"","COMUNE","CARNE","LATTE","MISTO","TOTALE_CAPI_SUM","YEAR","ISTAT_COMUNE"
"1","ABANO TERME",22,79,25,126,"2011","001"
"2","ABBADIA CERRETO",0,980,0,980,"2011","001"
"3","ABBADIA LARIANA",17,20,2,39,"2011","001"
"4","ABBIATEGRASSO",86,1345,0,1431,"2011","002"
"5","ACCEGLIO",54,10,20,84,"2011","001"
"6","ACQUAFREDDA",1434,132,0,1566,"2011","001"
"7","ACQUANEGRA CREMONESE",80,57,529,666,"2011","001"
"8","ACQUANEGRA SUL CHIESE",1347,651,82,2080,"2011","001"
"9","ACQUI TERME",222,0,12,234,"2011","001"
"10","ADRARA SAN MARTINO",37,67,0,104,"2011","001"
"11","ADRARA SAN ROCCO",18,10,0,28,"2011","002"
"12","ADRIA",2696,259,0,2955,"2011","001"
"13","ADRO",528,17,0,545,"2011","002"
"14","AFFI",2,16,2,20,"2011","001"
"15","AGAZZANO",170,401,0,571,"2011","001"
"16","AGLIANO TERME",53,0,29,82,"2011","001"
"17","AGLIE'",6,1,153,160,"2011","001"
"18","AGNA",354,10,0,364,"2011","002"
"19","AGNADELLO",66,1731,0,1797,"2011","002"
"20","AGNOSINE",17,21,0,38,"2011","003"
"21","AGORDO",2,22,0,24,"2011","001"
"22","AGRATE CONTURBIA",35,0,0,35,"2011","001"
"23","AGUGLIARO",368,72,35,475,"2011","001"
"24","AILOCHE",3,0,0,3,"2011","001"
"25","AIRASCA",456,76,324,856,"2011","002"
"26","AIRUNO",7,0,1,8,"2011","002"
"27","AISONE",14,13,0,27,"2011","002"
"28","ALA DI STURA",2,0,68,70,"2011","003"
"29","ALAGNA VALSESIA",2,8,19,29,"2011","002"
"30","ALANO DI PIAVE",450,50,0,500,"2011","002"
"31","ALBA",744,0,142,886,"2011","003"
"32","ALBAIRATE",55,588,0,643,"2011","005"
"33","ALBANO SANT'ALESSANDRO",12,0,0,12,"2011","003"
"34","ALBAREDO D'ADIGE",10318,114,55,10487,"2011","002"
"35","ALBAREDO PER SAN MARCO",3,32,0,35,"2011","001"
"36","ALBARETO",97,107,0,204,"2011","001"
"37","ALBARETTO DELLA TORRE",0,0,20,20,"2011","004"
"38","ALBAVILLA",1,0,0,1,"2011","003"
"39","ALBERA LIGURE",17,0,0,17,"2011","002"
"40","ALBESE CON CASSANO",7,0,3,10,"2011","004"
"41","ALBETTONE",1875,593,64,2532,"2011","002"
"42","ALBIANO D'IVREA",2,0,195,197,"2011","004"
"43","ALBIGNASEGO",249,72,94,415,"2011","003"
"44","ALBINEA",8,1451,2,1461,"2011","001"
"45","ALBINO",89,42,0,131,"2011","004"
"46","ALBIOLO",21,7,0,28,"2011","005"
"47","ALBIZZATE",9,0,0,9,"2011","002"
"48","ALBOSAGGIA",14,139,0,153,"2011","002"
"49","ALBUGNANO",94,0,0,94,"2011","002"
"50","ALBUZZANO",19,0,0,19,"2011","004"
"51","ALESSANDRIA",7761,1463,1432,10656,"2011","003"
"52","ALFIANELLO",21,590,4,615,"2011","004"
"53","ALFIANO NATTA",31,0,0,31,"2011","004"
"54","ALFONSINE",55,0,0,55,"2011","001"
"55","ALGUA",1,6,0,7,"2011","248"
"56","ALICE BEL COLLE",0,0,3,3,"2011","005"
"57","ALICE CASTELLO",483,28,0,511,"2011","004"
"58","ALICE SUPERIORE",0,0,32,32,"2011","005"
"59","ALLEGHE",4,0,0,4,"2011","003"
"60","ALLUVIONI CAMBIO'",21,0,0,21,"2011","006"
"61","ALME'",1,0,1,2,"2011","005"
"62","ALMENNO SAN BARTOLOMEO",31,0,0,31,"2011","006"
"63","ALMENNO SAN SALVATORE",5,0,0,5,"2011","007"
"64","ALMESE",0,15,48,63,"2011","006"
"65","ALONTE",521,13,0,534,"2011","003"
"66","ALPETTE",0,0,23,23,"2011","007"
"67","ALPIGNANO",236,173,134,543,"2011","008"
"68","ALSENO",467,916,0,1383,"2011","002"
"69","ALSERIO",6,0,0,6,"2011","006"
"70","ALTAVILLA MONFERRATO",76,0,1,77,"2011","007"
"71","ALTAVILLA VICENTINA",129,0,0,129,"2011","004"
"72","ALTISSIMO",66,47,0,113,"2011","005"
"73","ALTIVOLE",11824,90,113,12027,"2011","001"
"74","ALZANO LOMBARDO",45,48,0,93,"2011","008"
"75","ALZANO SCRIVIA",3,0,0,3,"2011","008"
"76","ALZATE BRIANZA",7,185,0,192,"2011","007"
"77","AMBIVERE",4,0,0,4,"2011","009"
"78","AMENO",0,0,37,37,"2011","002"
"79","ANDEZENO",683,0,0,683,"2011","009"
"80","ANDORNO MICCA",1,26,29,56,"2011","002"
"81","ANDRATE",0,0,39,39,"2011","010"
"82","ANFO",0,23,0,23,"2011","005"
"83","ANGERA",71,222,0,293,"2011","003"
"84","ANGOLO TERME",8,74,1,83,"2011","006"
"85","ANGROGNA",1,0,80,81,"2011","011"
"86","ANGUILLARA VENETA",13,0,0,13,"2011","004"
"87","ANNICCO",47,706,188,941,"2011","003"
"88","ANNONE DI BRIANZA",21,14,0,35,"2011","003"
"89","ANNONE VENETO",31,61,0,92,"2011","001"
"90","ANTEGNATE",1280,1032,0,2312,"2011","010"
"91","ANTIGNANO",63,0,0,63,"2011","003"
"92","ANTRONA SCHIERANCO",7,0,0,7,"2011","001"
"93","ANZANO DEL PARCO",0,161,0,161,"2011","009"
"94","ANZOLA D'OSSOLA",1,91,0,92,"2011","002"
"95","ANZOLA DELL'EMILIA",97,664,0,761,"2011","001"
"96","APPIANO GENTILE",41,316,13,370,"2011","010"
"97","APRICA",4,9,0,13,"2011","004"
"98","ARAMENGO",179,0,22,201,"2011","004"
"99","ARCADE",1082,107,0,1189,"2011","002"
"100","ARCENE",14,324,0,338,"2011","011"
"101","ARCISATE",54,691,0,745,"2011","004"
"102","ARCOLE",1431,164,0,1595,"2011","004"
"103","ARCONATE",44,99,0,143,"2011","007"
"104","ARCUGNANO",106,5,0,111,"2011","006"
"105","ARDENNO",83,53,6,142,"2011","005"
"106","ARDESIO",65,33,0,98,"2011","012"
"107","ARENA PO",145,504,0,649,"2011","005"
"108","ARESE",0,140,0,140,"2011","009"
"109","ARGEGNO",2,0,0,2,"2011","011"
"110","ARGELATO",60,63,0,123,"2011","002"
"111","ARGENTA",1867,6,4,1877,"2011","001"
"112","ARGUELLO",81,0,26,107,"2011","007"
"113","ARIANO NEL POLESINE",1496,153,0,1649,"2011","002"
"114","ARIGNANO",554,0,0,554,"2011","012"
"115","ARLUNO",43,216,0,259,"2011","010"
"116","ARMENO",4,84,43,131,"2011","006"
"117","AROLA",0,0,20,20,"2011","004"
"118","ARONA",3,0,0,3,"2011","008"
"119","AROSIO",2,3,0,5,"2011","012"
"120","ARQUA' PETRARCA",98,0,0,98,"2011","005"
"121","ARQUA' POLESINE",934,7,0,941,"2011","003"
"122","ARQUATA SCRIVIA",9,0,8,17,"2011","009"
"123","ARRE",13,25,0,38,"2011","006"
"124","ARSAGO SEPRIO",6,0,0,6,"2011","005"
"125","ARSIE'",23,70,401,494,"2011","004"
"126","ARSIERO",16,28,0,44,"2011","007"
"127","ARTOGNE",7,402,5,414,"2011","007"
"128","ARZAGO D'ADDA",193,789,0,982,"2011","013"
"129","ARZERGRANDE",209,94,17,320,"2011","007"
"130","ARZIGNANO",103,285,0,388,"2011","008"
"131","ASIAGO",91,1136,0,1227,"2011","009"
"132","ASIGLIANO VENETO",64,0,0,64,"2011","010"
"133","ASIGLIANO VERCELLESE",18,0,0,18,"2011","007"
"134","ASOLA",8542,1646,1257,11445,"2011","002"
"135","ASOLO",9810,530,47,10387,"2011","003"
"136","ASSAGO",0,0,5,5,"2011","011"
"137","ASSO",19,0,6,25,"2011","013"
"138","ASTI",2678,10,207,2895,"2011","005"
"139","AURANO",0,0,7,7,"2011","005"
"140","AURONZO DI CADORE",27,8,0,35,"2011","005"
"141","AVERARA",3,0,0,3,"2011","014"
"142","AVIATICO",2,22,0,24,"2011","015"
"143","AVIGLIANA",4,45,171,220,"2011","013"
"144","AVOLASCA",7,0,60,67,"2011","010"
"145","AZEGLIO",1,0,159,160,"2011","014"
"146","AZZANELLO",7,309,0,316,"2011","004"
"147","AZZANO MELLA",320,677,0,997,"2011","008"
"148","AZZANO SAN PAOLO",27,119,0,146,"2011","016"
"149","AZZATE",7,33,0,40,"2011","006"
"150","AZZIO",16,50,0,66,"2011","007"
"151","AZZONE",1,0,0,1,"2011","017"
"152","BACENO",2,31,10,43,"2011","006"
"153","BADIA CALAVENA",934,274,39,1247,"2011","005"
"154","BADIA PAVESE",37,0,0,37,"2011","006"
"155","BADIA POLESINE",174,6,31,211,"2011","004"
"156","BAGNACAVALLO",58,0,0,58,"2011","002"
"157","BAGNARA DI ROMAGNA",7,0,0,7,"2011","003"
"158","BAGNARIA",18,0,0,18,"2011","007"
"159","BAGNASCO",119,0,0,119,"2011","008"
"160","BAGNATICA",0,142,0,142,"2011","018"
"161","BAGNO DI ROMAGNA",927,16,0,943,"2011","001"
"162","BAGNOLI DI SOPRA",772,35,0,807,"2011","008"
"163","BAGNOLO CREMASCO",2,1526,0,1528,"2011","005"
"164","BAGNOLO IN PIANO",9,573,0,582,"2011","002"
"165","BAGNOLO MELLA",454,2668,3,3125,"2011","009"
"166","BAGNOLO PIEMONTE",952,83,0,1035,"2011","009"
"167","BAGNOLO SAN VITO",291,2435,1139,3865,"2011","003"
"168","BAGOLINO",2,317,9,328,"2011","010"
"169","BAIRO",39,41,68,148,"2011","015"
"170","BAISO",13,815,13,841,"2011","003"
"171","BALANGERO",122,115,74,311,"2011","016"
"172","BALDICHIERI D'ASTI",85,0,0,85,"2011","007"
"173","BALDISSERO CANAVESE",0,56,0,56,"2011","017"
"174","BALDISSERO D'ALBA",617,0,7,624,"2011","010"
"175","BALDISSERO TORINESE",249,0,0,249,"2011","018"
"176","BALLABIO",19,92,0,111,"2011","004"
"177","BALME",0,0,16,16,"2011","019"
"178","BALOCCO",24,22,0,46,"2011","009"
"179","BANCHETTE",0,0,9,9,"2011","020"
"180","BANNIO ANZINO",0,0,77,77,"2011","007"
"181","BAONE",12,0,0,12,"2011","009"
"182","BARBANIA",44,143,64,251,"2011","021"
"183","BARBARANO VICENTINO",333,155,0,488,"2011","011"
"184","BARBARESCO",6,0,29,35,"2011","011"
"185","BARBARIGA",937,1235,0,2172,"2011","011"
"186","BARBATA",43,971,0,1014,"2011","019"
"187","BARBIANELLO",158,7,0,165,"2011","008"
"188","BARBONA",149,4,0,153,"2011","010"
"189","BARDELLO",25,0,0,25,"2011","009"
"190","BARDI",35,516,0,551,"2011","002"
"191","BARDOLINO",26,86,0,112,"2011","006"
"192","BARDONECCHIA",0,35,10,45,"2011","022"
"193","BAREGGIO",81,287,0,368,"2011","012"
"194","BARENGO",3,89,2,94,"2011","012"
"195","BARGE",3935,1608,228,5771,"2011","012"
"196","BARGHE",4,17,0,21,"2011","012"
"197","BARIANO",5,308,0,313,"2011","020"
"198","BARNI",14,8,0,22,"2011","015"
"199","BAROLO",1,0,34,35,"2011","013"
"200","BARONE CANAVESE",352,0,35,387,"2011","023"
"201","BARZAGO",354,18,0,372,"2011","005"
"202","BARZANO'",19,0,0,19,"2011","006"
"203","BARZIO",10,33,16,59,"2011","007"
"204","BASALUZZO",113,0,123,236,"2011","012"
"205","BASCAPE'",88,761,0,849,"2011","009"
"206","BASIANO",2,0,0,2,"2011","014"
"207","BASIGLIO",0,57,0,57,"2011","015"
"208","BASSANO BRESCIANO",0,88,0,88,"2011","013"
"209","BASSANO DEL GRAPPA",271,135,53,459,"2011","012"
"210","BASSIGNANA",1,0,1,2,"2011","013"
"211","BASTIA MONDOVI'",662,0,0,662,"2011","014"
"212","BASTIDA DE' DOSSI",4,0,0,4,"2011","010"
"213","BASTIDA PANCARANA",1,0,0,1,"2011","011"
"214","BASTIGLIA",120,0,0,120,"2011","001"
"215","BATTAGLIA TERME",5,0,0,5,"2011","011"
"216","BATTIFOLLO",1,0,0,1,"2011","015"
"217","BAZZANO",2,167,0,169,"2011","004"
"218","BEDERO VALCUVIA",24,0,0,24,"2011","010"
"219","BEDIZZOLE",3515,1216,0,4731,"2011","014"
"220","BEDONIA",184,134,12,330,"2011","003"
"221","BEDULITA",15,3,0,18,"2011","022"
"222","BEE",0,0,1,1,"2011","009"
"223","BEINASCO",11,0,0,11,"2011","024"
"224","BEINETTE",809,264,0,1073,"2011","016"
"225","BELFIORE",2336,0,27,2363,"2011","007"
"226","BELGIOIOSO",2,140,0,142,"2011","013"
"227","BELLAGIO",6,36,21,63,"2011","019"
"228","BELLANO",6,0,0,6,"2011","008"
"229","BELLARIA-IGEA MARINA",19,0,0,19,"2011","001"
"230","BELLINO",77,0,0,77,"2011","017"
"231","BELLINZAGO LOMBARDO",48,1533,0,1581,"2011","016"
"232","BELLINZAGO NOVARESE",487,390,58,935,"2011","016"
"233","BELLUNO",644,327,75,1046,"2011","006"
"234","BELVEDERE LANGHE",201,0,55,256,"2011","018"
"235","BELVEGLIO",4,0,0,4,"2011","008"
"236","BEMA",0,6,0,6,"2011","006"
"237","BENE LARIO",2,51,0,53,"2011","021"
"238","BENE VAGIENNA",1626,239,87,1952,"2011","019"
"239","BENEVELLO",60,0,168,228,"2011","020"
"240","BENNA",0,41,1,42,"2011","003"
"241","BENTIVOGLIO",33,198,0,231,"2011","005"
"242","BERBENNO",12,26,0,38,"2011","023"
"243","BERBENNO DI VALTELLINA",20,145,3,168,"2011","007"
"244","BERCETO",34,80,0,114,"2011","004"
"245","BEREGAZZO CON FIGLIARO",27,0,0,27,"2011","022"
"246","BEREGUARDO",3,651,0,654,"2011","014"
"247","BERGAMASCO",81,0,13,94,"2011","015"
"248","BERGAMO",131,181,0,312,"2011","024"
"249","BERGOLO",0,0,2,2,"2011","021"
"250","BERLINGO",2249,315,26,2590,"2011","015"
"251","BERNATE TICINO",220,135,0,355,"2011","019"
"252","BERNEZZO",312,0,54,366,"2011","022"
"253","BERRA",1093,57,0,1150,"2011","002"
"254","BERTINORO",228,53,0,281,"2011","003"
"255","BERTONICO",79,2209,0,2288,"2011","002"
"256","BERZANO DI SAN PIETRO",13,0,0,13,"2011","009"
"257","BERZO DEMO",14,51,5,70,"2011","016"
"258","BERZO INFERIORE",8,156,1,165,"2011","017"
"259","BERZO SAN FERMO",849,101,18,968,"2011","025"
"260","BESANO",46,15,0,61,"2011","011"
"261","BESATE",102,0,0,102,"2011","022"
"262","BESENZONE",1362,1324,0,2686,"2011","003"
"263","BESNATE",12,228,0,240,"2011","012"
"264","BESOZZO",40,67,0,107,"2011","013"
"265","BETTOLA",218,182,0,400,"2011","004"
"266","BEURA-CARDEZZA",6,6,6,18,"2011","011"
"267","BEVILACQUA",195,61,0,256,"2011","008"
"268","BIANDRONNO",19,0,0,19,"2011","014"
"269","BIANZANO",13,23,0,36,"2011","026"
"270","BIANZE'",81,308,0,389,"2011","011"
"271","BIANZONE",4,33,0,37,"2011","008"
"272","BIBBIANO",5,1962,0,1967,"2011","004"
"273","BIBIANA",184,0,362,546,"2011","025"
"274","BIELLA",19,209,86,314,"2011","004"
"275","BIENNO",4,58,1,63,"2011","018"
"276","BIGARELLO",3178,219,515,3912,"2011","004"
"277","BINAGO",8,141,1,150,"2011","023"
"278","BIOGLIO",0,0,17,17,"2011","005"
"279","BIONE",19,13,8,40,"2011","019"
"280","BISTAGNO",26,0,1,27,"2011","017"
"281","BISUSCHIO",2,0,0,2,"2011","015"
"282","BIZZARONE",14,27,0,41,"2011","024"
"283","BLELLO",12,20,0,32,"2011","027"
"284","BLESSAGNO",0,0,1,1,"2011","025"
"285","BOARA PISANI",2,0,0,2,"2011","012"
"286","BOBBIO",190,27,0,217,"2011","005"
"287","BOBBIO PELLICE",0,116,69,185,"2011","026"
"288","BOCA",0,1,0,1,"2011","019"
"289","BOCCIOLETO",1,3,0,4,"2011","014"
"290","BOFFALORA D'ADDA",393,428,0,821,"2011","003"
"291","BOFFALORA SOPRA TICINO",236,164,0,400,"2011","026"
"292","BOLGARE",54,266,0,320,"2011","028"
"293","BOLLATE",0,261,0,261,"2011","027"
"294","BOLLENGO",10,35,78,123,"2011","027"
"295","BOLOGNA",23,36,0,59,"2011","006"
"296","BOLTIERE",34,83,0,117,"2011","029"
"297","BOLZANO NOVARESE",0,17,0,17,"2011","022"
"298","BOLZANO VICENTINO",262,1305,19,1586,"2011","013"
"299","BOMPORTO",1484,105,0,1589,"2011","002"
"300","BONATE SOPRA",287,10,0,297,"2011","030"
"301","BONATE SOTTO",88,1,0,89,"2011","031"
"302","BONAVIGO",3535,29,0,3564,"2011","009"
"303","BONDENO",896,379,0,1275,"2011","003"
"304","BONEMERSE",11,304,0,315,"2011","006"
"305","BORDOLANO",24,523,0,547,"2011","007"
"306","BORE",55,6,0,61,"2011","005"
"307","BORETTO",0,270,0,270,"2011","005"
"308","BORGARELLO",2,0,0,2,"2011","015"
"309","BORGARO TORINESE",71,89,56,216,"2011","028"
"310","BORGHETTO DI BORBERA",95,6,70,171,"2011","018"
"311","BORGHETTO LODIGIANO",54,1436,0,1490,"2011","004"
"312","BORGHI",1604,0,0,1604,"2011","004"
"313","BORGIALLO",0,5,18,23,"2011","029"
"314","BORGO D'ALE",107,0,118,225,"2011","015"
"315","BORGO DI TERZO",3,0,0,3,"2011","032"
"316","BORGO PRIOLO",13,0,0,13,"2011","016"
"317","BORGO SAN DALMAZZO",391,111,0,502,"2011","025"
"318","BORGO SAN GIACOMO",1103,2762,6,3871,"2011","020"
"319","BORGO SAN GIOVANNI",13,761,0,774,"2011","005"
"320","BORGO SAN SIRO",3,693,0,696,"2011","018"
"321","BORGO TICINO",47,0,0,47,"2011","025"
"322","BORGO TOSSIGNANO",4,0,0,4,"2011","007"
"323","BORGO VAL DI TARO",130,213,0,343,"2011","006"
"324","BORGO VERCELLI",1,30,0,31,"2011","017"
"325","BORGOFORTE",35,2378,1318,3731,"2011","005"
"326","BORGOFRANCO D'IVREA",87,7,83,177,"2011","030"
"327","BORGOFRANCO SUL PO",13,21,54,88,"2011","006"
"328","BORGOLAVEZZARO",7,0,0,7,"2011","023"
"329","BORGOMALE",65,0,47,112,"2011","024"
"330","BORGOMANERO",96,46,16,158,"2011","024"
"331","BORGOMASINO",23,0,164,187,"2011","031"
"332","BORGONE SUSA",0,22,25,47,"2011","032"
"333","BORGONOVO VAL TIDONE",558,1526,0,2084,"2011","006"
"334","BORGORATTO ALESSANDRINO",0,0,37,37,"2011","019"
"335","BORGORATTO MORMOROLO",50,0,0,50,"2011","017"
"336","BORGORICCO",124,77,4,205,"2011","013"
"337","BORGOSATOLLO",22,581,29,632,"2011","021"
"338","BORGOSESIA",53,44,1,98,"2011","016"
"339","BORMIO",6,296,34,336,"2011","009"
"340","BORNASCO",179,477,0,656,"2011","019"
"341","BORNO",20,158,25,203,"2011","022"
"342","BORRIANA",48,75,36,159,"2011","006"
"343","BORSO DEL GRAPPA",136,225,4,365,"2011","004"
"344","BOSARO",8,0,0,8,"2011","007"
"345","BOSCHI SANT'ANNA",6,3,0,9,"2011","010"
"346","BOSCO CHIESANUOVA",415,1286,0,1701,"2011","011"
"347","BOSCO MARENGO",45,25,104,174,"2011","021"
"348","BOSCONERO",13,0,132,145,"2011","033"
"349","BOSIA",0,0,247,247,"2011","026"
"350","BOSIO",38,5,18,61,"2011","022"
"351","BOSISIO PARINI",15,116,1,132,"2011","009"
"352","BOSSICO",22,92,2,116,"2011","033"
"353","BOSSOLASCO",0,0,135,135,"2011","027"
"354","BOTTANUCO",14,690,0,704,"2011","034"
"355","BOTTICINO",32,0,0,32,"2011","023"
"356","BOVEGNO",97,74,4,175,"2011","024"
"357","BOVES",656,495,305,1456,"2011","028"
"358","BOVEZZO",1,0,0,1,"2011","025"
"359","BOVOLENTA",3483,290,0,3773,"2011","014"
"360","BOVOLONE",3513,355,0,3868,"2011","012"
"361","BOZZOLO",97,825,4,926,"2011","007"
"362","BRA",2539,934,1481,4954,"2011","029"
"363","BRACCA",5,0,0,5,"2011","035"
"364","BRALLO DI PREGOLA",13,27,0,40,"2011","021"
"365","BRANDICO",38,225,0,263,"2011","026"
"366","BRANDIZZO",0,56,13,69,"2011","034"
"367","BRANZI",5,32,0,37,"2011","036"
"368","BRAONE",0,22,0,22,"2011","027"
"369","BREBBIA",103,0,1,104,"2011","017"
"370","BREDA DI PIAVE",70,363,0,433,"2011","005"
"371","BREGANO",5,0,0,5,"2011","018"
"372","BREGANZE",338,831,146,1315,"2011","014"
"373","BREGNANO",5,81,4,90,"2011","028"
"374","BREIA",6,0,0,6,"2011","019"
"375","BREMBATE",22,186,0,208,"2011","037"
"376","BREMBATE DI SOPRA",3,174,0,177,"2011","038"
"377","BREMBILLA",53,51,0,104,"2011","039"
"378","BREMBIO",115,1444,58,1617,"2011","006"
"379","BREME",35,0,0,35,"2011","022"
"380","BRENDOLA",328,109,0,437,"2011","015"
"381","BRENNA",11,0,0,11,"2011","029"
"382","BRENO",7,258,0,265,"2011","028"
"383","BRENTA",10,0,0,10,"2011","019"
"384","BRENTINO BELLUNO",3,0,0,3,"2011","013"
"385","BRENZONE",20,0,1,21,"2011","014"
"386","BRESCELLO",1,39,15,55,"2011","006"
"387","BRESCIA",143,597,0,740,"2011","029"
"388","BRESSANA BOTTARONE",10,0,0,10,"2011","023"
"389","BRESSANVIDO",132,1045,12,1189,"2011","016"
"390","BREZZO DI BEDERO",9,0,0,9,"2011","020"
"391","BRIAGLIA",75,0,0,75,"2011","030"
"392","BRICHERASIO",171,40,544,755,"2011","035"
"393","BRIGA NOVARESE",1,80,0,81,"2011","026"
"394","BRIGNANO GERA D'ADDA",149,1340,0,1489,"2011","040"
"395","BRIGNANO-FRASCATA",6,0,0,6,"2011","024"
"396","BRINZIO",6,0,0,6,"2011","021"
"397","BRIONA",9,1471,3,1483,"2011","027"
"398","BRIONE",10,0,0,10,"2011","030"
"399","BRISIGHELLA",363,74,0,437,"2011","004"
"400","BRISSAGO-VALTRAVAGLIA",1,0,0,1,"2011","022"
"401","BRIVIO",53,73,0,126,"2011","010"
"402","BROGLIANO",3,56,0,59,"2011","017"
"403","BRONDELLO",5,0,0,5,"2011","032"
"404","BRONI",188,0,0,188,"2011","024"
"405","BROSSASCO",91,0,0,91,"2011","033"
"406","BROSSO",3,0,60,63,"2011","036"
"407","BROVELLO-CARPUGNINO",3,0,20,23,"2011","013"
"408","BROZOLO",112,0,48,160,"2011","037"
"409","BRUGINE",3760,111,42,3913,"2011","015"
"410","BRUINO",130,0,74,204,"2011","038"
"411","BRUMANO",7,16,0,23,"2011","041"
"412","BRUNELLO",18,0,0,18,"2011","023"
"413","BRUNO",20,0,0,20,"2011","010"
"414","BRUSAPORTO",26,45,0,71,"2011","042"
"415","BRUSASCO",38,0,81,119,"2011","039"
"416","BRUSNENGO",0,0,27,27,"2011","007"
"417","BRUZOLO",0,26,46,72,"2011","040"
"418","BUBBIANO",4,25,0,29,"2011","035"
"419","BUBBIO",78,0,0,78,"2011","011"
"420","BUCCINASCO",22,471,0,493,"2011","036"
"421","BUDRIO",402,388,0,790,"2011","008"
"422","BUGLIO IN MONTE",14,276,0,290,"2011","010"
"423","BUGUGGIATE",9,0,0,9,"2011","025"
"424","BULCIAGO",12,106,33,151,"2011","011"
"425","BULGAROGRASSO",39,244,6,289,"2011","034"
"426","BURIASCO",477,756,745,1978,"2011","041"
"427","BUROLO",0,0,6,6,"2011","042"
"428","BURONZO",3,15,0,18,"2011","021"
"429","BUSANA",0,32,0,32,"2011","007"
"430","BUSANO",0,31,9,40,"2011","043"
"431","BUSCA",4809,537,1204,6550,"2011","034"
"432","BUSCATE",49,0,0,49,"2011","038"
"433","BUSSERO",0,547,0,547,"2011","040"
"434","BUSSETO",2,3436,0,3438,"2011","007"
"435","BUSSOLENGO",2016,133,47,2196,"2011","015"
"436","BUSSOLENO",2,221,21,244,"2011","044"
"437","BUSTO ARSIZIO",26,247,52,325,"2011","026"
"438","BUSTO GAROLFO",91,168,0,259,"2011","041"
"439","BUTTAPIETRA",22,264,0,286,"2011","016"
"440","BUTTIGLIERA ALTA",22,36,52,110,"2011","045"
"441","BUTTIGLIERA D'ASTI",1778,152,0,1930,"2011","012"
"442","CA' D'ANDREA",3,1110,3,1116,"2011","008"
"443","CABELLA LIGURE",16,0,59,75,"2011","025"
"444","CABIATE",2,0,0,2,"2011","035"
"445","CADEGLIANO-VICONAGO",7,0,0,7,"2011","027"
"446","CADELBOSCO DI SOPRA",72,1269,0,1341,"2011","008"
"447","CADEO",20,1922,0,1942,"2011","007"
"448","CADONEGHE",17,4,20,41,"2011","016"
"449","CADORAGO",10,62,0,72,"2011","036"
"450","CADREZZATE",6,0,0,6,"2011","028"
"451","CAERANO DI SAN MARCO",296,113,7,416,"2011","006"
"452","CAFASSE",10,24,73,107,"2011","046"
"453","CAGLIO",3,1,0,4,"2011","037"
"454","CAGNO",0,66,0,66,"2011","038"
"455","CAINO",6,0,0,6,"2011","031"
"456","CAIOLO",6,79,0,85,"2011","011"
"457","CAIRATE",3,5,0,8,"2011","029"
"458","CALAMANDRANA",64,0,37,101,"2011","013"
"459","CALASCA-CASTIGLIONE",2,0,13,15,"2011","014"
"460","CALCINATE",220,236,0,456,"2011","043"
"461","CALCINATO",3624,1615,901,6140,"2011","032"
"462","CALCIO",225,1292,0,1517,"2011","044"
"463","CALCO",13,137,0,150,"2011","012"
"464","CALDERARA DI RENO",12,128,0,140,"2011","009"
"465","CALDIERO",1,0,0,1,"2011","017"
"466","CALDOGNO",229,356,0,585,"2011","018"
"467","CALENDASCO",163,362,0,525,"2011","008"
"468","CALESTANO",13,492,0,505,"2011","008"
"469","CALLABIANA",0,0,12,12,"2011","008"
"470","CALLIANO",239,0,0,239,"2011","014"
"471","CALOLZIOCORTE",19,0,14,33,"2011","013"
"472","CALOSSO",24,0,8,32,"2011","015"
"473","CALTIGNAGA",775,213,12,1000,"2011","030"
"474","CALTO",28,0,0,28,"2011","008"
"475","CALTRANO",1451,1,5,1457,"2011","019"
"476","CALUSCO D'ADDA",16,0,0,16,"2011","046"
"477","CALUSO",49,162,628,839,"2011","047"
"478","CALVAGESE DELLA RIVIERA",77,149,0,226,"2011","033"
"479","CALVATONE",70,98,2,170,"2011","009"
"480","CALVENE",8,88,0,96,"2011","020"
"481","CALVENZANO",20,458,0,478,"2011","047"
"482","CALVIGNASCO",1,30,0,31,"2011","042"
"483","CALVISANO",14874,3966,41,18881,"2011","034"
"484","CAMAGNA MONFERRATO",0,0,26,26,"2011","026"
"485","CAMAIRAGO",9,1162,0,1171,"2011","007"
"486","CAMANDONA",0,0,6,6,"2011","009"
"487","CAMBIAGO",19,78,0,97,"2011","044"
"488","CAMBIANO",361,0,0,361,"2011","048"
"489","CAMBIASCA",2,0,5,7,"2011","015"
"490","CAMBURZANO",16,16,59,91,"2011","010"
"491","CAMERANA",317,0,0,317,"2011","035"
"492","CAMERANO CASASCO",16,0,8,24,"2011","016"
"493","CAMERATA CORNELLO",20,63,0,83,"2011","048"
"494","CAMERI",43,669,37,749,"2011","032"
"495","CAMINATA",15,0,0,15,"2011","009"
"496","CAMISANO",180,2947,0,3127,"2011","010"
"497","CAMISANO VICENTINO",347,1652,4,2003,"2011","021"
"498","CAMPAGNA LUPIA",119,159,0,278,"2011","002"
"499","CAMPAGNOLA CREMASCA",92,378,0,470,"2011","011"
"500","CAMPAGNOLA EMILIA",14,669,0,683,"2011","009"
"501","CAMPEGINE",10,1071,0,1081,"2011","010"
"502","CAMPERTOGNO",0,52,111,163,"2011","025"
"503","CAMPIGLIA CERVO",0,4,0,4,"2011","011"
"504","CAMPIGLIA DEI BERICI",728,123,0,851,"2011","022"
"505","CAMPIGLIONE-FENILE",233,103,447,783,"2011","049"
"506","CAMPO SAN MARTINO",262,102,0,364,"2011","020"
"507","CAMPODARSEGO",818,99,0,917,"2011","017"
"508","CAMPODORO",83,346,0,429,"2011","018"
"509","CAMPOGALLIANO",0,580,0,580,"2011","003"
"510","CAMPOLONGO MAGGIORE",46,56,0,102,"2011","003"
"511","CAMPOLONGO SUL BRENTA",3,0,0,3,"2011","023"
"512","CAMPONOGARA",118,79,0,197,"2011","004"
"513","CAMPOSAMPIERO",228,142,4,374,"2011","019"
"514","CAMPOSPINOSO",2,0,0,2,"2011","026"
"515","CAMUGNANO",198,145,0,343,"2011","010"
"516","CANALE",601,0,86,687,"2011","037"
"517","CANARO",218,69,0,287,"2011","009"
"518","CANDA",97,0,0,97,"2011","010"
"519","CANDELO",41,128,48,217,"2011","012"
"520","CANDIA CANAVESE",1,0,21,22,"2011","050"
"521","CANDIANA",10175,205,0,10380,"2011","021"
"522","CANDIOLO",252,447,111,810,"2011","051"
"523","CANEGRATE",7,0,0,7,"2011","046"
"524","CANELLI",9,0,2,11,"2011","017"
"525","CANEVINO",4,0,0,4,"2011","028"
"526","CANISCHIO",4,0,1,5,"2011","052"
"527","CANNERO RIVIERA",2,0,0,2,"2011","016"
"528","CANNETO SULL'OGLIO",1280,1182,891,3353,"2011","008"
"529","CANNOBIO",1,0,19,20,"2011","017"
"530","CANONICA D'ADDA",58,347,0,405,"2011","049"
"531","CANOSIO",8,0,44,52,"2011","038"
"532","CANOSSA",39,310,0,349,"2011","018"
"533","CANTALUPA",97,0,32,129,"2011","053"
"534","CANTALUPO LIGURE",9,0,6,15,"2011","028"
"535","CANTARANA",100,0,0,100,"2011","018"
"536","CANTELLO",140,146,0,286,"2011","030"
"537","CANTOIRA",0,16,52,68,"2011","054"
"538","CANTU'",212,250,9,471,"2011","041"
"539","CANZO",2,0,6,8,"2011","042"
"540","CAORLE",630,219,0,849,"2011","005"
"541","CAORSO",26,436,0,462,"2011","010"
"542","CAPERGNANICA",453,1127,0,1580,"2011","012"
"543","CAPIAGO INTIMIANO",14,34,1,49,"2011","043"
"544","CAPIZZONE",13,14,0,27,"2011","050"
"545","CAPO DI PONTE",15,72,0,87,"2011","035"
"546","CAPOVALLE",32,12,0,44,"2011","036"
"547","CAPPELLA CANTONE",0,536,0,536,"2011","013"
"548","CAPPELLA DE' PICENARDI",32,287,0,319,"2011","014"
"549","CAPPELLA MAGGIORE",31,22,0,53,"2011","007"
"550","CAPRALBA",0,1553,0,1553,"2011","015"
"551","CAPRAUNA",5,0,0,5,"2011","039"
"552","CAPRIANO DEL COLLE",18,886,0,904,"2011","037"
"553","CAPRIATA D'ORBA",35,0,20,55,"2011","029"
"554","CAPRIE",1,0,17,18,"2011","055"
"555","CAPRIGLIO",1,0,0,1,"2011","019"
"556","CAPRILE",24,4,4,32,"2011","013"
"557","CAPRINO BERGAMASCO",24,47,0,71,"2011","052"
"558","CAPRINO VERONESE",90,684,72,846,"2011","018"
"559","CAPRIOLO",272,37,0,309,"2011","038"
"560","CARAGLIO",3386,669,400,4455,"2011","040"
"561","CARAMAGNA PIEMONTE",1296,548,0,1844,"2011","041"
"562","CARATE URIO",0,0,1,1,"2011","044"
"563","CARAVAGGIO",327,2758,47,3132,"2011","053"
"564","CARAVATE",11,137,0,148,"2011","031"
"565","CARAVINO",3,0,4,7,"2011","056"
"566","CARBONARA AL TICINO",0,164,0,164,"2011","030"
"567","CARBONARA DI PO",21,435,96,552,"2011","009"
"568","CARBONARA SCRIVIA",20,0,0,20,"2011","030"
"569","CARBONATE",60,39,6,105,"2011","045"
"570","CARBONERA",103,344,0,447,"2011","008"
"571","CARCERI",862,0,0,862,"2011","022"
"572","CARCOFORO",1,0,3,4,"2011","029"
"573","CARDANO AL CAMPO",12,0,0,12,"2011","032"
"574","CARDE'",2612,1578,0,4190,"2011","042"
"575","CAREMA",5,23,55,83,"2011","057"
"576","CARENNO",25,0,8,33,"2011","014"
"577","CARENTINO",0,476,225,701,"2011","031"
"578","CARESANA",7,0,0,7,"2011","030"
"579","CAREZZANO",0,0,2,2,"2011","032"
"580","CARIGNANO",2945,1521,101,4567,"2011","058"
"581","CARISIO",44,0,0,44,"2011","032"
"582","CARLAZZO",14,34,33,81,"2011","047"
"583","CARMAGNOLA",6647,2400,185,9232,"2011","059"
"584","CARMIGNANO DI BRENTA",310,1434,0,1744,"2011","023"
"585","CARNAGO",21,43,0,64,"2011","033"
"586","CAROBBIO DEGLI ANGELI",81,46,0,127,"2011","055"
"587","CARONNO PERTUSELLA",10,0,0,10,"2011","034"
"588","CARONNO VARESINO",16,0,0,16,"2011","035"
"589","CARPANETO PIACENTINO",57,3277,0,3334,"2011","011"
"590","CARPENEDOLO",1829,3382,0,5211,"2011","039"
"591","CARPENETO",49,2,63,114,"2011","033"
"592","CARPI",15,2081,0,2096,"2011","005"
"593","CARPIANO",78,1067,0,1145,"2011","050"
"594","CARPIGNANO SESIA",77,35,4,116,"2011","036"
"595","CARPINETI",76,1367,0,1443,"2011","011"
"596","CARRE'",405,156,2,563,"2011","024"
"597","CARREGA LIGURE",12,0,23,35,"2011","034"
"598","CARROSIO",2,0,0,2,"2011","035"
"599","CARRU'",811,22,7,840,"2011","043"
"600","CARTIGLIANO",19,46,0,65,"2011","025"
"601","CARTIGNANO",166,0,71,237,"2011","044"
"602","CARTOSIO",14,0,35,49,"2011","036"
"603","CARTURA",462,28,0,490,"2011","026"
"604","CARUGATE",1,84,0,85,"2011","051"
"605","CARUGO",23,0,0,23,"2011","048"
"606","CARVICO",13,0,0,13,"2011","057"
"607","CASAL CERMELLI",0,0,13,13,"2011","037"
"608","CASALBELTRAME",0,0,139,139,"2011","037"
"609","CASALBORGONE",1,0,59,60,"2011","060"
"610","CASALBUTTANO ED UNITI",11,1250,0,1261,"2011","016"
"611","CASALE CORTE CERRO",4,0,10,14,"2011","019"
"612","CASALE CREMASCO-VIDOLASCO",86,1484,0,1570,"2011","017"
"613","CASALE DI SCODOSIA",627,0,0,627,"2011","027"
"614","CASALE LITTA",25,148,3,176,"2011","036"
"615","CASALE MONFERRATO",100,141,55,296,"2011","039"
"616","CASALE SUL SILE",143,136,47,326,"2011","009"
"617","CASALECCHIO DI RENO",3,0,0,3,"2011","011"
"618","CASALEGGIO BOIRO",5,0,0,5,"2011","038"
"619","CASALEGGIO NOVARA",1,0,0,1,"2011","039"
"620","CASALEONE",440,32,0,472,"2011","019"
"621","CASALETTO CEREDANO",4,59,0,63,"2011","018"
"622","CASALETTO DI SOPRA",9,256,0,265,"2011","019"
"623","CASALETTO LODIGIANO",9,537,0,546,"2011","008"
"624","CASALETTO VAPRIO",96,528,0,624,"2011","020"
"625","CASALFIUMANESE",314,151,0,465,"2011","012"
"626","CASALGRANDE",9,1009,0,1018,"2011","012"
"627","CASALGRASSO",155,370,0,525,"2011","045"
"628","CASALINO",19,366,0,385,"2011","040"
"629","CASALMAGGIORE",20,701,0,721,"2011","021"
"630","CASALMAIOCCO",29,577,0,606,"2011","009"
"631","CASALMORANO",92,1651,0,1743,"2011","022"
"632","CASALMORO",1198,218,262,1678,"2011","010"
"633","CASALNOCETO",12,0,0,12,"2011","040"
"634","CASALOLDO",1343,1004,797,3144,"2011","011"
"635","CASALPUSTERLENGO",0,1389,0,1389,"2011","010"
"636","CASALROMANO",338,329,170,837,"2011","012"
"637","CASALSERUGO",107,6,47,160,"2011","028"
"638","CASALVOLONE",4,74,1,79,"2011","041"
"639","CASALZUIGNO",3,107,0,110,"2011","037"
"640","CASANOVA ELVO",3,0,0,3,"2011","033"
"641","CASARGO",21,0,0,21,"2011","015"
"642","CASARILE",17,26,0,43,"2011","055"
"643","CASASCO",66,0,0,66,"2011","041"
"644","CASATENOVO",175,22,0,197,"2011","016"
"645","CASAZZA",22,24,0,46,"2011","058"
"646","CASCIAGO",40,36,0,76,"2011","038"
"647","CASEI GEROLA",543,0,0,543,"2011","033"
"648","CASELETTE",11,262,124,397,"2011","062"
"649","CASELLE LANDI",421,456,0,877,"2011","011"
"650","CASELLE LURANI",107,219,0,326,"2011","012"
"651","CASELLE TORINESE",94,1253,171,1518,"2011","063"
"652","CASIER",14,70,34,118,"2011","010"
"653","CASINA",178,910,0,1088,"2011","013"
"654","CASIRATE D'ADDA",197,442,0,639,"2011","059"
"655","CASLINO D'ERBA",0,26,0,26,"2011","052"
"656","CASNATE CON BERNATE",88,0,0,88,"2011","053"
"657","CASNIGO",49,127,0,176,"2011","060"
"658","CASOLA VALSENIO",147,89,0,236,"2011","005"
"659","CASORATE PRIMO",21,57,0,78,"2011","034"
"660","CASORATE SEMPIONE",2,0,0,2,"2011","039"
"661","CASOREZZO",2,330,0,332,"2011","058"
"662","CASORZO",1,0,0,1,"2011","020"
"663","CASPOGGIO",0,39,0,39,"2011","013"
"664","CASSAGO BRIANZA",6,34,1,41,"2011","017"
"665","CASSANO D'ADDA",130,306,0,436,"2011","059"
"666","CASSANO MAGNAGO",28,95,13,136,"2011","040"
"667","CASSANO SPINOLA",513,0,0,513,"2011","042"
"668","CASSANO VALCUVIA",1,0,0,1,"2011","041"
"669","CASSINA DE' PECCHI",0,464,0,464,"2011","060"
"670","CASSINA RIZZARDI",7,0,0,7,"2011","055"
"671","CASSINA VALSASSINA",4,52,0,56,"2011","018"
"672","CASSINASCO",44,23,0,67,"2011","021"
"673","CASSINE",127,1,6,134,"2011","043"
"674","CASSINELLE",6,0,0,6,"2011","044"
"675","CASSINETTA DI LUGAGNANO",7,174,0,181,"2011","061"
"676","CASSOLA",1132,27,0,1159,"2011","026"
"677","CASSOLNOVO",23,51,0,74,"2011","035"
"678","CASTAGNARO",530,0,0,530,"2011","020"
"679","CASTAGNETO PO",5,0,50,55,"2011","064"
"680","CASTAGNITO",224,0,23,247,"2011","046"
"681","CASTAGNOLE DELLE LANZE",331,0,0,331,"2011","022"
"682","CASTAGNOLE MONFERRATO",48,0,0,48,"2011","023"
"683","CASTAGNOLE PIEMONTE",1316,911,0,2227,"2011","065"
"684","CASTANA",3,0,0,3,"2011","036"
"685","CASTANO PRIMO",101,0,0,101,"2011","062"
"686","CASTEGGIO",15,0,0,15,"2011","037"
"687","CASTEGNATO",109,904,33,1046,"2011","040"
"688","CASTEGNERO",88,22,26,136,"2011","027"
"689","CASTEL BOGLIONE",25,0,17,42,"2011","024"
"690","CASTEL BOLOGNESE",13,0,0,13,"2011","006"
"691","CASTEL D'AIANO",23,420,60,503,"2011","013"
"692","CASTEL D'ARIO",0,241,666,907,"2011","014"
"693","CASTEL D'AZZANO",907,131,0,1038,"2011","021"
"694","CASTEL DEL RIO",5,12,0,17,"2011","014"
"695","CASTEL DI CASIO",39,26,19,84,"2011","015"
"696","CASTEL GABBIANO",0,1322,0,1322,"2011","024"
"697","CASTEL GOFFREDO",2717,405,480,3602,"2011","015"
"698","CASTEL GUELFO DI BOLOGNA",121,239,0,360,"2011","016"
"699","CASTEL MAGGIORE",8,0,0,8,"2011","019"
"700","CASTEL MELLA",0,330,0,330,"2011","042"
"701","CASTEL ROCCHERO",25,0,0,25,"2011","032"
"702","CASTEL ROZZONE",2,42,0,44,"2011","063"
"703","CASTEL SAN GIOVANNI",240,731,0,971,"2011","013"
"704","CASTEL SAN PIETRO TERME",677,323,0,1000,"2011","020"
"705","CASTELBALDO",8,0,0,8,"2011","029"
"706","CASTELBELFORTE",999,88,0,1087,"2011","013"
"707","CASTELCOVATI",8,314,0,322,"2011","041"
"708","CASTELCUCCO",31,223,0,254,"2011","011"
"709","CASTELDELCI",155,0,1,156,"2011","021"
"710","CASTELDELFINO",68,0,0,68,"2011","047"
"711","CASTELDIDONE",45,0,0,45,"2011","023"
"712","CASTELFRANCO EMILIA",1200,1967,0,3167,"2011","006"
"713","CASTELFRANCO VENETO",5233,211,12,5456,"2011","012"
"714","CASTELGOMBERTO",541,456,0,997,"2011","028"
"715","CASTELGUGLIELMO",481,0,0,481,"2011","011"
"716","CASTELL'ALFERO",440,0,0,440,"2011","025"
"717","CASTELL'ARQUATO",77,692,0,769,"2011","012"
"718","CASTELLAMONTE",105,45,371,521,"2011","066"
"719","CASTELLAR",1,9,0,10,"2011","048"
"720","CASTELLARANO",21,344,0,365,"2011","014"
"721","CASTELLAVAZZO",4,0,0,4,"2011","009"
"722","CASTELLAZZO BORMIDA",0,6,155,161,"2011","047"
"723","CASTELLAZZO NOVARESE",12,0,0,12,"2011","042"
"724","CASTELLEONE",455,3253,0,3708,"2011","025"
"725","CASTELLERO",4,0,0,4,"2011","026"
"726","CASTELLETTO CERVO",0,0,37,37,"2011","015"
"727","CASTELLETTO D'ORBA",7,0,7,14,"2011","049"
"728","CASTELLETTO DI BRANDUZZO",13,0,0,13,"2011","038"
"729","CASTELLETTO MERLI",74,0,0,74,"2011","050"
"730","CASTELLETTO MONFERRATO",19,0,74,93,"2011","051"
"731","CASTELLETTO SOPRA TICINO",98,66,31,195,"2011","043"
"732","CASTELLETTO STURA",1384,67,100,1551,"2011","049"
"733","CASTELLETTO UZZONE",0,0,45,45,"2011","050"
"734","CASTELLI CALEPIO",56,263,0,319,"2011","062"
"735","CASTELLINALDO",862,0,0,862,"2011","051"
"736","CASTELLINO TANARO",113,0,0,113,"2011","052"
"737","CASTELLO CABIAGLIO",8,0,0,8,"2011","043"
"738","CASTELLO D'ARGILE",15,70,32,117,"2011","017"
"739","CASTELLO DELL'ACQUA",18,21,0,39,"2011","014"
"740","CASTELLO DI ANNONE",143,0,0,143,"2011","028"
"741","CASTELLO DI BRIANZA",7,0,0,7,"2011","019"
"742","CASTELLO DI GODEGO",5078,179,7,5264,"2011","013"
"743","CASTELLO DI SERRAVALLE",99,339,0,438,"2011","018"
"744","CASTELLUCCHIO",1075,1720,1064,3859,"2011","016"
"745","CASTELMAGNO",1,16,36,53,"2011","053"
"746","CASTELMARTE",12,1,0,13,"2011","058"
"747","CASTELMASSA",2,97,0,99,"2011","012"
"748","CASTELNOVETTO",1,0,0,1,"2011","040"
"749","CASTELNOVO BARIANO",1606,74,0,1680,"2011","013"
"750","CASTELNOVO DI SOTTO",9,970,2,981,"2011","015"
"751","CASTELNOVO NE' MONTI",92,1360,0,1452,"2011","016"
"752","CASTELNUOVO BELBO",0,0,4,4,"2011","029"
"753","CASTELNUOVO BOCCA D'ADDA",3140,107,0,3247,"2011","013"
"754","CASTELNUOVO BORMIDA",9,0,5,14,"2011","052"
"755","CASTELNUOVO BOZZENTE",8,26,0,34,"2011","059"
"756","CASTELNUOVO CALCEA",1,0,0,1,"2011","030"
"757","CASTELNUOVO DEL GARDA",3125,245,0,3370,"2011","022"
"758","CASTELNUOVO DON BOSCO",203,0,0,203,"2011","031"
"759","CASTELNUOVO NIGRA",0,0,45,45,"2011","067"
"760","CASTELNUOVO RANGONE",39,798,0,837,"2011","007"
"761","CASTELNUOVO SCRIVIA",197,0,0,197,"2011","053"
"762","CASTELSEPRIO",4,0,1,5,"2011","044"
"763","CASTELSPINA",15,0,0,15,"2011","054"
"764","CASTELVECCANA",26,0,10,36,"2011","045"
"765","CASTELVERDE",420,2943,101,3464,"2011","026"
"766","CASTELVETRO DI MODENA",39,1256,0,1295,"2011","008"
"767","CASTELVETRO PIACENTINO",500,838,0,1338,"2011","014"
"768","CASTELVISCONTI",19,1492,0,1511,"2011","027"
"769","CASTENASO",92,208,0,300,"2011","021"
"770","CASTENEDOLO",938,1390,21,2349,"2011","043"
"771","CASTIGLIONE D'ADDA",10,420,0,430,"2011","014"
"772","CASTIGLIONE D'INTELVI",3,8,10,21,"2011","060"
"773","CASTIGLIONE DEI PEPOLI",107,86,0,193,"2011","022"
"774","CASTIGLIONE DELLE STIVIERE",3445,1349,1369,6163,"2011","017"
"775","CASTIGLIONE FALLETTO",26,0,0,26,"2011","055"
"776","CASTIGLIONE OLONA",5,20,6,31,"2011","046"
"777","CASTIGLIONE TINELLA",4,0,19,23,"2011","056"
"778","CASTIGLIONE TORINESE",0,0,7,7,"2011","068"
"779","CASTINO",92,0,87,179,"2011","057"
"780","CASTIONE ANDEVENNO",27,40,3,70,"2011","015"
"781","CASTIONE DELLA PRESOLANA",39,6,0,45,"2011","064"
"782","CASTIRAGA VIDARDO",2,337,0,339,"2011","015"
"783","CASTO",31,39,1,71,"2011","044"
"784","CASTREZZATO",307,1006,0,1313,"2011","045"
"785","CASTRO",2,0,0,2,"2011","065"
"786","CASTROCARO TERME E TERRA DEL SOLE",18,21,0,39,"2011","005"
"787","CASTRONNO",5,0,0,5,"2011","047"
"788","CAVA MANARA",2,0,0,2,"2011","041"
"789","CAVACURTA",123,528,0,651,"2011","016"
"790","CAVAGLIA'",1008,197,230,1435,"2011","016"
"791","CAVAGLIETTO",0,182,0,182,"2011","044"
"792","CAVAGNOLO",16,0,24,40,"2011","069"
"793","CAVAION VERONESE",14,0,0,14,"2011","023"
"794","CAVALLASCA",2,0,30,32,"2011","061"
"795","CAVALLERLEONE",405,823,69,1297,"2011","058"
"796","CAVALLERMAGGIORE",2522,2064,61,4647,"2011","059"
"797","CAVALLINO-TREPORTI",14,0,0,14,"2011","044"
"798","CAVALLIRIO",1,0,0,1,"2011","047"
"799","CAVARGNA",1,0,13,14,"2011","062"
"800","CAVARIA CON PREMEZZO",6,3,0,9,"2011","048"
"801","CAVARZERE",5915,9,1,5925,"2011","006"
"802","CAVASO DEL TOMBA",79,119,0,198,"2011","014"
"803","CAVATORE",0,0,3,3,"2011","055"
"804","CAVENAGO D'ADDA",12,749,167,928,"2011","017"
"805","CAVERNAGO",4,0,0,4,"2011","066"
"806","CAVEZZO",0,300,0,300,"2011","009"
"807","CAVOUR",563,1183,2200,3946,"2011","070"
"808","CAVRIAGO",8,526,0,534,"2011","017"
"809","CAVRIANA",1841,1672,325,3838,"2011","018"
"810","CAZZAGO SAN MARTINO",4361,228,195,4784,"2011","046"
"811","CAZZANO DI TRAMIGNA",7,0,0,7,"2011","024"
"812","CAZZANO SANT'ANDREA",293,10,0,303,"2011","067"
"813","CECIMA",16,0,0,16,"2011","042"
"814","CEDEGOLO",4,27,1,32,"2011","047"
"815","CEDRASCO",0,68,0,68,"2011","016"
"816","CEGGIA",18,2,0,20,"2011","007"
"817","CELLA DATI",323,142,91,556,"2011","028"
"818","CELLA MONTE",187,0,0,187,"2011","056"
"819","CELLARENGO",334,206,0,540,"2011","033"
"820","CELLATICA",5,64,0,69,"2011","048"
"821","CELLE DI MACRA",93,0,10,103,"2011","060"
"822","CELLE ENOMONDO",177,0,0,177,"2011","034"
"823","CELLIO",8,0,0,8,"2011","038"
"824","CENATE SOPRA",22,0,0,22,"2011","068"
"825","CENATE SOTTO",18,0,0,18,"2011","069"
"826","CENCENIGHE AGORDINO",0,11,0,11,"2011","010"
"827","CENE",27,58,0,85,"2011","070"
"828","CENESELLI",14,250,29,293,"2011","014"
"829","CENTALLO",6628,676,379,7683,"2011","061"
"830","CENTO",50,0,0,50,"2011","004"
"831","CEPPO MORELLI",7,0,9,16,"2011","021"
"832","CERANO",79,0,0,79,"2011","049"
"833","CERANO D'INTELVI",6,0,29,35,"2011","063"
"834","CERANOVA",3,546,0,549,"2011","043"
"835","CERCENASCO",29,180,99,308,"2011","071"
"836","CERCINO",13,55,0,68,"2011","017"
"837","CEREA",1412,183,0,1595,"2011","025"
"838","CEREGNANO",1,0,0,1,"2011","015"
"839","CERES",0,0,12,12,"2011","072"
"840","CERESARA",1413,350,99,1862,"2011","019"
"841","CERESETO",105,0,0,105,"2011","057"
"842","CERESOLE ALBA",3357,537,154,4048,"2011","062"
"843","CERESOLE REALE",0,13,11,24,"2011","073"
"844","CERETE",8,173,0,181,"2011","071"
"845","CERETTO LOMELLINA",1,0,0,1,"2011","044"
"846","CERIGNALE",21,0,0,21,"2011","015"
"847","CERMENATE",3,189,0,192,"2011","064"
"848","CERNUSCO LOMBARDONE",23,0,0,23,"2011","020"
"849","CERNUSCO SUL NAVIGLIO",11,158,0,169,"2011","070"
"850","CERRETO CASTELLO",51,56,0,107,"2011","017"
"851","CERRETO D'ASTI",5,0,0,5,"2011","035"
"852","CERRETO GRUE",12,0,75,87,"2011","058"
"853","CERRETTO LANGHE",5,0,13,18,"2011","063"
"854","CERRINA MONFERRATO",28,0,11,39,"2011","059"
"855","CERRIONE",3,403,100,506,"2011","018"
"856","CERRO AL LAMBRO",1,584,0,585,"2011","071"
"857","CERRO MAGGIORE",47,57,0,104,"2011","072"
"858","CERRO TANARO",264,0,0,264,"2011","036"
"859","CERRO VERONESE",28,129,0,157,"2011","026"
"860","CERTOSA DI PAVIA",4,0,0,4,"2011","046"
"861","CERVARESE SANTA CROCE",43,152,109,304,"2011","030"
"862","CERVASCA",1494,227,149,1870,"2011","064"
"863","CERVENO",9,15,0,24,"2011","049"
"864","CERVERE",2041,244,148,2433,"2011","065"
"865","CERVIA",9,0,0,9,"2011","007"
"866","CERVIGNANO D'ADDA",0,912,0,912,"2011","018"
"867","CESANA BRIANZA",6,17,0,23,"2011","021"
"868","CESANA TORINESE",0,0,86,86,"2011","074"
"869","CESANO BOSCONE",0,5,0,5,"2011","074"
"870","CESARA",0,2,5,7,"2011","022"
"871","CESATE",2,0,0,2,"2011","076"
"872","CESENA",123,14,0,137,"2011","007"
"873","CESENATICO",6,100,0,106,"2011","008"
"874","CESIOMAGGIORE",168,99,62,329,"2011","011"
"875","CESSALTO",56,115,18,189,"2011","015"
"876","CESSOLE",148,0,0,148,"2011","037"
"877","CETO",7,43,1,51,"2011","050"
"878","CEVA",991,0,48,1039,"2011","066"
"879","CEVO",30,7,1,38,"2011","051"
"880","CHERASCO",2747,685,1756,5188,"2011","067"
"881","CHIALAMBERTO",0,48,8,56,"2011","075"
"882","CHIAMPO",51,97,0,148,"2011","029"
"883","CHIANOCCO",1,0,72,73,"2011","076"
"884","CHIARANO",24,283,3,310,"2011","016"
"885","CHIARI",1276,4575,89,5940,"2011","052"
"886","CHIAVENNA",8,32,0,40,"2011","018"
"887","CHIAVERANO",1,0,28,29,"2011","077"
"888","CHIERI",2853,393,57,3303,"2011","078"
"889","CHIES D'ALPAGO",12,10,0,22,"2011","012"
"890","CHIESA IN VALMALENCO",4,46,2,52,"2011","019"
"891","CHIESANUOVA",0,85,47,132,"2011","079"
"892","CHIEVE",188,881,0,1069,"2011","029"
"893","CHIGNOLO D'ISOLA",82,268,0,350,"2011","072"
"894","CHIGNOLO PO",27,61,0,88,"2011","048"
"895","CHIOGGIA",2286,0,0,2286,"2011","008"
"896","CHIOMONTE",1,0,19,20,"2011","080"
"897","CHIUDUNO",64,6,0,70,"2011","073"
"898","CHIUPPANO",10,36,0,46,"2011","030"
"899","CHIURO",60,110,0,170,"2011","020"
"900","CHIUSA DI PESIO",1390,266,183,1839,"2011","068"
"901","CHIUSA DI SAN MICHELE",0,0,54,54,"2011","081"
"902","CHIUSANO D'ASTI",20,0,0,20,"2011","038"
"903","CHIVASSO",1380,312,229,1921,"2011","082"
"904","CICOGNOLO",0,765,0,765,"2011","030"
"905","CICONIO",16,55,93,164,"2011","083"
"906","CIGLIANO",329,93,0,422,"2011","042"
"907","CIGLIE'",442,0,34,476,"2011","069"
"908","CIGOGNOLA",1,0,0,1,"2011","049"
"909","CIGOLE",1248,1456,0,2704,"2011","053"
"910","CILAVEGNA",13,47,0,60,"2011","050"
"911","CIMADOLMO",20,168,10,198,"2011","017"
"912","CIMBERGO",3,0,0,3,"2011","054"
"913","CINAGLIO",1006,0,0,1006,"2011","039"
"914","CINGIA DE' BOTTI",0,1033,0,1033,"2011","031"
"915","CINO",9,12,0,21,"2011","021"
"916","CINTANO",2,4,28,34,"2011","084"
"917","CINTO CAOMAGGIORE",459,44,0,503,"2011","009"
"918","CINTO EUGANEO",80,31,0,111,"2011","031"
"919","CINZANO",0,0,7,7,"2011","085"
"920","CIRIE'",22,276,259,557,"2011","086"
"921","CIRIMIDO",8,24,0,32,"2011","068"
"922","CISANO BERGAMASCO",18,0,0,18,"2011","074"
"923","CISERANO",19,36,0,55,"2011","075"
"924","CISLAGO",22,0,0,22,"2011","050"
"925","CISLIANO",245,469,1,715,"2011","078"
"926","CISMON DEL GRAPPA",2,2,0,4,"2011","031"
"927","CISON DI VALMARINO",79,34,3,116,"2011","018"
"928","CISSONE",0,0,9,9,"2011","070"
"929","CISTERNA D'ASTI",89,0,0,89,"2011","040"
"930","CITTADELLA",1492,1080,414,2986,"2011","032"
"931","CITTIGLIO",22,23,0,45,"2011","051"
"932","CIVATE",5,0,0,5,"2011","022"
"933","CIVENNA",5,19,0,24,"2011","070"
"934","CIVIASCO",5,6,0,11,"2011","043"
"935","CIVIDATE AL PIANO",583,596,0,1179,"2011","076"
"936","CIVIDATE CAMUNO",6,0,0,6,"2011","055"
"937","CIVITELLA DI ROMAGNA",535,0,33,568,"2011","009"
"938","CIVO",15,25,0,40,"2011","022"
"939","CLAINO CON OSTENO",2,0,7,9,"2011","071"
"940","CLAVESANA",390,0,0,390,"2011","071"
"941","CLIVIO",24,50,0,74,"2011","052"
"942","CLUSONE",89,205,0,294,"2011","077"
"943","COASSOLO TORINESE",0,0,63,63,"2011","088"
"944","COAZZE",0,12,8,20,"2011","089"
"945","COAZZOLO",41,0,0,41,"2011","041"
"946","COCCAGLIO",433,585,18,1036,"2011","056"
"947","COCCONATO",115,0,0,115,"2011","042"
"948","COCQUIO-TREVISAGO",22,0,0,22,"2011","053"
"949","CODEVIGO",625,134,12,771,"2011","033"
"950","CODEVILLA",2,0,0,2,"2011","051"
"951","CODIGORO",4621,0,194,4815,"2011","005"
"952","CODOGNE'",48,224,0,272,"2011","019"
"953","CODOGNO",16,820,0,836,"2011","019"
"954","COGGIOLA",4,0,0,4,"2011","019"
"955","COGOLLO DEL CENGIO",771,136,0,907,"2011","032"
"956","COLERE",4,0,0,4,"2011","078"
"957","COLI",42,0,0,42,"2011","016"
"958","COLICO",91,126,20,237,"2011","023"
"959","COLLAGNA",7,53,0,60,"2011","019"
"960","COLLE BRIANZA",16,7,2,25,"2011","024"
"961","COLLE SANTA LUCIA",0,15,0,15,"2011","014"
"962","COLLE UMBERTO",25,238,0,263,"2011","020"
"963","COLLECCHIO",6,2225,0,2231,"2011","009"
"964","COLLEGNO",8,228,173,409,"2011","090"
"965","COLLERETTO CASTELNUOVO",2,0,27,29,"2011","091"
"966","COLLERETTO GIACOSA",0,0,32,32,"2011","092"
"967","COLLIO",57,73,0,130,"2011","058"
"968","COLOGNA VENETA",9592,179,0,9771,"2011","027"
"969","COLOGNE",428,579,0,1007,"2011","059"
"970","COLOGNO AL SERIO",140,869,0,1009,"2011","079"
"971","COLOGNO MONZESE",4,0,0,4,"2011","081"
"972","COLOGNOLA AI COLLI",5,0,0,5,"2011","028"
"973","COLORINA",44,378,0,422,"2011","023"
"974","COLORNO",21,1315,0,1336,"2011","010"
"975","COLTURANO",0,54,0,54,"2011","082"
"976","COLZATE",14,53,0,67,"2011","080"
"977","COMACCHIO",259,200,0,459,"2011","006"
"978","COMAZZO",58,581,15,654,"2011","020"
"979","COMELICO SUPERIORE",12,133,0,145,"2011","015"
"980","COMERIO",5,0,0,5,"2011","055"
"981","COMEZZANO-CIZZAGO",239,1492,0,1731,"2011","060"
"982","COMIGNAGO",4,0,0,4,"2011","052"
"983","COMMESSAGGIO",27,13,0,40,"2011","020"
"984","COMO",9,51,6,66,"2011","075"
"985","COMPIANO",12,0,0,12,"2011","011"
"986","COMUN NUOVO",120,36,0,156,"2011","081"
"987","CONA",11340,0,0,11340,"2011","010"
"988","CONCAMARISE",1,219,0,220,"2011","029"
"989","CONCESIO",17,30,0,47,"2011","061"
"990","CONCO",37,247,1,285,"2011","033"
"991","CONCORDIA SAGITTARIA",1158,274,0,1432,"2011","011"
"992","CONCORDIA SULLA SECCHIA",322,339,76,737,"2011","010"
"993","CONDOVE",3,14,215,232,"2011","093"
"994","CONEGLIANO",70,115,0,185,"2011","021"
"995","CONFIENZA",53,104,0,157,"2011","052"
"996","CONIOLO",228,0,0,228,"2011","060"
"997","CONSELICE",601,235,0,836,"2011","008"
"998","CONSELVE",1085,33,0,1118,"2011","034"
"999","CONZANO",39,0,92,131,"2011","061"
"1000","COPPARO",109,0,0,109,"2011","007"
"1001","CORBETTA",1030,80,0,1110,"2011","085"
"1002","CORBOLA",120,144,0,264,"2011","017"
"1003","CORDIGNANO",131,303,0,434,"2011","022"
"1004","CORIANO",42,201,0,243,"2011","003"
"1005","CORIO",0,32,161,193,"2011","094"
"1006","CORNA IMAGNA",26,18,0,44,"2011","082"
"1007","CORNALBA",2,16,0,18,"2011","249"
"1008","CORNAREDO",33,170,6,209,"2011","087"
"1009","CORNEDO VICENTINO",12,149,0,161,"2011","034"
"1010","CORNEGLIANO LAUDENSE",0,225,0,225,"2011","021"
"1011","CORNELIANO D'ALBA",39,0,91,130,"2011","072"
"1012","CORNIGLIO",36,453,0,489,"2011","012"
"1013","CORNO GIOVINE",145,93,0,238,"2011","022"
"1014","CORNOVECCHIO",115,0,0,115,"2011","023"
"1015","CORNUDA",1584,347,0,1931,"2011","023"
"1016","CORREGGIO",7,1917,3,1927,"2011","020"
"1017","CORREZZOLA",5514,20,0,5534,"2011","035"
"1018","CORRIDO",12,2,9,23,"2011","077"
"1019","CORSIONE",4,0,0,4,"2011","044"
"1020","CORTANZE",10,0,64,74,"2011","046"
"1021","CORTAZZONE",15,0,0,15,"2011","047"
"1022","CORTE BRUGNATELLA",102,9,0,111,"2011","017"
"1023","CORTE DE' CORTESI CON CIGNONE",11,121,0,132,"2011","032"
"1024","CORTE DE' FRATI",64,1025,0,1089,"2011","033"
"1025","CORTE FRANCA",103,77,3,183,"2011","062"
"1026","CORTE PALASIO",4,1683,0,1687,"2011","024"
"1027","CORTEMAGGIORE",185,1570,0,1755,"2011","018"
"1028","CORTEMILIA",44,0,181,225,"2011","073"
"1029","CORTENO GOLGI",11,106,6,123,"2011","063"
"1030","CORTENOVA",7,33,0,40,"2011","025"
"1031","CORTENUOVA",212,1093,0,1305,"2011","083"
"1032","CORTEOLONA",11,0,0,11,"2011","056"
"1033","CORTIGLIONE",10,0,0,10,"2011","048"
"1034","CORTINA D'AMPEZZO",25,33,0,58,"2011","016"
"1035","CORVINO SAN QUIRICO",2,0,0,2,"2011","057"
"1036","CORZANO",126,243,0,369,"2011","064"
"1037","COSIO VALTELLINO",10,626,0,636,"2011","024"
"1038","COSSANO BELBO",219,0,121,340,"2011","074"
"1039","COSSANO CANAVESE",0,0,2,2,"2011","095"
"1040","COSSATO",61,167,135,363,"2011","020"
"1041","COSSOGNO",1,0,2,3,"2011","023"
"1042","COSTA DE' NOBILI",88,50,0,138,"2011","058"
"1043","COSTA DI MEZZATE",31,0,0,31,"2011","084"
"1044","COSTA DI ROVIGO",0,202,0,202,"2011","018"
"1045","COSTA MASNAGA",23,12,0,35,"2011","026"
"1046","COSTA SERINA",13,10,0,23,"2011","247"
"1047","COSTA VALLE IMAGNA",4,0,0,4,"2011","085"
"1048","COSTA VESCOVATO",7,0,13,20,"2011","062"
"1049","COSTA VOLPINO",28,18,0,46,"2011","086"
"1050","COSTABISSARA",34,77,0,111,"2011","035"
"1051","COSTERMANO",8,38,20,66,"2011","030"
"1052","COSTIGLIOLE D'ASTI",620,0,6,626,"2011","050"
"1053","COSTIGLIOLE SALUZZO",518,66,0,584,"2011","075"
"1054","COTIGNOLA",104,0,0,104,"2011","009"
"1055","COVO",1020,1307,0,2327,"2011","087"
"1056","CRANDOLA VALSASSINA",10,7,0,17,"2011","027"
"1057","CRAVAGLIANA",0,2,0,2,"2011","048"
"1058","CRAVANZANA",2,0,0,2,"2011","076"
"1059","CRAVEGGIA",0,0,17,17,"2011","024"
"1060","CREAZZO",9,33,0,42,"2011","036"
"1061","CREDARO",4,145,0,149,"2011","088"
"1062","CREDERA RUBBIANO",0,1401,0,1401,"2011","034"
"1063","CREMA",631,1874,0,2505,"2011","035"
"1064","CREMELLA",9,0,0,9,"2011","028"
"1065","CREMENAGA",1,0,0,1,"2011","056"
"1066","CREMENO",6,14,36,56,"2011","029"
"1067","CREMIA",5,6,1,12,"2011","083"
"1068","CREMOLINO",67,0,20,87,"2011","063"
"1069","CREMONA",134,1803,0,1937,"2011","036"
"1070","CREMOSANO",18,547,0,565,"2011","037"
"1071","CRESCENTINO",78,45,15,138,"2011","049"
"1072","CRESPADORO",29,92,0,121,"2011","037"
"1073","CRESPANO DEL GRAPPA",1463,633,0,2096,"2011","024"
"1074","CRESPELLANO",338,89,0,427,"2011","023"
"1075","CRESPIATICA",75,267,0,342,"2011","025"
"1076","CRESPINO",2211,0,0,2211,"2011","019"
"1077","CRESSA",21,217,15,253,"2011","055"
"1078","CREVACUORE",6,0,0,6,"2011","021"
"1079","CREVALCORE",466,26,0,492,"2011","024"
"1080","CREVOLADOSSOLA",65,48,6,119,"2011","025"
"1081","CROCETTA DEL MONTELLO",42,61,1,104,"2011","025"
"1082","CRODO",25,103,20,148,"2011","026"
"1083","CROSIO DELLA VALLE",8,0,0,8,"2011","057"
"1084","CROTTA D'ADDA",0,480,0,480,"2011","038"
"1085","CROVA",1,0,0,1,"2011","052"
"1086","CUASSO AL MONTE",17,0,0,17,"2011","058"
"1087","CUCCARO MONFERRATO",11,0,5,16,"2011","064"
"1088","CUCCIAGO",7,0,4,11,"2011","084"
"1089","CUCEGLIO",0,0,51,51,"2011","096"
"1090","CUGGIONO",518,60,0,578,"2011","096"
"1091","CUGLIATE-FABIASCO",1,0,0,1,"2011","059"
"1092","CUMIANA",401,362,958,1721,"2011","097"
"1093","CUMIGNANO SUL NAVIGLIO",0,1140,0,1140,"2011","039"
"1094","CUNARDO",1,0,1,2,"2011","060"
"1095","CUNEO",8686,722,1771,11179,"2011","078"
"1096","CUNICO",1466,0,47,1513,"2011","051"
"1097","CUORGNE'",154,15,130,299,"2011","098"
"1098","CURA CARPIGNANO",2,176,0,178,"2011","060"
"1099","CUREGGIO",21,34,8,63,"2011","058"
"1100","CURIGLIA CON MONTEVIASCO",0,2,1,3,"2011","061"
"1101","CURINO",0,0,5,5,"2011","023"
"1102","CURNO",75,88,0,163,"2011","089"
"1103","CURSOLO-ORASSO",0,0,12,12,"2011","027"
"1104","CURTAROLO",84,201,56,341,"2011","036"
"1105","CURTATONE",3753,1318,1278,6349,"2011","021"
"1106","CUSAGO",122,237,7,366,"2011","097"
"1107","CUSINO",4,0,0,4,"2011","085"
"1108","CUSIO",2,0,0,2,"2011","090"
"1109","CUVEGLIO",5,0,0,5,"2011","062"
"1110","CUVIO",3,62,0,65,"2011","063"
"1111","DAIRAGO",23,21,0,44,"2011","099"
"1112","DALMINE",74,127,0,201,"2011","091"
"1113","DARFO BOARIO TERME",9,280,3,292,"2011","065"
"1114","DAVERIO",23,0,0,23,"2011","064"
"1115","DAZIO",0,19,0,19,"2011","025"
"1116","DELEBIO",46,176,0,222,"2011","026"
"1117","DELLO",360,1629,0,1989,"2011","066"
"1118","DEMONTE",1472,153,6,1631,"2011","079"
"1119","DENICE",2,0,6,8,"2011","065"
"1120","DERNICE",11,6,2,19,"2011","066"
"1121","DEROVERE",10,343,0,353,"2011","040"
"1122","DERVIO",1,0,0,1,"2011","030"
"1123","DESANA",40,0,0,40,"2011","054"
"1124","DESENZANO DEL GARDA",231,1687,0,1918,"2011","067"
"1125","DIANO D'ALBA",141,0,31,172,"2011","080"
"1126","DIVIGNANO",45,30,5,80,"2011","060"
"1127","DIZZASCO",0,0,4,4,"2011","087"
"1128","DOGLIANI",1747,0,0,1747,"2011","081"
"1129","DOLO",581,227,0,808,"2011","012"
"1130","DOMASO",5,7,2,14,"2011","089"
"1131","DOMEGGE DI CADORE",0,4,0,4,"2011","018"
"1132","DOMODOSSOLA",22,12,19,53,"2011","028"
"1133","DONATO",6,24,139,169,"2011","024"
"1134","DONGO",5,2,2,9,"2011","090"
"1135","DORIO",3,0,0,3,"2011","032"
"1136","DORMELLETTO",2,2,0,4,"2011","062"
"1137","DORNO",13,17,51,81,"2011","061"
"1138","DORZANO",0,0,1,1,"2011","025"
"1139","DOSOLO",212,188,120,520,"2011","022"
"1140","DOSSENA",11,61,0,72,"2011","092"
"1141","DOSSO DEL LIRO",13,2,7,22,"2011","092"
"1142","DOVADOLA",106,0,0,106,"2011","011"
"1143","DOVERA",25,1417,0,1442,"2011","041"
"1144","DOZZA",16,22,0,38,"2011","025"
"1145","DRESANO",13,0,0,13,"2011","101"
"1146","DREZZO",6,0,3,9,"2011","093"
"1147","DRIZZONA",0,415,0,415,"2011","042"
"1148","DRONERO",2103,165,164,2432,"2011","082"
"1149","DRUENTO",324,130,317,771,"2011","099"
"1150","DRUOGNO",5,7,7,19,"2011","029"
"1151","DUBINO",8,586,6,600,"2011","027"
"1152","DUE CARRARE",162,0,0,162,"2011","106"
"1153","DUEVILLE",492,570,0,1062,"2011","038"
"1154","DUMENZA",4,0,6,10,"2011","065"
"1155","DUSINO SAN MICHELE",430,48,4,482,"2011","052"
"1156","EDOLO",12,65,2,79,"2011","068"
"1157","ELLO",4,0,3,7,"2011","033"
"1158","ELVA",21,0,20,41,"2011","083"
"1159","ENDINE GAIANO",41,133,0,174,"2011","093"
"1160","ENEGO",33,209,5,247,"2011","039"
"1161","ENTRACQUE",77,0,0,77,"2011","084"
"1162","ENTRATICO",70,10,0,80,"2011","094"
"1163","ENVIE",2099,520,71,2690,"2011","085"
"1164","ERACLEA",3844,333,0,4177,"2011","013"
"1165","ERBA",75,338,17,430,"2011","095"
"1166","ERBE'",220,27,0,247,"2011","032"
"1167","ERBEZZO",16,689,35,740,"2011","033"
"1168","ERBUSCO",229,61,0,290,"2011","069"
"1169","ERVE",8,0,0,8,"2011","034"
"1170","ESINE",7,167,4,178,"2011","070"
"1171","ESINO LARIO",16,0,0,16,"2011","035"
"1172","ESTE",719,63,0,782,"2011","037"
"1173","EUPILIO",4,31,11,46,"2011","097"
"1174","FABBRICA CURONE",9,30,1,40,"2011","067"
"1175","FABBRICO",551,146,0,697,"2011","021"
"1176","FAEDO VALTELLINO",7,10,0,17,"2011","028"
"1177","FAENZA",272,115,0,387,"2011","010"
"1178","FAGGETO LARIO",10,0,2,12,"2011","098"
"1179","FAGNANO OLONA",25,103,9,137,"2011","067"
"1180","FALCADE",5,27,0,32,"2011","019"
"1181","FALMENTA",0,0,2,2,"2011","030"
"1182","FALOPPIO",1,0,16,17,"2011","099"
"1183","FANANO",74,454,0,528,"2011","011"
"1184","FARA GERA D'ADDA",220,447,0,667,"2011","096"
"1185","FARA NOVARESE",0,0,4,4,"2011","065"
"1186","FARA OLIVANA CON SOLA",385,277,0,662,"2011","097"
"1187","FARA VICENTINO",990,603,121,1714,"2011","040"
"1188","FARIGLIANO",540,0,0,540,"2011","086"
"1189","FARINI",105,120,0,225,"2011","019"
"1190","FARRA D'ALPAGO",4,96,0,100,"2011","020"
"1191","FARRA DI SOLIGO",100,79,0,179,"2011","026"
"1192","FAULE",27,99,0,126,"2011","087"
"1193","FAVRIA",28,235,574,837,"2011","101"
"1194","FEISOGLIO",79,0,0,79,"2011","088"
"1195","FELETTO",0,0,51,51,"2011","102"
"1196","FELINO",37,1073,0,1110,"2011","013"
"1197","FELIZZANO",20,0,25,45,"2011","068"
"1198","FELONICA",13,0,0,13,"2011","023"
"1199","FELTRE",169,1101,71,1341,"2011","021"
"1200","FENEGRO'",7,13,45,65,"2011","100"
"1201","FENESTRELLE",0,0,20,20,"2011","103"
"1202","FERNO",1,31,0,32,"2011","068"
"1203","FERRARA",343,239,0,582,"2011","008"
"1204","FERRARA DI MONTE BALDO",5,51,0,56,"2011","034"
"1205","FERRERA DI VARESE",19,0,0,19,"2011","069"
"1206","FERRERA ERBOGNONE",49,25,0,74,"2011","062"
"1207","FERRERE",1143,0,9,1152,"2011","053"
"1208","FERRIERE",151,14,0,165,"2011","020"
"1209","FIANO",2,0,10,12,"2011","104"
"1210","FICAROLO",11,0,0,11,"2011","021"
"1211","FIDENZA",383,3140,41,3564,"2011","014"
"1212","FIESCO",32,440,0,472,"2011","043"
"1213","FIESSE",1171,410,15,1596,"2011","071"
"1214","FIESSO D'ARTICO",7,40,0,47,"2011","014"
"1215","FIESSO UMBERTIANO",117,31,0,148,"2011","022"
"1216","FIGINO SERENZA",63,80,0,143,"2011","101"
"1217","FILAGO",13,29,0,42,"2011","098"
"1218","FILIGHERA",0,135,0,135,"2011","063"
"1219","FINALE EMILIA",71,65,0,136,"2011","012"
"1220","FINO DEL MONTE",29,0,0,29,"2011","099"
"1221","FINO MORNASCO",13,0,5,18,"2011","102"
"1222","FIORANO AL SERIO",12,16,0,28,"2011","100"
"1223","FIORANO CANAVESE",0,0,10,10,"2011","105"
"1224","FIORANO MODENESE",18,66,0,84,"2011","013"
"1225","FIORENZUOLA D'ARDA",161,1910,0,2071,"2011","021"
"1226","FIUMALBO",127,80,0,207,"2011","014"
"1227","FLERO",444,365,0,809,"2011","072"
"1228","FOBELLO",4,0,2,6,"2011","057"
"1229","FOGLIZZO",110,0,40,150,"2011","106"
"1230","FOLLINA",294,97,0,391,"2011","027"
"1231","FOMBIO",233,356,0,589,"2011","026"
"1232","FONTANELICE",144,198,0,342,"2011","026"
"1233","FONTANELLA",3289,2013,0,5302,"2011","101"
"1234","FONTANELLATO",164,2162,0,2326,"2011","015"
"1235","FONTANELLE",100,747,13,860,"2011","028"
"1236","FONTANETO D'AGOGNA",4,63,0,67,"2011","066"
"1237","FONTANETTO PO",9,0,0,9,"2011","058"
"1238","FONTANILE",5,0,0,5,"2011","054"
"1239","FONTANIVA",284,313,17,614,"2011","038"
"1240","FONTE",1184,508,0,1692,"2011","029"
"1241","FONTENO",19,3,0,22,"2011","102"
"1242","FONTEVIVO",0,1130,0,1130,"2011","016"
"1243","FONZASO",257,57,0,314,"2011","022"
"1244","FOPPOLO",0,16,0,16,"2011","103"
"1245","FORCOLA",6,146,0,152,"2011","029"
"1246","FORESTO SPARSO",19,77,0,96,"2011","104"
"1247","FORLI'",582,163,68,813,"2011","012"
"1248","FORLIMPOPOLI",26,14,0,40,"2011","013"
"1249","FORMAZZA",0,13,12,25,"2011","031"
"1250","FORMIGARA",1,943,192,1136,"2011","044"
"1251","FORMIGINE",23,1620,0,1643,"2011","015"
"1252","FORMIGLIANA",25,0,0,25,"2011","059"
"1253","FORMIGNANA",17,0,0,17,"2011","009"
"1254","FORNO CANAVESE",56,0,6,62,"2011","107"
"1255","FORNO DI ZOLDO",8,0,0,8,"2011","024"
"1256","FORNOVO DI TARO",16,348,0,364,"2011","017"
"1257","FORNOVO SAN GIOVANNI",28,789,0,817,"2011","105"
"1258","FORTUNAGO",27,0,0,27,"2011","064"
"1259","FOSSALTA DI PIAVE",9,0,0,9,"2011","015"
"1260","FOSSALTA DI PORTOGRUARO",1,195,682,878,"2011","016"
"1261","FOSSANO",18377,3460,1207,23044,"2011","089"
"1262","FOSSO'",146,17,0,163,"2011","017"
"1263","FOZA",58,51,2,111,"2011","041"
"1264","FRABOSA SOPRANA",96,306,0,402,"2011","090"
"1265","FRABOSA SOTTANA",453,1,35,489,"2011","091"
"1266","FRACONALTO",3,0,6,9,"2011","069"
"1267","FRANCAVILLA BISIO",1,0,0,1,"2011","070"
"1268","FRASCARO",0,20,0,20,"2011","071"
"1269","FRASCAROLO",77,56,0,133,"2011","065"
"1270","FRASSINELLE POLESINE",508,0,0,508,"2011","023"
"1271","FRASSINELLO MONFERRATO",60,0,0,60,"2011","072"
"1272","FRASSINETO PO",0,0,27,27,"2011","073"
"1273","FRASSINETTO",15,38,52,105,"2011","108"
"1274","FRASSINO",26,3,0,29,"2011","092"
"1275","FRASSINORO",149,143,3,295,"2011","016"
"1276","FRATTA POLESINE",168,115,13,296,"2011","024"
"1277","FREGONA",18,48,0,66,"2011","030"
"1278","FRESONARA",16,0,9,25,"2011","074"
"1279","FRINCO",188,0,55,243,"2011","055"
"1280","FRONT",0,0,67,67,"2011","109"
"1281","FROSSASCO",757,76,951,1784,"2011","110"
"1282","FRUGAROLO",38,136,169,343,"2011","075"
"1283","FUBINE",383,0,0,383,"2011","076"
"1284","FUIPIANO VALLE IMAGNA",8,48,0,56,"2011","106"
"1285","FUMANE",19,28,0,47,"2011","035"
"1286","FUSIGNANO",9,0,0,9,"2011","011"
"1287","FUSINE",3,28,0,31,"2011","030"
"1288","GABBIONETA-BINANUOVA",140,516,0,656,"2011","045"
"1289","GABIANO",80,0,0,80,"2011","077"
"1290","GADESCO-PIEVE DELMONA",1,393,46,440,"2011","046"
"1291","GAGGIANO",79,459,0,538,"2011","103"
"1292","GAGGIO MONTANO",183,352,4,539,"2011","027"
"1293","GAGLIANICO",0,0,4,4,"2011","026"
"1294","GAIARINE",505,12,0,517,"2011","031"
"1295","GAIBA",21,0,0,21,"2011","025"
"1296","GAIOLA",0,1,0,1,"2011","093"
"1297","GALBIATE",53,13,0,66,"2011","036"
"1298","GALEATA",233,0,22,255,"2011","014"
"1299","GALGAGNANO",0,784,0,784,"2011","027"
"1300","GALLARATE",4,70,0,74,"2011","070"
"1301","GALLIATE",30,16,10,56,"2011","068"
"1302","GALLIATE LOMBARDO",11,0,0,11,"2011","071"
"1303","GALLIERA",15,42,0,57,"2011","028"
"1304","GALLIERA VENETA",1385,121,0,1506,"2011","039"
"1305","GALLIO",16,208,0,224,"2011","042"
"1306","GALZIGNANO TERME",29,0,0,29,"2011","040"
"1307","GAMALERO",1,0,17,18,"2011","078"
"1308","GAMBARA",5478,1841,244,7563,"2011","073"
"1309","GAMBARANA",0,5,0,5,"2011","067"
"1310","GAMBASCA",4,0,0,4,"2011","094"
"1311","GAMBELLARA",8,0,0,8,"2011","043"
"1312","GAMBOLO'",109,149,0,258,"2011","068"
"1313","GAMBUGLIANO",9,54,0,63,"2011","044"
"1314","GANDELLINO",5,13,0,18,"2011","107"
"1315","GANDINO",51,135,0,186,"2011","108"
"1316","GANDOSSO",3,31,0,34,"2011","109"
"1317","GARBAGNA",55,0,36,91,"2011","079"
"1318","GARBAGNA NOVARESE",0,2,0,2,"2011","069"
"1319","GARBAGNATE MONASTERO",9,0,0,9,"2011","037"
"1320","GARDA",2,0,0,2,"2011","036"
"1321","GARDONE RIVIERA",11,0,0,11,"2011","074"
"1322","GARDONE VAL TROMPIA",37,0,0,37,"2011","075"
"1323","GARESSIO",146,0,5,151,"2011","095"
"1324","GARGALLO",0,0,3,3,"2011","070"
"1325","GARGNANO",20,0,32,52,"2011","076"
"1326","GARLASCO",15,0,0,15,"2011","069"
"1327","GARLATE",3,0,0,3,"2011","038"
"1328","GARZENO",14,10,7,31,"2011","106"
"1329","GARZIGLIANA",0,41,323,364,"2011","111"
"1330","GASSINO TORINESE",2,0,32,34,"2011","112"
"1331","GATTATICO",33,1903,0,1936,"2011","022"
"1332","GATTEO",2,0,0,2,"2011","016"
"1333","GATTICO",13,123,142,278,"2011","071"
"1334","GATTINARA",38,0,0,38,"2011","061"
"1335","GAVARDO",107,417,0,524,"2011","077"
"1336","GAVERINA TERME",26,38,0,64,"2011","110"
"1337","GAVI",70,0,9,79,"2011","081"
"1338","GAVIRATE",57,0,0,57,"2011","072"
"1339","GAZOLDO DEGLI IPPOLITI",496,98,0,594,"2011","024"
"1340","GAZZADA SCHIANNO",7,8,0,15,"2011","073"
"1341","GAZZANIGA",18,58,0,76,"2011","111"
"1342","GAZZO",592,2594,1,3187,"2011","041"
"1343","GAZZO VERONESE",993,265,0,1258,"2011","037"
"1344","GAZZOLA",141,1272,0,1413,"2011","022"
"1345","GAZZUOLO",670,43,37,750,"2011","025"
"1346","GEMMANO",27,55,0,82,"2011","004"
"1347","GEMONIO",2,0,1,3,"2011","074"
"1348","GENIVOLTA",23,1783,136,1942,"2011","047"
"1349","GENOLA",1866,1081,92,3039,"2011","096"
"1350","GENZONE",220,63,0,283,"2011","070"
"1351","GERA LARIO",76,193,0,269,"2011","107"
"1352","GERENZAGO",0,67,0,67,"2011","071"
"1353","GERENZANO",53,61,0,114,"2011","075"
"1354","GERMAGNANO",0,1,9,10,"2011","113"
"1355","GERMAGNO",0,0,2,2,"2011","032"
"1356","GERMIGNAGA",16,48,0,64,"2011","076"
"1357","GEROLA ALTA",1,0,0,1,"2011","031"
"1358","GEROSA",22,9,0,31,"2011","112"
"1359","GERRE DE' CAPRIOLI",0,313,0,313,"2011","048"
"1360","GESSATE",28,333,0,361,"2011","106"
"1361","GHEDI",3828,6343,27,10198,"2011","078"
"1362","GHEMME",15,1,57,73,"2011","073"
"1363","GHIFFA",1,0,1,2,"2011","033"
"1364","GHISALBA",13,723,0,736,"2011","113"
"1365","GHISLARENGO",23,0,0,23,"2011","062"
"1366","GIACCIANO CON BARUCHELLA",1,0,13,14,"2011","027"
"1367","GIAGLIONE",0,0,12,12,"2011","114"
"1368","GIANICO",125,164,83,372,"2011","079"
"1369","GIAVENO",31,413,307,751,"2011","115"
"1370","GIAVERA DEL MONTELLO",610,136,0,746,"2011","032"
"1371","GIFFLENGA",3,0,0,3,"2011","027"
"1372","GIGNESE",0,0,4,4,"2011","034"
"1373","GIRONICO",36,83,7,126,"2011","109"
"1374","GIUSSAGO",80,185,0,265,"2011","072"
"1375","GIVOLETTO",0,0,20,20,"2011","116"
"1376","GODEGA DI SANT'URBANO",48,153,2,203,"2011","033"
"1377","GODIASCO",23,0,0,23,"2011","073"
"1378","GOITO",3012,4090,1001,8103,"2011","026"
"1379","GOLASECCA",26,33,0,59,"2011","077"
"1380","GOLFERENZO",0,0,10,10,"2011","074"
"1381","GOMBITO",9,796,0,805,"2011","049"
"1382","GONZAGA",18569,2965,1962,23496,"2011","027"
"1383","GORDONA",85,135,3,223,"2011","032"
"1384","GORGO AL MONTICANO",61,385,30,476,"2011","034"
"1385","GORGONZOLA",13,321,0,334,"2011","108"
"1386","GORLA MAGGIORE",27,161,0,188,"2011","078"
"1387","GORLA MINORE",8,0,1,9,"2011","079"
"1388","GORLAGO",40,272,0,312,"2011","114"
"1389","GORLE",2,0,0,2,"2011","115"
"1390","GORNATE-OLONA",13,0,2,15,"2011","080"
"1391","GORNO",38,88,0,126,"2011","116"
"1392","GORZEGNO",2,0,46,48,"2011","097"
"1393","GOSSOLENGO",69,487,0,556,"2011","023"
"1394","GOTTASECCA",43,0,0,43,"2011","098"
"1395","GOTTOLENGO",13197,1442,18,14657,"2011","080"
"1396","GOVONE",250,0,76,326,"2011","099"
"1397","GOZZANO",6,1,2,9,"2011","076"
"1398","GRAFFIGNANA",54,167,115,336,"2011","028"
"1399","GRAGLIA",17,87,117,221,"2011","028"
"1400","GRAGNANO TREBBIENSE",46,2139,0,2185,"2011","024"
"1401","GRANA",64,0,0,64,"2011","056"
"1402","GRANAGLIONE",2,0,0,2,"2011","029"
"1403","GRANAROLO DELL'EMILIA",82,156,0,238,"2011","030"
"1404","GRANCONA",30,131,0,161,"2011","045"
"1405","GRANDATE",1,0,0,1,"2011","110"
"1406","GRANDOLA ED UNITI",4,37,14,55,"2011","111"
"1407","GRANOZZO CON MONTICELLO",3,44,0,47,"2011","077"
"1408","GRANTOLA",62,0,0,62,"2011","081"
"1409","GRANTORTO",90,981,5,1076,"2011","042"
"1410","GRANZE",1067,0,0,1067,"2011","043"
"1411","GRASSOBBIO",9,179,0,188,"2011","117"
"1412","GRAVEDONA ED UNITI",16,19,103,138,"2011","249"
"1413","GRAVELLONA LOMELLINA",47,77,0,124,"2011","075"
"1414","GRAVELLONA TOCE",2,0,17,19,"2011","035"
"1415","GRAVERE",1,0,1,2,"2011","117"
"1416","GRAZZANO BADOGLIO",442,0,0,442,"2011","057"
"1417","GREMIASCO",34,0,5,39,"2011","083"
"1418","GREZZAGO",33,0,0,33,"2011","110"
"1419","GREZZANA",170,740,0,910,"2011","038"
"1420","GRIANTE",2,0,4,6,"2011","113"
"1421","GRIGNASCO",2,51,0,53,"2011","079"
"1422","GRINZANE CAVOUR",0,0,50,50,"2011","100"
"1423","GRISIGNANO DI ZOCCO",42,702,5,749,"2011","046"
"1424","GRIZZANA MORANDI",55,0,0,55,"2011","031"
"1425","GROMO",56,85,0,141,"2011","118"
"1426","GRONDONA",1,0,2,3,"2011","085"
"1427","GRONE",26,19,0,45,"2011","119"
"1428","GRONTARDO",0,1794,0,1794,"2011","050"
"1429","GROPELLO CAIROLI",53,0,0,53,"2011","076"
"1430","GROPPARELLO",99,23,0,122,"2011","025"
"1431","GROSCAVALLO",0,0,37,37,"2011","118"
"1432","GROSIO",30,214,3,247,"2011","033"
"1433","GROSOTTO",19,47,0,66,"2011","034"
"1434","GROSSO",0,0,43,43,"2011","119"
"1435","GRUARO",14,156,0,170,"2011","018"
"1436","GRUGLIASCO",33,19,140,192,"2011","120"
"1437","GRUMELLO CREMONESE ED UNITI",24,1100,199,1323,"2011","051"
"1438","GRUMELLO DEL MONTE",235,107,0,342,"2011","120"
"1439","GRUMOLO DELLE ABBADESSE",58,286,0,344,"2011","047"
"1440","GUALTIERI",1270,613,3,1886,"2011","023"
"1441","GUANZATE",31,0,0,31,"2011","114"
"1442","GUARDA VENETA",619,0,0,619,"2011","028"
"1443","GUARDABOSONE",24,24,0,48,"2011","066"
"1444","GUARDAMIGLIO",1,262,0,263,"2011","029"
"1445","GUARENE",326,0,61,387,"2011","101"
"1446","GUASTALLA",59,1104,0,1163,"2011","024"
"1447","GUDO VISCONTI",18,0,0,18,"2011","112"
"1448","GUIDIZZOLO",935,699,203,1837,"2011","028"
"1449","GUIGLIA",86,520,0,606,"2011","017"
"1450","GUSSAGO",154,698,0,852,"2011","081"
"1451","GUSSOLA",9,41,0,50,"2011","052"
"1452","IDRO",5,0,0,5,"2011","082"
"1453","IESOLO",35,48,1,84,"2011","019"
"1454","IGLIANO",56,0,25,81,"2011","102"
"1455","ILLASI",1,62,0,63,"2011","039"
"1456","IMBERSAGO",3,0,0,3,"2011","039"
"1457","IMOLA",127,20,0,147,"2011","032"
"1458","INARZO",10,0,0,10,"2011","082"
"1459","INCISA SCAPACCINO",53,0,0,53,"2011","058"
"1460","INCUDINE",1,2,0,3,"2011","083"
"1461","INDUNO OLONA",19,62,0,81,"2011","083"
"1462","INTRAGNA",1,0,3,4,"2011","037"
"1463","INTROBIO",38,14,0,52,"2011","040"
"1464","INTROZZO",2,0,0,2,"2011","041"
"1465","INVERIGO",78,0,23,101,"2011","118"
"1466","INVERNO E MONTELEONE",106,153,0,259,"2011","077"
"1467","INVERSO PINASCA",0,0,26,26,"2011","122"
"1468","INVERUNO",23,173,0,196,"2011","113"
"1469","INVORIO",31,123,13,167,"2011","082"
"1470","INZAGO",252,683,31,966,"2011","114"
"1471","IRMA",8,0,0,8,"2011","084"
"1472","ISASCA",9,0,0,9,"2011","103"
"1473","ISEO",51,33,0,84,"2011","085"
"1474","ISOLA D'ASTI",248,0,43,291,"2011","059"
"1475","ISOLA DELLA SCALA",6194,357,26,6577,"2011","040"
"1476","ISOLA DI FONDRA",4,23,0,27,"2011","121"
"1477","ISOLA DOVARESE",0,436,0,436,"2011","053"
"1478","ISOLA RIZZA",2517,425,0,2942,"2011","041"
"1479","ISOLA SANT'ANTONIO",1,0,0,1,"2011","087"
"1480","ISOLA VICENTINA",1411,715,0,2126,"2011","048"
"1481","ISOLABELLA",125,418,0,543,"2011","123"
"1482","ISORELLA",11492,651,0,12143,"2011","086"
"1483","ISPRA",70,102,0,172,"2011","084"
"1484","ISSIGLIO",0,45,38,83,"2011","124"
"1485","ISSO",6,1085,0,1091,"2011","122"
"1486","ISTRANA",3317,384,41,3742,"2011","035"
"1487","IVREA",2,113,238,353,"2011","125"
"1488","IZANO",32,918,0,950,"2011","054"
"1489","JERAGO CON ORAGO",4,0,0,4,"2011","085"
"1490","JOLANDA DI SAVOIA",102,0,0,102,"2011","010"
"1491","LA CASSA",1,332,0,333,"2011","126"
"1492","LA LOGGIA",275,0,71,346,"2011","127"
"1493","LA MORRA",50,0,57,107,"2011","105"
"1494","LA VALLE AGORDINA",10,19,0,29,"2011","027"
"1495","LACCHIARELLA",36,72,0,108,"2011","115"
"1496","LAGNASCO",51,18,0,69,"2011","104"
"1497","LAGOSANTO",44,0,0,44,"2011","011"
"1498","LAINATE",11,0,6,17,"2011","116"
"1499","LAINO",0,7,0,7,"2011","120"
"1500","LAMA MOCOGNO",106,414,0,520,"2011","018"
"1501","LAMBRUGO",0,70,0,70,"2011","121"
"1502","LAMON",8,8,0,16,"2011","026"
"1503","LAMPORO",10,0,16,26,"2011","067"
"1504","LANDRIANO",23,253,0,276,"2011","078"
"1505","LANGHIRANO",1,828,0,829,"2011","018"
"1506","LANGOSCO",6,0,0,6,"2011","079"
"1507","LANZADA",12,66,0,78,"2011","036"
"1508","LANZO D'INTELVI",19,0,1,20,"2011","122"
"1509","LANZO TORINESE",2,0,161,163,"2011","128"
"1510","LASNIGO",2,23,0,25,"2011","123"
"1511","LAURIANO",0,0,16,16,"2011","129"
"1512","LAVENA PONTE TRESA",7,0,0,7,"2011","086"
"1513","LAVENO-MOMBELLO",15,0,0,15,"2011","087"
"1514","LAVENONE",13,6,0,19,"2011","087"
"1515","LAZISE",53,119,11,183,"2011","043"
"1516","LECCO",20,56,5,81,"2011","042"
"1517","LEFFE",51,79,0,130,"2011","124"
"1518","LEGGIUNO",4,0,0,4,"2011","088"
"1519","LEGNAGO",127,38,0,165,"2011","044"
"1520","LEGNANO",0,45,0,45,"2011","118"
"1521","LEGNARO",170,39,139,348,"2011","044"
"1522","LEINI'",11,726,414,1151,"2011","130"
"1523","LEMIE",0,55,17,72,"2011","131"
"1524","LENDINARA",542,202,0,744,"2011","029"
"1525","LENNA",5,10,0,15,"2011","125"
"1526","LENNO",7,0,2,9,"2011","125"
"1527","LENO",7000,5879,75,12954,"2011","088"
"1528","LENTA",0,28,0,28,"2011","068"
"1529","LENTIAI",98,92,0,190,"2011","028"
"1530","LEQUIO BERRIA",5,0,54,59,"2011","106"
"1531","LEQUIO TANARO",518,75,0,593,"2011","107"
"1532","LERMA",9,0,12,21,"2011","088"
"1533","LESA",3,0,5,8,"2011","084"
"1534","LESEGNO",675,0,0,675,"2011","108"
"1535","LESIGNANO DE' BAGNI",30,1028,0,1058,"2011","019"
"1536","LESSOLO",105,0,36,141,"2011","132"
"1537","LESSONA",4,8,3,15,"2011","029"
"1538","LEVATE",3,39,0,42,"2011","126"
"1539","LEVICE",24,0,69,93,"2011","109"
"1540","LEZZENO",3,0,3,6,"2011","126"
"1541","LIERNA",8,0,0,8,"2011","043"
"1542","LIGNANA",1,0,0,1,"2011","070"
"1543","LIGONCHIO",25,60,0,85,"2011","025"
"1544","LIMANA",30,116,0,146,"2011","029"
"1545","LIMENA",563,469,109,1141,"2011","045"
"1546","LIMIDO COMASCO",8,23,1,32,"2011","128"
"1547","LIMONE PIEMONTE",86,0,0,86,"2011","110"
"1548","LINAROLO",7,347,0,354,"2011","081"
"1549","LIRIO",45,0,0,45,"2011","082"
"1550","LISCATE",30,0,0,30,"2011","122"
"1551","LISIO",57,0,0,57,"2011","111"
"1552","LIVIGNO",20,340,5,365,"2011","037"
"1553","LIVINALLONGO DEL COL DI LANA",3,67,0,70,"2011","030"
"1554","LIVO",2,0,0,2,"2011","130"
"1555","LIVORNO FERRARIS",12,206,0,218,"2011","071"
"1556","LIVRAGA",21,1184,42,1247,"2011","030"
"1557","LIZZANO IN BELVEDERE",39,53,66,158,"2011","033"
"1558","LOAZZOLO",7,0,0,7,"2011","060"
"1559","LOCANA",3,46,242,291,"2011","134"
"1560","LOCATE DI TRIULZI",0,1030,0,1030,"2011","125"
"1561","LOCATE VARESINO",13,0,0,13,"2011","131"
"1562","LOCATELLO",28,22,0,50,"2011","127"
"1563","LODI",584,1278,0,1862,"2011","031"
"1564","LODI VECCHIO",5,1014,0,1019,"2011","032"
"1565","LODRINO",24,0,0,24,"2011","090"
"1566","LOGRATO",633,828,0,1461,"2011","091"
"1567","LOIANO",34,318,0,352,"2011","034"
"1568","LOMAGNA",2,0,0,2,"2011","044"
"1569","LOMAZZO",1,38,0,39,"2011","133"
"1570","LOMBARDORE",10,0,37,47,"2011","135"
"1571","LOMBRIASCO",65,100,0,165,"2011","136"
"1572","LOMELLO",1,90,0,91,"2011","083"
"1573","LONATE CEPPINO",2,238,6,246,"2011","089"
"1574","LONATE POZZOLO",21,0,5,26,"2011","090"
"1575","LONATO",2998,3878,66,6942,"2011","092"
"1576","LONGARE",101,265,0,366,"2011","051"
"1577","LONGARONE",1,0,0,1,"2011","031"
"1578","LONGHENA",0,257,0,257,"2011","093"
"1579","LONGIANO",18,0,0,18,"2011","018"
"1580","LONIGO",6056,481,6,6543,"2011","052"
"1581","LORANZE'",0,0,29,29,"2011","137"
"1582","LOREGGIA",586,441,0,1027,"2011","046"
"1583","LOREGLIA",7,0,1,8,"2011","038"
"1584","LORENZAGO DI CADORE",1,0,0,1,"2011","032"
"1585","LOREO",1086,155,0,1241,"2011","030"
"1586","LORIA",7555,27,5,7587,"2011","036"
"1587","LOSINE",0,41,0,41,"2011","094"
"1588","LOVERE",15,16,0,31,"2011","128"
"1589","LOVERO",0,7,0,7,"2011","038"
"1590","LOZIO",0,1,0,1,"2011","095"
"1591","LOZZA",0,130,0,130,"2011","091"
"1592","LOZZO ATESTINO",1795,12,0,1807,"2011","047"
"1593","LOZZO DI CADORE",3,0,0,3,"2011","033"
"1594","LOZZOLO",1,0,25,26,"2011","072"
"1595","LU",26,0,35,61,"2011","089"
"1596","LUGAGNANO VAL D'ARDA",51,213,0,264,"2011","026"
"1597","LUGNACCO",0,0,2,2,"2011","138"
"1598","LUGO",473,99,0,572,"2011","012"
"1599","LUGO DI VICENZA",11,141,0,152,"2011","053"
"1600","LUINO",12,26,0,38,"2011","092"
"1601","LUISAGO",3,0,0,3,"2011","135"
"1602","LUMEZZANE",30,0,0,30,"2011","096"
"1603","LUNGAVILLA",2,0,0,2,"2011","084"
"1604","LURAGO D'ERBA",7,0,0,7,"2011","136"
"1605","LURAGO MARINONE",0,97,0,97,"2011","137"
"1606","LURANO",22,0,0,22,"2011","129"
"1607","LURATE CACCIVIO",9,0,73,82,"2011","138"
"1608","LUSERNA SAN GIOVANNI",283,77,162,522,"2011","139"
"1609","LUSERNETTA",4,0,81,85,"2011","140"
"1610","LUSIA",22,0,0,22,"2011","031"
"1611","LUSIANA",32,85,0,117,"2011","054"
"1612","LUSIGLIE'",46,0,1,47,"2011","141"
"1613","LUVINATE",2,0,0,2,"2011","093"
"1614","LUZZANA",16,0,0,16,"2011","130"
"1615","LUZZARA",1581,1464,39,3084,"2011","026"
"1616","MACCAGNO",0,3,0,3,"2011","094"
"1617","MACCASTORNA",604,0,0,604,"2011","033"
"1618","MACELLO",701,488,522,1711,"2011","142"
"1619","MACLODIO",126,278,0,404,"2011","097"
"1620","MACUGNAGA",8,7,6,21,"2011","039"
"1621","MADESIMO",2,12,0,14,"2011","035"
"1622","MADIGNANO",58,452,0,510,"2011","055"
"1623","MADONE",67,0,0,67,"2011","131"
"1624","MADONNA DEL SASSO",1,0,20,21,"2011","040"
"1625","MAGASA",11,14,0,25,"2011","098"
"1626","MAGENTA",79,559,0,638,"2011","130"
"1627","MAGGIORA",6,47,76,129,"2011","088"
"1628","MAGHERNO",0,92,0,92,"2011","085"
"1629","MAGLIANO ALFIERI",425,0,0,425,"2011","113"
"1630","MAGLIANO ALPI",682,108,0,790,"2011","114"
"1631","MAGNACAVALLO",361,300,324,985,"2011","029"
"1632","MAGNAGO",53,0,0,53,"2011","131"
"1633","MAGNANO",0,17,18,35,"2011","030"
"1634","MAIOLO",98,7,0,105,"2011","022"
"1635","MAIRAGO",5,494,0,499,"2011","034"
"1636","MAIRANO",351,782,0,1133,"2011","099"
"1637","MALAGNINO",64,469,0,533,"2011","056"
"1638","MALALBERGO",2,0,0,2,"2011","035"
"1639","MALCESINE",29,86,13,128,"2011","045"
"1640","MALEGNO",7,48,0,55,"2011","100"
"1641","MALEO",177,1244,0,1421,"2011","035"
"1642","MALESCO",1,10,16,27,"2011","041"
"1643","MALGESSO",28,0,0,28,"2011","095"
"1644","MALNATE",68,30,0,98,"2011","096"
"1645","MALO",2555,344,7,2906,"2011","055"
"1646","MALONNO",11,267,8,286,"2011","101"
"1647","MALVICINO",0,4,5,9,"2011","090"
"1648","MANDELLO DEL LARIO",23,0,0,23,"2011","046"
"1649","MANDELLO VITTA",1,2,0,3,"2011","090"
"1650","MANERBA DEL GARDA",23,0,8,31,"2011","102"
"1651","MANERBIO",1079,1275,0,2354,"2011","103"
"1652","MANGO",11,0,17,28,"2011","115"
"1653","MANSUE'",59,371,27,457,"2011","037"
"1654","MANTA",6,0,0,6,"2011","116"
"1655","MANTELLO",11,82,0,93,"2011","039"
"1656","MANTOVA",1008,426,395,1829,"2011","030"
"1657","MAPELLO",64,19,0,83,"2011","132"
"1658","MARANELLO",9,551,0,560,"2011","019"
"1659","MARANO DI VALPOLICELLA",16,79,39,134,"2011","046"
"1660","MARANO SUL PANARO",103,715,0,818,"2011","020"
"1661","MARANO TICINO",5,268,2,275,"2011","091"
"1662","MARANO VICENTINO",200,314,4,518,"2011","056"
"1663","MARCALLO CON CASONE",3,205,0,208,"2011","134"
"1664","MARCARIA",2297,2022,1912,6231,"2011","031"
"1665","MARCHENO",5,15,1,21,"2011","104"
"1666","MARCHIROLO",3,0,0,3,"2011","097"
"1667","MARCIGNAGO",26,0,0,26,"2011","086"
"1668","MARCON",869,81,0,950,"2011","020"
"1669","MARENE",3773,1920,146,5839,"2011","117"
"1670","MARENO DI PIAVE",1513,239,5,1757,"2011","038"
"1671","MARENTINO",93,0,24,117,"2011","144"
"1672","MARETTO",194,0,0,194,"2011","062"
"1673","MARGARITA",826,0,6,832,"2011","118"
"1674","MARGNO",3,8,0,11,"2011","047"
"1675","MARIANA MANTOVANA",144,284,33,461,"2011","032"
"1676","MARIANO COMENSE",641,72,1,714,"2011","143"
"1677","MARMENTINO",26,17,1,44,"2011","105"
"1678","MARMIROLO",4105,2536,2372,9013,"2011","033"
"1679","MARMORA",51,82,0,133,"2011","119"
"1680","MARONE",46,40,0,86,"2011","106"
"1681","MAROSTICA",244,702,0,946,"2011","057"
"1682","MARSAGLIA",186,0,0,186,"2011","120"
"1683","MARTELLAGO",34,31,15,80,"2011","021"
"1684","MARTIGNANA DI PO",0,1,0,1,"2011","057"
"1685","MARTINENGO",815,2320,0,3135,"2011","133"
"1686","MARTINIANA PO",95,94,0,189,"2011","121"
"1687","MARUDO",0,326,0,326,"2011","036"
"1688","MARZABOTTO",4,203,0,207,"2011","036"
"1689","MARZANO",23,219,0,242,"2011","087"
"1690","MARZIO",2,0,5,7,"2011","099"
"1691","MASATE",0,163,0,163,"2011","136"
"1692","MASCIAGO PRIMO",39,0,0,39,"2011","100"
"1693","MASER",3888,65,0,3953,"2011","039"
"1694","MASERA",2,73,19,94,"2011","042"
"1695","MASERA' DI PADOVA",286,47,134,467,"2011","048"
"1696","MASERADA SUL PIAVE",2716,96,3,2815,"2011","040"
"1697","MASI",73,0,0,73,"2011","049"
"1698","MASI TORELLO",6,89,0,95,"2011","012"
"1699","MASIO",333,0,48,381,"2011","091"
"1700","MASLIANICO",0,0,1,1,"2011","144"
"1701","MASON VICENTINO",91,473,15,579,"2011","058"
"1702","MASSA FISCAGLIA",16,0,0,16,"2011","013"
"1703","MASSA LOMBARDA",13,0,0,13,"2011","013"
"1704","MASSALENGO",0,173,0,173,"2011","037"
"1705","MASSANZAGO",726,135,0,861,"2011","050"
"1706","MASSAZZA",0,16,5,21,"2011","031"
"1707","MASSELLO",0,0,2,2,"2011","145"
"1708","MASSERANO",50,0,11,61,"2011","032"
"1709","MASSINO VISCONTI",0,55,12,67,"2011","093"
"1710","MASSIOLA",0,0,1,1,"2011","043"
"1711","MATHI",5,11,74,90,"2011","146"
"1712","MATTIE",0,0,7,7,"2011","147"
"1713","MAZZANO",540,795,0,1335,"2011","107"
"1714","MAZZE'",1234,0,158,1392,"2011","148"
"1715","MAZZO DI VALTELLINA",4,19,5,28,"2011","040"
"1716","MEANA DI SUSA",3,0,1,4,"2011","149"
"1717","MEDE",21,61,0,82,"2011","088"
"1718","MEDESANO",130,1161,0,1291,"2011","020"
"1719","MEDICINA",268,125,0,393,"2011","037"
"1720","MEDIGLIA",11,1340,0,1351,"2011","139"
"1721","MEDOLAGO",12,0,0,12,"2011","250"
"1722","MEDOLE",1137,680,523,2340,"2011","034"
"1723","MEDOLLA",39,416,0,455,"2011","021"
"1724","MEDUNA DI LIVENZA",14,40,2,56,"2011","041"
"1725","MEGLIADINO SAN FIDENZIO",1049,0,0,1049,"2011","051"
"1726","MEGLIADINO SAN VITALE",1930,0,0,1930,"2011","052"
"1727","MEINA",2,0,0,2,"2011","095"
"1728","MEL",59,312,54,425,"2011","034"
"1729","MELARA",297,0,0,297,"2011","032"
"1730","MELAZZO",181,0,49,230,"2011","092"
"1731","MELDOLA",193,65,0,258,"2011","019"
"1732","MELEGNANO",6,92,0,98,"2011","140"
"1733","MELETI",50,418,0,468,"2011","038"
"1734","MELLE",403,15,5,423,"2011","122"
"1735","MELLO",28,43,0,71,"2011","041"
"1736","MELZO",30,334,0,364,"2011","142"
"1737","MENAGGIO",2,0,1,3,"2011","145"
"1738","MENCONICO",12,0,0,12,"2011","089"
"1739","MEOLO",1428,120,0,1548,"2011","022"
"1740","MERANA",584,0,12,596,"2011","093"
"1741","MERATE",120,325,0,445,"2011","048"
"1742","MERCATO SARACENO",228,23,1,252,"2011","020"
"1743","MERCENASCO",53,0,269,322,"2011","150"
"1744","MERGOZZO",15,0,0,15,"2011","044"
"1745","MERLARA",572,13,0,585,"2011","053"
"1746","MERLINO",14,822,0,836,"2011","039"
"1747","MERONE",30,80,0,110,"2011","147"
"1748","MESE",17,25,0,42,"2011","043"
"1749","MESENZANA",1,20,0,21,"2011","102"
"1750","MESERO",0,84,0,84,"2011","144"
"1751","MESOLA",2094,185,0,2279,"2011","014"
"1752","MESTRINO",73,177,25,275,"2011","054"
"1753","MEUGLIANO",3,0,14,17,"2011","151"
"1754","MEZZANA BIGLI",104,0,0,104,"2011","090"
"1755","MEZZANE DI SOTTO",3,17,0,20,"2011","047"
"1756","MEZZANI",8,385,0,393,"2011","021"
"1757","MEZZANINO",7,0,0,7,"2011","092"
"1758","MEZZEGRA",7,7,9,23,"2011","148"
"1759","MEZZENILE",0,53,35,88,"2011","152"
"1760","MEZZOLDO",3,24,0,27,"2011","134"
"1761","MEZZOMERICO",0,7,0,7,"2011","097"
"1762","MIAGLIANO",0,0,12,12,"2011","034"
"1763","MIANE",23,6,0,29,"2011","042"
"1764","MIASINO",0,0,23,23,"2011","098"
"1765","MIAZZINA",2,0,0,2,"2011","045"
"1766","MIGLIARINO",1385,0,0,1385,"2011","015"
"1767","MIGLIARO",849,82,0,931,"2011","026"
"1768","MILANO",415,114,0,529,"2011","146"
"1769","MILZANO",3,791,0,794,"2011","108"
"1770","MINERBE",2747,295,0,3042,"2011","048"
"1771","MINERBIO",74,0,0,74,"2011","038"
"1772","MIRA",1785,620,8,2413,"2011","023"
"1773","MIRABELLO MONFERRATO",62,0,0,62,"2011","094"
"1774","MIRADOLO TERME",35,89,0,124,"2011","093"
"1775","MIRANDOLA",324,881,0,1205,"2011","022"
"1776","MIRANO",1397,774,0,2171,"2011","024"
"1777","MISANO ADRIATICO",13,0,0,13,"2011","005"
"1778","MISANO DI GERA D'ADDA",15,167,0,182,"2011","135"
"1779","MISSAGLIA",29,278,248,555,"2011","049"
"1780","MODENA",892,2166,0,3058,"2011","023"
"1781","MODIGLIANA",105,2,5,112,"2011","022"
"1782","MOGLIA",5235,809,397,6441,"2011","035"
"1783","MOGLIANO VENETO",1161,351,94,1606,"2011","043"
"1784","MOIO DE' CALVI",2,7,0,9,"2011","136"
"1785","MOIOLA",2,0,2,4,"2011","123"
"1786","MOLARE",1,0,3,4,"2011","095"
"1787","MOLINELLA",2183,41,0,2224,"2011","039"
"1788","MOLLIA",2,0,0,2,"2011","078"
"1789","MOLTENO",18,45,0,63,"2011","051"
"1790","MOLVENA",22,5,0,27,"2011","059"
"1791","MOMBALDONE",68,0,10,78,"2011","064"
"1792","MOMBARCARO",110,0,20,130,"2011","124"
"1793","MOMBARUZZO",110,0,0,110,"2011","065"
"1794","MOMBASIGLIO",145,0,1,146,"2011","125"
"1795","MOMBELLO DI TORINO",27,0,0,27,"2011","153"
"1796","MOMBELLO MONFERRATO",64,0,0,64,"2011","097"
"1797","MOMBERCELLI",14,0,35,49,"2011","066"
"1798","MOMO",73,690,19,782,"2011","100"
"1799","MOMPANTERO",0,0,4,4,"2011","154"
"1800","MOMPERONE",0,0,8,8,"2011","098"
"1801","MONALE",46,0,3,49,"2011","067"
"1802","MONASTERO BORMIDA",342,0,31,373,"2011","068"
"1803","MONASTERO DI LANZO",0,0,63,63,"2011","155"
"1804","MONASTERO DI VASCO",453,8,0,461,"2011","126"
"1805","MONASTEROLO CASOTTO",44,0,0,44,"2011","127"
"1806","MONASTEROLO DEL CASTELLO",1,0,0,1,"2011","137"
"1807","MONASTEROLO DI SAVIGLIANO",555,217,12,784,"2011","128"
"1808","MONASTIER DI TREVISO",2190,424,0,2614,"2011","044"
"1809","MONCALIERI",532,363,0,895,"2011","156"
"1810","MONCALVO",118,0,0,118,"2011","069"
"1811","MONCENISIO",0,0,4,4,"2011","157"
"1812","MONCESTINO",15,0,0,15,"2011","099"
"1813","MONCHIERO",161,0,21,182,"2011","129"
"1814","MONCHIO DELLE CORTI",37,111,0,148,"2011","022"
"1815","MONCRIVELLO",152,33,159,344,"2011","079"
"1816","MONCUCCO TORINESE",53,0,0,53,"2011","070"
"1817","MONDAINO",5,0,0,5,"2011","006"
"1818","MONDOVI'",5615,200,184,5999,"2011","130"
"1819","MONESIGLIO",103,0,5,108,"2011","131"
"1820","MONFORTE D'ALBA",186,0,74,260,"2011","132"
"1821","MONFUMO",55,271,0,326,"2011","045"
"1822","MONGARDINO",33,0,0,33,"2011","071"
"1823","MONGHIDORO",25,60,33,118,"2011","040"
"1824","MONGIARDINO LIGURE",9,0,22,31,"2011","100"
"1825","MONGRANDO",1,138,74,213,"2011","035"
"1826","MONGUZZO",26,6,0,32,"2011","153"
"1827","MONIGA DEL GARDA",0,12,0,12,"2011","109"
"1828","MONNO",2,69,0,71,"2011","110"
"1829","MONSELICE",737,54,0,791,"2011","055"
"1830","MONTA'",106,0,48,154,"2011","133"
"1831","MONTABONE",48,53,0,101,"2011","072"
"1832","MONTACUTO",13,11,4,28,"2011","102"
"1833","MONTAFIA",48,0,0,48,"2011","073"
"1834","MONTAGNA IN VALTELLINA",11,64,0,75,"2011","044"
"1835","MONTAGNANA",1470,34,14,1518,"2011","056"
"1836","MONTALDO BORMIDA",0,0,2,2,"2011","104"
"1837","MONTALDO DI MONDOVI'",92,2,0,94,"2011","134"
"1838","MONTALDO ROERO",10,0,0,10,"2011","135"
"1839","MONTALDO SCARAMPI",29,0,0,29,"2011","074"
"1840","MONTALDO TORINESE",438,0,0,438,"2011","158"
"1841","MONTALENGHE",1,0,3,4,"2011","159"
"1842","MONTALTO DORA",4,0,23,27,"2011","160"
"1843","MONTALTO PAVESE",59,0,0,59,"2011","094"
"1844","MONTANARO",41,122,182,345,"2011","161"
"1845","MONTANASO LOMBARDO",105,385,0,490,"2011","040"
"1846","MONTANERA",1593,554,367,2514,"2011","136"
"1847","MONTANO LUCINO",3,0,19,22,"2011","154"
"1848","MONTE COLOMBO",59,0,0,59,"2011","007"
"1849","MONTE CREMASCO",329,240,0,569,"2011","058"
"1850","MONTE DI MALO",1071,171,0,1242,"2011","063"
"1851","MONTE ISOLA",24,0,0,24,"2011","111"
"1852","MONTE MARENZO",18,0,3,21,"2011","052"
"1853","MONTE SAN PIETRO",100,146,0,246,"2011","042"
"1854","MONTEBELLO DELLA BATTAGLIA",4,57,0,61,"2011","095"
"1855","MONTEBELLO VICENTINO",69,27,174,270,"2011","060"
"1856","MONTEBELLUNA",3932,521,33,4486,"2011","046"
"1857","MONTECASTELLO",181,0,2,183,"2011","105"
"1858","MONTECCHIA DI CROSARA",974,0,0,974,"2011","049"
"1859","MONTECCHIO EMILIA",59,1599,0,1658,"2011","027"
"1860","MONTECCHIO MAGGIORE",147,95,3,245,"2011","061"
"1861","MONTECCHIO PRECALCINO",371,188,78,637,"2011","062"
"1862","MONTECHIARO D'ACQUI",12,0,48,60,"2011","106"
"1863","MONTECHIARO D'ASTI",344,0,4,348,"2011","075"
"1864","MONTECHIARUGOLO",11,2886,0,2897,"2011","023"
"1865","MONTECRESTESE",26,56,8,90,"2011","046"
"1866","MONTECRETO",8,334,0,342,"2011","024"
"1867","MONTEFIORE CONCA",34,8,0,42,"2011","008"
"1868","MONTEFIORINO",50,330,0,380,"2011","025"
"1869","MONTEFORTE D'ALPONE",711,6,0,717,"2011","050"
"1870","MONTEGALDA",191,247,0,438,"2011","064"
"1871","MONTEGALDELLA",81,324,48,453,"2011","065"
"1872","MONTEGIOCO",17,0,3,20,"2011","107"
"1873","MONTEGRIDOLFO",1,0,0,1,"2011","009"
"1874","MONTEGRINO VALTRAVAGLIA",21,0,0,21,"2011","103"
"1875","MONTEGROSSO D'ASTI",36,0,0,36,"2011","076"
"1876","MONTEGROTTO TERME",15,0,41,56,"2011","057"
"1877","MONTELLO",2,0,0,2,"2011","139"
"1878","MONTELUPO ALBESE",86,0,1,87,"2011","137"
"1879","MONTEMAGNO",150,0,0,150,"2011","077"
"1880","MONTEMALE DI CUNEO",80,0,0,80,"2011","138"
"1881","MONTEMARZINO",7,0,0,7,"2011","108"
"1882","MONTEMEZZO",3,0,0,3,"2011","155"
"1883","MONTERENZIO",327,134,4,465,"2011","041"
"1884","MONTEROSSO GRANA",11,38,84,133,"2011","139"
"1885","MONTESCANO",1,0,0,1,"2011","097"
"1886","MONTESCHENO",2,0,0,2,"2011","047"
"1887","MONTESCUDO",191,0,0,191,"2011","010"
"1888","MONTESE",59,1137,0,1196,"2011","026"
"1889","MONTESEGALE",27,0,0,27,"2011","098"
"1890","MONTEU DA PO",0,0,112,112,"2011","162"
"1891","MONTEU ROERO",427,0,139,566,"2011","140"
"1892","MONTEVECCHIA",14,4,0,18,"2011","053"
"1893","MONTEVEGLIO",15,56,2,73,"2011","043"
"1894","MONTEVIALE",268,12,0,280,"2011","066"
"1895","MONTEZEMOLO",160,0,0,160,"2011","141"
"1896","MONTIANO",2,0,0,2,"2011","028"
"1897","MONTICELLI BRUSATI",7,186,2,195,"2011","112"
"1898","MONTICELLI D'ONGINA",415,557,0,972,"2011","027"
"1899","MONTICELLI PAVESE",1194,403,0,1597,"2011","099"
"1900","MONTICELLO BRIANZA",22,0,173,195,"2011","054"
"1901","MONTICELLO CONTE OTTO",36,781,9,826,"2011","067"
"1902","MONTICELLO D'ALBA",84,0,50,134,"2011","142"
"1903","MONTICHIARI",11174,6590,25,17789,"2011","113"
"1904","MONTIGLIO MONFERRATO",310,0,1,311,"2011","121"
"1905","MONTIRONE",4393,748,0,5141,"2011","114"
"1906","MONTODINE",2,1010,0,1012,"2011","059"
"1907","MONTORFANO",16,0,0,16,"2011","157"
"1908","MONTORSO VICENTINO",617,159,0,776,"2011","068"
"1909","MONTU' BECCARIA",7,0,0,7,"2011","100"
"1910","MONVALLE",11,35,0,46,"2011","104"
"1911","MONZAMBANO",1462,618,843,2923,"2011","036"
"1912","MONZUNO",87,76,0,163,"2011","044"
"1913","MORANO SUL PO",3,0,0,3,"2011","109"
"1914","MORANSENGO",111,0,3,114,"2011","079"
"1915","MORAZZONE",33,93,0,126,"2011","105"
"1916","MORBEGNO",19,90,0,109,"2011","045"
"1917","MORBELLO",16,0,1,17,"2011","110"
"1918","MORCIANO DI ROMAGNA",3,0,0,3,"2011","011"
"1919","MORDANO",4,0,0,4,"2011","045"
"1920","MORENGO",95,37,0,132,"2011","140"
"1921","MORETTA",1749,703,177,2629,"2011","143"
"1922","MORFASSO",128,6,0,134,"2011","028"
"1923","MORGANO",2069,9,7,2085,"2011","047"
"1924","MORIAGO DELLA BATTAGLIA",2108,60,0,2168,"2011","048"
"1925","MORIMONDO",35,1346,0,1381,"2011","150"
"1926","MORIONDO TORINESE",268,0,0,268,"2011","163"
"1927","MORNAGO",35,0,0,35,"2011","106"
"1928","MORNESE",0,0,15,15,"2011","111"
"1929","MORNICO AL SERIO",2916,401,0,3317,"2011","141"
"1930","MORNICO LOSANA",20,0,0,20,"2011","101"
"1931","MOROZZO",1915,421,683,3019,"2011","144"
"1932","MORSASCO",112,0,55,167,"2011","112"
"1933","MORTARA",52,0,0,52,"2011","102"
"1934","MORTERONE",26,0,0,26,"2011","055"
"1935","MOSCAZZANO",111,1102,220,1433,"2011","060"
"1936","MOSSANO",218,103,0,321,"2011","069"
"1937","MOSSO",4,32,20,56,"2011","084"
"1938","MOTTA BALUFFI",8,101,0,109,"2011","061"
"1939","MOTTA DI LIVENZA",840,39,2,881,"2011","049"
"1940","MOTTA VISCONTI",3,0,0,3,"2011","151"
"1941","MOTTALCIATA",0,53,15,68,"2011","037"
"1942","MOTTEGGIANA",1128,1083,521,2732,"2011","037"
"1943","MOZZANICA",173,617,0,790,"2011","142"
"1944","MOZZATE",25,88,0,113,"2011","159"
"1945","MOZZECANE",3719,655,7,4381,"2011","051"
"1946","MULAZZANO",9,1150,0,1159,"2011","041"
"1947","MURA",27,75,3,105,"2011","115"
"1948","MURAZZANO",351,0,43,394,"2011","145"
"1949","MURELLO",527,1237,191,1955,"2011","146"
"1950","MURISENGO",269,0,20,289,"2011","113"
"1951","MUSCOLINE",82,429,0,511,"2011","116"
"1952","MUSILE DI PIAVE",34,51,0,85,"2011","025"
"1953","MUSSO",3,9,2,14,"2011","160"
"1954","MUSSOLENTE",287,208,100,595,"2011","070"
"1955","MUZZANO",8,4,25,37,"2011","038"
"1956","NANTO",341,190,17,548,"2011","071"
"1957","NARZOLE",437,46,749,1232,"2011","147"
"1958","NAVE",55,180,0,235,"2011","117"
"1959","NEBBIUNO",2,31,26,59,"2011","103"
"1960","NEGRAR",8,113,14,135,"2011","052"
"1961","NEIVE",0,0,28,28,"2011","148"
"1962","NEMBRO",38,0,0,38,"2011","144"
"1963","NERVESA DELLA BATTAGLIA",548,283,0,831,"2011","050"
"1964","NERVIANO",50,124,0,174,"2011","154"
"1965","NESSO",0,10,0,10,"2011","161"
"1966","NETRO",19,55,95,169,"2011","039"
"1967","NEVIANO DEGLI ARDUINI",39,1730,0,1769,"2011","024"
"1968","NEVIGLIE",25,0,0,25,"2011","149"
"1969","NIARDO",1,145,13,159,"2011","118"
"1970","NIBBIANO",241,0,0,241,"2011","029"
"1971","NIBIONNO",3,15,0,18,"2011","056"
"1972","NICHELINO",40,0,29,69,"2011","164"
"1973","NICORVO",10,0,0,10,"2011","103"
"1974","NIELLA BELBO",0,0,125,125,"2011","150"
"1975","NIELLA TANARO",157,0,15,172,"2011","151"
"1976","NIZZA MONFERRATO",81,0,9,90,"2011","080"
"1977","NOALE",572,160,3,735,"2011","026"
"1978","NOASCA",0,0,69,69,"2011","165"
"1979","NOCETO",34,2851,12,2897,"2011","025"
"1980","NOGARA",2631,508,0,3139,"2011","053"
"1981","NOGAROLE ROCCA",748,243,63,1054,"2011","054"
"1982","NOGAROLE VICENTINO",43,33,0,76,"2011","072"
"1983","NOLE",61,103,87,251,"2011","166"
"1984","NONANTOLA",7,189,0,196,"2011","027"
"1985","NONE",1008,996,162,2166,"2011","168"
"1986","NOSATE",23,402,0,425,"2011","155"
"1987","NOVAFELTRIA",1225,186,0,1411,"2011","023"
"1988","NOVALESA",5,15,36,56,"2011","169"
"1989","NOVARA",29,268,9,306,"2011","106"
"1990","NOVATE MEZZOLA",18,44,0,62,"2011","046"
"1991","NOVE",31,211,27,269,"2011","073"
"1992","NOVEDRATE",1033,0,0,1033,"2011","163"
"1993","NOVELLARA",3453,2004,21,5478,"2011","028"
"1994","NOVELLO",947,0,53,1000,"2011","152"
"1995","NOVENTA DI PIAVE",5,19,3,27,"2011","027"
"1996","NOVENTA PADOVANA",19,0,0,19,"2011","058"
"1997","NOVENTA VICENTINA",3847,0,0,3847,"2011","074"
"1998","NOVI DI MODENA",1349,710,0,2059,"2011","028"
"1999","NOVI LIGURE",368,0,41,409,"2011","114"
"2000","NOVIGLIO",21,450,0,471,"2011","158"
"2001","NUVOLENTO",14,816,0,830,"2011","119"
"2002","NUVOLERA",1506,299,0,1805,"2011","120"
"2003","OCCHIEPPO INFERIORE",5,138,11,154,"2011","040"
"2004","OCCHIEPPO SUPERIORE",2,64,45,111,"2011","041"
"2005","OCCHIOBELLO",3,149,0,152,"2011","033"
"2006","OCCIMIANO",8,0,38,46,"2011","115"
"2007","ODALENGO GRANDE",114,0,0,114,"2011","116"
"2008","ODERZO",317,475,0,792,"2011","051"
"2009","ODOLO",2,0,0,2,"2011","121"
"2010","OFFANENGO",332,472,0,804,"2011","062"
"2011","OFFLAGA",681,3295,0,3976,"2011","122"
"2012","OGGEBBIO",3,0,3,6,"2011","049"
"2013","OGGIONA CON SANTO STEFANO",5,33,0,38,"2011","107"
"2014","OGGIONO",59,71,5,135,"2011","057"
"2015","OGLIANICO",0,353,110,463,"2011","170"
"2016","OLCENENGO",4,0,0,4,"2011","088"
"2017","OLDENICO",2,0,0,2,"2011","089"
"2018","OLEGGIO",92,859,31,982,"2011","108"
"2019","OLEGGIO CASTELLO",27,0,2,29,"2011","109"
"2020","OLEVANO DI LOMELLINA",4,0,0,4,"2011","104"
"2021","OLGIATE COMASCO",64,0,25,89,"2011","165"
"2022","OLGIATE MOLGORA",26,95,0,121,"2011","058"
"2023","OLGIATE OLONA",3,0,0,3,"2011","108"
"2024","OLGINATE",13,0,0,13,"2011","059"
"2025","OLIVETO LARIO",26,0,1,27,"2011","060"
"2026","OLMENETA",15,207,93,315,"2011","063"
"2027","OLMO AL BREMBO",8,2,0,10,"2011","145"
"2028","OLMO GENTILE",61,0,19,80,"2011","081"
"2029","OLTRE IL COLLE",39,91,0,130,"2011","146"
"2030","OLTRESSENDA ALTA",25,14,0,39,"2011","147"
"2031","OLTRONA DI SAN MAMETTE",13,0,0,13,"2011","169"
"2032","OME",38,16,0,54,"2011","123"
"2033","OMEGNA",16,0,9,25,"2011","050"
"2034","ONCINO",69,0,0,69,"2011","154"
"2035","ONETA",13,46,0,59,"2011","148"
"2036","ONO SAN PIETRO",1,18,0,19,"2011","124"
"2037","ONORE",87,18,0,105,"2011","149"
"2038","OPERA",0,165,0,165,"2011","159"
"2039","OPPEANO",5063,804,56,5923,"2011","055"
"2040","ORBASSANO",255,53,545,853,"2011","171"
"2041","ORGIANO",561,22,68,651,"2011","075"
"2042","ORIGGIO",82,0,0,82,"2011","109"
"2043","ORINO",1,0,0,1,"2011","110"
"2044","ORIO CANAVESE",0,40,1,41,"2011","172"
"2045","ORIO LITTA",12,72,0,84,"2011","042"
"2046","ORMEA",159,0,12,171,"2011","155"
"2047","ORMELLE",45,200,0,245,"2011","052"
"2048","ORNAVASSO",13,5,6,24,"2011","051"
"2049","ORNICA",6,2,0,8,"2011","151"
"2050","ORSAGO",22,140,0,162,"2011","053"
"2051","ORSARA BORMIDA",12,0,2,14,"2011","119"
"2052","ORSENIGO",3,43,10,56,"2011","170"
"2053","ORTA SAN GIULIO",0,0,4,4,"2011","112"
"2054","ORZINUOVI",576,3912,71,4559,"2011","125"
"2055","ORZIVECCHI",12,634,0,646,"2011","126"
"2056","OSASCO",23,61,360,444,"2011","173"
"2057","OSASIO",220,251,0,471,"2011","174"
"2058","OSIO SOPRA",52,566,0,618,"2011","152"
"2059","OSIO SOTTO",12,0,0,12,"2011","153"
"2060","OSMATE",29,0,0,29,"2011","111"
"2061","OSNAGO",296,66,0,362,"2011","061"
"2062","OSPEDALETTO EUGANEO",420,55,0,475,"2011","059"
"2063","OSPEDALETTO LODIGIANO",0,794,0,794,"2011","043"
"2064","OSPITALE DI CADORE",1,0,0,1,"2011","035"
"2065","OSPITALETTO",124,89,0,213,"2011","127"
"2066","OSSAGO LODIGIANO",159,1581,13,1753,"2011","044"
"2067","OSSIMO",0,17,0,17,"2011","128"
"2068","OSSONA",46,0,0,46,"2011","164"
"2069","OSSUCCIO",0,0,5,5,"2011","172"
"2070","OSTANA",64,0,0,64,"2011","156"
"2071","OSTELLATO",4235,3,0,4238,"2011","017"
"2072","OSTIANO",490,1317,58,1865,"2011","064"
"2073","OSTIGLIA",27,31,46,104,"2011","038"
"2074","OTTIGLIO",122,0,0,122,"2011","120"
"2075","OTTOBIANO",3,32,0,35,"2011","106"
"2076","OTTONE",63,0,0,63,"2011","030"
"2077","OULX",3,31,46,80,"2011","175"
"2078","OVADA",36,0,18,54,"2011","121"
"2079","OVIGLIO",14,0,25,39,"2011","122"
"2080","OZEGNA",25,2,120,147,"2011","176"
"2081","OZZANO DELL'EMILIA",144,217,0,361,"2011","046"
"2082","OZZANO MONFERRATO",2,0,59,61,"2011","123"
"2083","OZZERO",10,256,0,266,"2011","165"
"2084","PADENGHE SUL GARDA",44,0,0,44,"2011","129"
"2085","PADERNO D'ADDA",0,20,0,20,"2011","062"
"2086","PADERNO DEL GRAPPA",44,169,0,213,"2011","054"
"2087","PADERNO DUGNANO",30,0,62,92,"2011","166"
"2088","PADERNO FRANCIACORTA",1,126,76,203,"2011","130"
"2089","PADERNO PONCHIELLI",293,1672,74,2039,"2011","065"
"2090","PADOVA",387,313,182,882,"2011","060"
"2091","PAESANA",764,94,14,872,"2011","157"
"2092","PAESE",2094,603,55,2752,"2011","055"
"2093","PAGAZZANO",3,301,0,304,"2011","154"
"2094","PAGNO",45,0,0,45,"2011","158"
"2095","PAGNONA",13,0,1,14,"2011","063"
"2096","PAISCO LOVENO",0,11,0,11,"2011","131"
"2097","PAITONE",36,13,0,49,"2011","132"
"2098","PALADINA",4,3,0,7,"2011","155"
"2099","PALAGANO",112,640,0,752,"2011","029"
"2100","PALANZANO",77,294,0,371,"2011","026"
"2101","PALAZZAGO",86,110,0,196,"2011","156"
"2102","PALAZZO CANAVESE",3,0,0,3,"2011","177"
"2103","PALAZZO PIGNANO",43,807,0,850,"2011","066"
"2104","PALAZZOLO SULL'OGLIO",1484,1232,0,2716,"2011","133"
"2105","PALAZZOLO VERCELLESE",5,0,0,5,"2011","090"
"2106","PALESTRO",1,11,0,12,"2011","107"
"2107","PALLANZENO",2,6,0,8,"2011","052"
"2108","PALOSCO",481,445,0,926,"2011","157"
"2109","PALU'",653,0,0,653,"2011","056"
"2110","PAMPARATO",56,0,0,56,"2011","159"
"2111","PANCALIERI",23,171,0,194,"2011","178"
"2112","PANDINO",21,3793,8,3822,"2011","067"
"2113","PANTIGLIATE",6,0,0,6,"2011","167"
"2114","PAPOZZE",111,89,0,200,"2011","034"
"2115","PARABIAGO",55,54,0,109,"2011","168"
"2116","PARATICO",15,28,0,43,"2011","134"
"2117","PARE'",2,0,0,2,"2011","175"
"2118","PARETO",24,2,36,62,"2011","125"
"2119","PARLASCO",3,0,0,3,"2011","064"
"2120","PARMA",828,8485,0,9313,"2011","027"
"2121","PARODI LIGURE",4,0,37,41,"2011","126"
"2122","PAROLDO",22,0,11,33,"2011","160"
"2123","PARONA",9,0,0,9,"2011","109"
"2124","PARRE",60,67,0,127,"2011","158"
"2125","PARUZZARO",28,32,1,61,"2011","114"
"2126","PARZANICA",2,1,4,7,"2011","159"
"2127","PASPARDO",1,8,0,9,"2011","135"
"2128","PASSERANO MARMORITO",100,0,0,100,"2011","082"
"2129","PASSIRANO",185,222,0,407,"2011","136"
"2130","PASTRENGO",5,136,0,141,"2011","057"
"2131","PASTURO",41,110,33,184,"2011","065"
"2132","PAULLO",0,400,0,400,"2011","169"
"2133","PAVAROLO",71,0,0,71,"2011","180"
"2134","PAVIA",202,210,1,413,"2011","110"
"2135","PAVONE CANAVESE",10,0,93,103,"2011","181"
"2136","PAVONE DEL MELLA",1843,438,12,2293,"2011","137"
"2137","PAVULLO NEL FRIGNANO",1360,3586,0,4946,"2011","030"
"2138","PECETTO DI VALENZA",1,0,37,38,"2011","128"
"2139","PECETTO TORINESE",130,0,0,130,"2011","183"
"2140","PECORARA",309,112,0,421,"2011","031"
"2141","PEDAVENA",8,126,0,134,"2011","036"
"2142","PEDEMONTE",1,3,0,4,"2011","076"
"2143","PEDEROBBA",125,159,0,284,"2011","056"
"2144","PEDRENGO",15,109,3,127,"2011","160"
"2145","PEGLIO",3,3,4,10,"2011","178"
"2146","PEGOGNAGA",2887,1657,907,5451,"2011","039"
"2147","PEIA",13,9,0,22,"2011","161"
"2148","PELLA",1,0,0,1,"2011","115"
"2149","PELLEGRINO PARMENSE",43,565,0,608,"2011","028"
"2150","PELLIO INTELVI",6,14,21,41,"2011","179"
"2151","PENANGO",81,0,0,81,"2011","083"
"2152","PENNABILLI",293,22,0,315,"2011","024"
"2153","PEREGO",4,0,9,13,"2011","066"
"2154","PERLEDO",5,0,0,5,"2011","067"
"2155","PERLETTO",14,0,116,130,"2011","161"
"2156","PERLO",38,0,0,38,"2011","162"
"2157","PERNUMIA",579,140,0,719,"2011","061"
"2158","PEROSA ARGENTINA",4,6,50,60,"2011","184"
"2159","PEROSA CANAVESE",44,0,211,255,"2011","185"
"2160","PERRERO",3,0,22,25,"2011","186"
"2161","PERSICO DOSIMO",2,1735,0,1737,"2011","068"
"2162","PERTENGO",3,0,0,3,"2011","091"
"2163","PERTICA ALTA",24,7,6,37,"2011","139"
"2164","PERTICA BASSA",23,49,1,73,"2011","140"
"2165","PERTUSIO",1,0,38,39,"2011","187"
"2166","PESCANTINA",211,107,5,323,"2011","058"
"2167","PESCAROLO ED UNITI",75,694,0,769,"2011","069"
"2168","PESCHIERA BORROMEO",389,157,0,546,"2011","171"
"2169","PESSANO CON BORNAGO",75,118,0,193,"2011","172"
"2170","PESSINA CREMONESE",235,2698,29,2962,"2011","070"
"2171","PESSINETTO",0,0,5,5,"2011","188"
"2172","PETTENASCO",1,0,5,6,"2011","116"
"2173","PETTINENGO",3,26,6,35,"2011","042"
"2174","PETTORAZZA GRIMANI",399,191,0,590,"2011","035"
"2175","PEVERAGNO",1149,453,82,1684,"2011","163"
"2176","PEZZAZE",11,32,0,43,"2011","141"
"2177","PEZZOLO VALLE UZZONE",29,0,45,74,"2011","164"
"2178","PIACENZA",286,1236,0,1522,"2011","032"
"2179","PIACENZA D'ADIGE",534,0,0,534,"2011","062"
"2180","PIADENA",4,393,2,399,"2011","071"
"2181","PIAN CAMUNO",0,250,2,252,"2011","142"
"2182","PIANCOGNO",1,35,0,36,"2011","206"
"2183","PIANELLO DEL LARIO",1,2,8,11,"2011","183"
"2184","PIANELLO VAL TIDONE",381,93,0,474,"2011","033"
"2185","PIANENGO",3,163,0,166,"2011","072"
"2186","PIANEZZA",17,319,360,696,"2011","189"
"2187","PIANEZZE",168,49,20,237,"2011","077"
"2188","PIANFEI",917,50,53,1020,"2011","165"
"2189","PIANICO",12,111,0,123,"2011","162"
"2190","PIANIGA",64,54,4,122,"2011","028"
"2191","PIANORO",181,73,0,254,"2011","047"
"2192","PIANTEDO",17,303,0,320,"2011","048"
"2193","PIARIO",0,38,0,38,"2011","163"
"2194","PIASCO",218,216,0,434,"2011","166"
"2195","PIATEDA",12,49,0,61,"2011","049"
"2196","PIATTO",29,0,3,32,"2011","043"
"2197","PIAZZA BREMBANA",0,4,0,4,"2011","164"
"2198","PIAZZATORRE",0,3,0,3,"2011","165"
"2199","PIAZZOLA SUL BRENTA",2783,1095,12,3890,"2011","063"
"2200","PIAZZOLO",11,0,0,11,"2011","166"
"2201","PIEA",70,0,0,70,"2011","084"
"2202","PIEDIMULERA",0,32,2,34,"2011","053"
"2203","PIERANICA",24,0,0,24,"2011","073"
"2204","PIETRA DE' GIORGI",7,0,0,7,"2011","111"
"2205","PIEVE D'ALPAGO",22,49,0,71,"2011","038"
"2206","PIEVE D'OLMI",0,1468,0,1468,"2011","074"
"2207","PIEVE DEL CAIRO",6,58,0,64,"2011","113"
"2208","PIEVE DI CADORE",1,16,0,17,"2011","039"
"2209","PIEVE DI CENTO",3,0,0,3,"2011","048"
"2210","PIEVE DI CORIANO",1,0,100,101,"2011","040"
"2211","PIEVE DI SOLIGO",72,147,0,219,"2011","057"
"2212","PIEVE EMANUELE",0,349,92,441,"2011","173"
"2213","PIEVE FISSIRAGA",101,1089,0,1190,"2011","045"
"2214","PIEVE PORTO MORONE",133,0,0,133,"2011","114"
"2215","PIEVE SAN GIACOMO",30,1599,0,1629,"2011","075"
"2216","PIEVE VERGONTE",14,8,36,58,"2011","054"
"2217","PIEVEPELAGO",49,76,0,125,"2011","031"
"2218","PINAROLO PO",2460,0,0,2460,"2011","115"
"2219","PINASCA",9,45,93,147,"2011","190"
"2220","PINCARA",387,0,0,387,"2011","036"
"2221","PINEROLO",944,317,919,2180,"2011","191"
"2222","PINO D'ASTI",8,0,0,8,"2011","085"
"2223","PINO TORINESE",513,0,54,567,"2011","192"
"2224","PIOBESI TORINESE",526,942,73,1541,"2011","193"
"2225","PIODE",0,17,0,17,"2011","097"
"2226","PIOLTELLO",11,0,0,11,"2011","175"
"2227","PIOMBINO DESE",5628,498,0,6126,"2011","064"
"2228","PIOSSASCO",132,699,407,1238,"2011","194"
"2229","PIOVA' MASSAIA",61,0,2,63,"2011","086"
"2230","PIOVE DI SACCO",2878,195,92,3165,"2011","065"
"2231","PIOVENE ROCCHETTE",1762,163,8,1933,"2011","078"
"2232","PIOVERA",212,273,6,491,"2011","130"
"2233","PIOZZANO",188,8,0,196,"2011","034"
"2234","PIOZZO",382,0,0,382,"2011","169"
"2235","PISCINA",1138,17,623,1778,"2011","195"
"2236","PISOGNE",10,267,1,278,"2011","143"
"2237","PIUBEGA",2888,605,26,3519,"2011","041"
"2238","PIURO",17,134,0,151,"2011","050"
"2239","PIVERONE",2,79,69,150,"2011","196"
"2240","PIZZIGHETTONE",156,3170,0,3326,"2011","076"
"2241","PLESIO",4,0,0,4,"2011","185"
"2242","POCAPAGLIA",230,61,153,444,"2011","170"
"2243","PODENZANO",369,687,0,1056,"2011","035"
"2244","POGGIO BERNI",127,0,0,127,"2011","012"
"2245","POGGIO RENATICO",3,352,0,355,"2011","018"
"2246","POGGIO RUSCO",284,327,115,726,"2011","042"
"2247","POGGIRIDENTI",0,13,0,13,"2011","051"
"2248","POGLIANO MILANESE",1,0,0,1,"2011","176"
"2249","POGNANO",17,346,0,363,"2011","167"
"2250","POIRINO",3894,490,1,4385,"2011","197"
"2251","POJANA MAGGIORE",1977,51,0,2028,"2011","079"
"2252","POLAVENO",21,0,0,21,"2011","144"
"2253","POLESELLA",19,0,0,19,"2011","037"
"2254","POLESINE PARMENSE",14,340,0,354,"2011","029"
"2255","POLINAGO",87,583,0,670,"2011","032"
"2256","POLLONE",31,42,169,242,"2011","046"
"2257","POLONGHERA",237,183,0,420,"2011","171"
"2258","POLPENAZZE DEL GARDA",9,109,0,118,"2011","145"
"2259","POLVERARA",76,80,0,156,"2011","066"
"2260","POMARETTO",1,11,47,59,"2011","198"
"2261","POMARO MONFERRATO",15,213,0,228,"2011","131"
"2262","POMBIA",1,60,5,66,"2011","121"
"2263","POMPIANO",28,1192,0,1220,"2011","146"
"2264","POMPONESCO",5,266,96,367,"2011","043"
"2265","PONCARALE",544,710,0,1254,"2011","147"
"2266","PONDERANO",23,79,23,125,"2011","047"
"2267","PONNA",1,0,15,16,"2011","187"
"2268","PONSO",136,0,0,136,"2011","067"
"2269","PONT-CANAVESE",1,0,80,81,"2011","199"
"2270","PONTE DELL'OLIO",120,135,0,255,"2011","036"
"2271","PONTE DI LEGNO",2,23,0,25,"2011","148"
"2272","PONTE DI PIAVE",64,61,18,143,"2011","058"
"2273","PONTE IN VALTELLINA",8,27,0,35,"2011","052"
"2274","PONTE LAMBRO",3,25,0,28,"2011","188"
"2275","PONTE NELLE ALPI",24,147,0,171,"2011","040"
"2276","PONTE NIZZA",96,24,0,120,"2011","117"
"2277","PONTE NOSSA",0,19,0,19,"2011","168"
"2278","PONTE SAN NICOLO'",144,39,35,218,"2011","069"
"2279","PONTE SAN PIETRO",5,0,0,5,"2011","170"
"2280","PONTECCHIO POLESINE",1058,0,0,1058,"2011","038"
"2281","PONTECHIANALE",262,0,0,262,"2011","172"
"2282","PONTECURONE",0,0,4,4,"2011","132"
"2283","PONTELONGO",564,0,0,564,"2011","068"
"2284","PONTENURE",112,244,0,356,"2011","037"
"2285","PONTERANICA",4,0,0,4,"2011","169"
"2286","PONTESTURA",7,0,0,7,"2011","133"
"2287","PONTEVICO",184,2750,133,3067,"2011","149"
"2288","PONTI",56,0,38,94,"2011","134"
"2289","PONTI SUL MINCIO",230,394,56,680,"2011","044"
"2290","PONTIDA",32,0,0,32,"2011","171"
"2291","PONTIROLO NUOVO",489,406,0,895,"2011","172"
"2292","PONTOGLIO",1015,993,0,2008,"2011","150"
"2293","PONZANO MONFERRATO",0,0,26,26,"2011","135"
"2294","PONZANO VENETO",478,143,8,629,"2011","059"
"2295","PONZONE",26,5,17,48,"2011","136"
"2296","PORLEZZA",16,49,18,83,"2011","189"
"2297","PORRETTA TERME",49,0,0,49,"2011","049"
"2298","PORTACOMARO",42,0,7,49,"2011","087"
"2299","PORTALBERA",2,0,0,2,"2011","118"
"2300","PORTE",0,0,12,12,"2011","200"
"2301","PORTICO E SAN BENEDETTO",58,0,0,58,"2011","031"
"2302","PORTO CERESIO",3,0,0,3,"2011","113"
"2303","PORTO MANTOVANO",822,630,1514,2966,"2011","045"
"2304","PORTO TOLLE",40,0,0,40,"2011","039"
"2305","PORTO VALTRAVAGLIA",4,7,0,11,"2011","114"
"2306","PORTO VIRO",6697,0,0,6697,"2011","052"
"2307","PORTOBUFFOLE'",5,40,0,45,"2011","060"
"2308","PORTOGRUARO",1366,248,6,1620,"2011","029"
"2309","PORTOMAGGIORE",343,316,47,706,"2011","019"
"2310","PORTULA",7,0,0,7,"2011","048"
"2311","POSINA",1,13,0,14,"2011","080"
"2312","POSSAGNO",26,14,0,40,"2011","061"
"2313","POSTALESIO",1,0,3,4,"2011","053"
"2314","POSTUA",1,2,0,3,"2011","102"
"2315","POVE DEL GRAPPA",16,67,0,83,"2011","081"
"2316","POVEGLIANO",254,203,78,535,"2011","062"
"2317","POVEGLIANO VERONESE",2358,490,15,2863,"2011","060"
"2318","POVIGLIO",26,1131,0,1157,"2011","029"
"2319","POZZAGLIO ED UNITI",24,2605,0,2629,"2011","077"
"2320","POZZO D'ADDA",176,0,0,176,"2011","177"
"2321","POZZOL GROPPO",30,0,6,36,"2011","137"
"2322","POZZOLENGO",934,627,0,1561,"2011","151"
"2323","POZZOLEONE",609,1514,0,2123,"2011","082"
"2324","POZZOLO FORMIGARO",2,169,12,183,"2011","138"
"2325","POZZONOVO",1959,0,0,1959,"2011","070"
"2326","POZZUOLO MARTESANA",44,767,0,811,"2011","178"
"2327","PRADALUNGA",20,0,0,20,"2011","173"
"2328","PRADLEVES",1,9,0,10,"2011","173"
"2329","PRAGELATO",0,0,22,22,"2011","201"
"2330","PRALBOINO",1637,869,1,2507,"2011","152"
"2331","PRALI",0,0,33,33,"2011","202"
"2332","PRALORMO",1278,238,0,1516,"2011","203"
"2333","PRALUNGO",0,23,71,94,"2011","049"
"2334","PRAMAGGIORE",17,99,0,116,"2011","030"
"2335","PRAMOLLO",0,0,2,2,"2011","204"
"2336","PRAROSTINO",4,5,27,36,"2011","205"
"2337","PRASCO",18,0,16,34,"2011","139"
"2338","PRASCORSANO",0,0,3,3,"2011","206"
"2339","PRATA CAMPORTACCIO",34,109,0,143,"2011","054"
"2340","PRATIGLIONE",1,0,1,2,"2011","207"
"2341","PRATO SESIA",0,12,0,12,"2011","122"
"2342","PRAY",47,0,0,47,"2011","050"
"2343","PRAZZO",168,26,23,217,"2011","174"
"2344","PREDAPPIO",170,0,19,189,"2011","032"
"2345","PREDORE",29,0,0,29,"2011","174"
"2346","PREDOSA",73,85,108,266,"2011","140"
"2347","PREGANZIOL",18,198,0,216,"2011","063"
"2348","PREGNANA MILANESE",15,116,0,131,"2011","179"
"2349","PREMANA",10,3,2,15,"2011","069"
"2350","PREMENO",0,0,2,2,"2011","055"
"2351","PREMIA",0,211,0,211,"2011","056"
"2352","PREMILCUORE",325,0,18,343,"2011","033"
"2353","PREMOLO",14,19,0,33,"2011","175"
"2354","PREMOSELLO-CHIOVENDA",15,0,15,30,"2011","057"
"2355","PRESEGLIE",43,1,0,44,"2011","153"
"2356","PRESSANA",3621,104,0,3725,"2011","061"
"2357","PRESTINE",5,58,0,63,"2011","154"
"2358","PREVALLE",67,477,0,544,"2011","155"
"2359","PRIERO",5,0,0,5,"2011","175"
"2360","PRIGNANO SULLA SECCHIA",174,969,37,1180,"2011","033"
"2361","PRIMALUNA",30,43,4,77,"2011","070"
"2362","PRIOCCA",466,0,236,702,"2011","176"
"2363","PRIOLA",75,0,0,75,"2011","177"
"2364","PROSERPIO",5,1,0,6,"2011","192"
"2365","PROVAGLIO D'ISEO",66,142,6,214,"2011","156"
"2366","PROVAGLIO VAL SABBIA",42,0,3,45,"2011","157"
"2367","PRUNETTO",63,0,1,64,"2011","178"
"2368","PUEGNAGO SUL GARDA",19,73,2,94,"2011","158"
"2369","PUMENENGO",1160,524,0,1684,"2011","177"
"2370","PUOS D'ALPAGO",3,123,0,126,"2011","041"
"2371","PUSIANO",0,0,2,2,"2011","193"
"2372","QUAGLIUZZO",0,16,1,17,"2011","208"
"2373","QUAREGNA",1,0,1,2,"2011","051"
"2374","QUARGNENTO",779,0,131,910,"2011","141"
"2375","QUARNA SOPRA",0,0,1,1,"2011","058"
"2376","QUARNA SOTTO",1,0,5,6,"2011","059"
"2377","QUARONA",15,0,1,16,"2011","107"
"2378","QUARTO D'ALTINO",82,73,0,155,"2011","031"
"2379","QUASSOLO",0,13,51,64,"2011","209"
"2380","QUATTORDIO",499,0,48,547,"2011","142"
"2381","QUATTRO CASTELLA",20,1142,0,1162,"2011","030"
"2382","QUERO",57,48,0,105,"2011","042"
"2383","QUINCINETTO",0,41,48,89,"2011","210"
"2384","QUINGENTOLE",822,47,106,975,"2011","046"
"2385","QUINTANO",0,298,1,299,"2011","078"
"2386","QUINTO DI TREVISO",173,171,46,390,"2011","064"
"2387","QUINTO VERCELLESE",21,0,0,21,"2011","108"
"2388","QUINTO VICENTINO",139,567,56,762,"2011","083"
"2389","QUINZANO D'OGLIO",129,2765,0,2894,"2011","159"
"2390","QUISTELLO",90,1737,555,2382,"2011","047"
"2391","QUITTENGO",2,0,2,4,"2011","052"
"2392","RACCONIGI",1801,1954,83,3838,"2011","179"
"2393","RAMISETO",30,234,0,264,"2011","031"
"2394","RAMPONIO VERNA",9,17,2,28,"2011","194"
"2395","RANCIO VALCUVIA",3,12,0,15,"2011","115"
"2396","RANCO",0,0,32,32,"2011","116"
"2397","RANICA",15,33,0,48,"2011","178"
"2398","RANZANICO",6,30,0,36,"2011","179"
"2399","RASSA",0,21,0,21,"2011","110"
"2400","RASURA",0,1,0,1,"2011","055"
"2401","RAVENNA",1445,1168,2,2615,"2011","014"
"2402","RE",1,0,5,6,"2011","060"
"2403","REANO",0,0,31,31,"2011","211"
"2404","RECOARO TERME",79,97,0,176,"2011","084"
"2405","REDAVALLE",130,0,0,130,"2011","120"
"2406","REDONDESCO",281,256,384,921,"2011","048"
"2407","REFRANCORE",43,0,15,58,"2011","089"
"2408","REFRONTOLO",32,32,0,64,"2011","065"
"2409","REGGIO NELL'EMILIA",60,10736,0,10796,"2011","033"
"2410","REGGIOLO",1256,2109,1,3366,"2011","032"
"2411","REMEDELLO",6652,2106,107,8865,"2011","160"
"2412","RESANA",2766,36,22,2824,"2011","066"
"2413","REVELLO",6547,1617,96,8260,"2011","180"
"2414","REVERE",2,105,4,111,"2011","049"
"2415","REVIGLIASCO D'ASTI",284,0,1,285,"2011","090"
"2416","REVINE LAGO",4,32,0,36,"2011","067"
"2417","REZZATO",3,485,0,488,"2011","161"
"2418","RHO",3,250,10,263,"2011","182"
"2419","RIBORDONE",0,0,5,5,"2011","212"
"2420","RICCIONE",7,0,0,7,"2011","013"
"2421","RICENGO",37,1855,0,1892,"2011","079"
"2422","RIESE PIO X",8738,445,51,9234,"2011","068"
"2423","RIFREDDO",1035,117,0,1152,"2011","181"
"2424","RIMA SAN GIUSEPPE",8,0,0,8,"2011","111"
"2425","RIMASCO",0,8,0,8,"2011","112"
"2426","RIMELLA",1,23,0,24,"2011","113"
"2427","RIMINI",180,71,0,251,"2011","014"
"2428","RIO SALICETO",766,490,0,1256,"2011","034"
"2429","RIOLO TERME",371,0,0,371,"2011","015"
"2430","RIOLUNATO",60,15,0,75,"2011","035"
"2431","RIPALTA ARPINA",17,315,0,332,"2011","080"
"2432","RIPALTA CREMASCA",4,360,0,364,"2011","081"
"2433","RIPALTA GUERINA",0,353,0,353,"2011","082"
"2434","RIVA DI SOLTO",14,1,0,15,"2011","180"
"2435","RIVA PRESSO CHIERI",3806,107,0,3913,"2011","215"
"2436","RIVA VALDOBBIA",6,42,1,49,"2011","114"
"2437","RIVALBA",11,0,78,89,"2011","213"
"2438","RIVALTA DI TORINO",4,10,109,123,"2011","214"
"2439","RIVAMONTE AGORDINO",0,0,27,27,"2011","043"
"2440","RIVANAZZANO",130,0,0,130,"2011","122"
"2441","RIVARA",69,0,191,260,"2011","216"
"2442","RIVAROLO CANAVESE",208,177,1013,1398,"2011","217"
"2443","RIVAROLO DEL RE ED UNITI",3393,286,0,3679,"2011","083"
"2444","RIVAROLO MANTOVANO",70,997,41,1108,"2011","050"
"2445","RIVAROSSA",0,0,147,147,"2011","218"
"2446","RIVERGARO",258,513,0,771,"2011","038"
"2447","RIVOLI",770,1,912,1683,"2011","219"
"2448","RIVOLI VERONESE",152,52,18,222,"2011","062"
"2449","RIVOLTA D'ADDA",1893,2764,3,4660,"2011","084"
"2450","RO",15,47,0,62,"2011","020"
"2451","ROANA",56,438,0,494,"2011","085"
"2452","ROASCIO",27,0,3,30,"2011","184"
"2453","ROASIO",23,0,0,23,"2011","116"
"2454","ROATTO",49,0,34,83,"2011","091"
"2455","ROBASSOMERO",0,70,34,104,"2011","220"
"2456","ROBBIO",13,175,0,188,"2011","123"
"2457","ROBECCHETTO CON INDUNO",251,138,0,389,"2011","183"
"2458","ROBECCO D'OGLIO",107,2693,0,2800,"2011","085"
"2459","ROBECCO PAVESE",21,0,0,21,"2011","124"
"2460","ROBECCO SUL NAVIGLIO",72,544,0,616,"2011","184"
"2461","ROBELLA",432,0,8,440,"2011","092"
"2462","ROBILANTE",271,0,0,271,"2011","185"
"2463","ROBURENT",21,0,0,21,"2011","186"
"2464","ROCCA CANAVESE",0,0,65,65,"2011","221"
"2465","ROCCA CIGLIE'",48,0,0,48,"2011","188"
"2466","ROCCA D'ARAZZO",481,0,0,481,"2011","093"
"2467","ROCCA DE' BALDI",2631,1271,338,4240,"2011","189"
"2468","ROCCA DE' GIORGI",4,0,0,4,"2011","125"
"2469","ROCCA GRIMALDA",0,0,13,13,"2011","147"
"2470","ROCCA PIETORE",0,2,0,2,"2011","044"
"2471","ROCCA SAN CASCIANO",88,0,0,88,"2011","036"
"2472","ROCCABIANCA",0,1389,0,1389,"2011","030"
"2473","ROCCABRUNA",730,0,41,771,"2011","187"
"2474","ROCCAFORTE LIGURE",0,0,39,39,"2011","146"
"2475","ROCCAFORTE MONDOVI'",882,120,0,1002,"2011","190"
"2476","ROCCAFRANCA",1691,1180,0,2871,"2011","162"
"2477","ROCCASPARVERA",517,0,0,517,"2011","191"
"2478","ROCCAVERANO",241,0,0,241,"2011","094"
"2479","ROCCAVIONE",26,0,1,27,"2011","192"
"2480","ROCCHETTA LIGURE",27,0,0,27,"2011","148"
"2481","ROCCHETTA PALAFEA",7,0,0,7,"2011","095"
"2482","ROCCHETTA TANARO",256,0,0,256,"2011","096"
"2483","RODANO",2,148,0,150,"2011","185"
"2484","RODDI",0,5,57,62,"2011","194"
"2485","RODDINO",5,0,73,78,"2011","195"
"2486","RODELLO",7,0,72,79,"2011","196"
"2487","RODENGO-SAIANO",189,246,0,435,"2011","163"
"2488","RODIGO",1221,1121,776,3118,"2011","051"
"2489","ROE' VOLCIANO",10,0,0,10,"2011","164"
"2490","ROGENO",146,226,0,372,"2011","072"
"2491","ROGNANO",10,0,0,10,"2011","127"
"2492","ROGNO",13,113,0,126,"2011","182"
"2493","ROGOLO",0,20,0,20,"2011","056"
"2494","ROLETTO",76,76,170,322,"2011","222"
"2495","ROLO",0,202,0,202,"2011","035"
"2496","ROMAGNANO SESIA",33,0,2,35,"2011","130"
"2497","ROMAGNESE",138,0,0,138,"2011","128"
"2498","ROMANENGO",1,1914,0,1915,"2011","086"
"2499","ROMANO CANAVESE",2,0,40,42,"2011","223"
"2500","ROMANO D'EZZELINO",187,502,0,689,"2011","086"
"2501","ROMANO DI LOMBARDIA",169,2357,0,2526,"2011","183"
"2502","ROMENTINO",12,0,0,12,"2011","131"
"2503","RONAGO",5,46,0,51,"2011","199"
"2504","RONCA'",7,5,0,12,"2011","063"
"2505","RONCADE",2140,168,6,2314,"2011","069"
"2506","RONCADELLE",327,553,0,880,"2011","165"
"2507","RONCARO",2,0,0,2,"2011","129"
"2508","RONCO ALL'ADIGE",6847,15,0,6862,"2011","064"
"2509","RONCO BIELLESE",2,63,1,66,"2011","053"
"2510","RONCO CANAVESE",0,0,74,74,"2011","224"
"2511","RONCOFERRARO",2816,490,565,3871,"2011","052"
"2512","RONCOFREDDO",52,53,0,105,"2011","037"
"2513","RONCOLA",35,35,0,70,"2011","185"
"2514","RONDISSONE",0,0,6,6,"2011","225"
"2515","ROPPOLO",4,0,9,13,"2011","054"
"2516","RORA'",1,0,31,32,"2011","226"
"2517","ROSA'",158,900,0,1058,"2011","087"
"2518","ROSASCO",4,0,0,4,"2011","130"
"2519","ROSATE",3222,466,0,3688,"2011","188"
"2520","ROSIGNANO MONFERRATO",0,0,101,101,"2011","149"
"2521","ROSOLINA",988,0,0,988,"2011","040"
"2522","ROSSA",7,21,9,37,"2011","121"
"2523","ROSSANA",293,67,0,360,"2011","197"
"2524","ROSSANO VENETO",360,203,13,576,"2011","088"
"2525","ROSTA",0,0,86,86,"2011","228"
"2526","ROTA D'IMAGNA",18,39,1,58,"2011","186"
"2527","ROTTOFRENO",272,524,0,796,"2011","039"
"2528","ROTZO",71,0,0,71,"2011","089"
"2529","ROURE",0,4,12,16,"2011","227"
"2530","ROVAGNATE",23,0,9,32,"2011","073"
"2531","ROVASENDA",9,0,1,10,"2011","122"
"2532","ROVATO",1698,1949,0,3647,"2011","166"
"2533","ROVELLASCA",32,63,0,95,"2011","201"
"2534","ROVERBELLA",12986,624,516,14126,"2011","053"
"2535","ROVERCHIARA",5198,38,0,5236,"2011","065"
"2536","ROVERE' VERONESE",194,1230,6,1430,"2011","067"
"2537","ROVEREDO DI GUA'",1855,73,16,1944,"2011","066"
"2538","ROVESCALA",11,0,0,11,"2011","131"
"2539","ROVETTA",10,135,0,145,"2011","187"
"2540","ROVIGO",1403,0,0,1403,"2011","041"
"2541","ROVOLON",204,163,89,456,"2011","071"
"2542","ROZZANO",0,2,0,2,"2011","189"
"2543","RUBANO",47,45,41,133,"2011","072"
"2544","RUBIANA",0,0,15,15,"2011","229"
"2545","RUBIERA",0,622,0,622,"2011","036"
"2546","RUDIANO",458,1022,0,1480,"2011","167"
"2547","RUEGLIO",2,81,127,210,"2011","230"
"2548","RUFFIA",355,296,0,651,"2011","198"
"2549","RUINO",133,0,0,133,"2011","132"
"2550","RUSSI",10,60,0,70,"2011","016"
"2551","SABBIO CHIESE",18,25,0,43,"2011","168"
"2552","SABBIONETA",46,136,0,182,"2011","054"
"2553","SACCOLONGO",104,395,85,584,"2011","073"
"2554","SAGLIANO MICCA",0,0,32,32,"2011","056"
"2555","SALA BAGANZA",11,103,0,114,"2011","031"
"2556","SALA BIELLESE",0,0,8,8,"2011","057"
"2557","SALA BOLOGNESE",296,111,0,407,"2011","050"
"2558","SALA COMACINA",2,0,2,4,"2011","203"
"2559","SALA MONFERRATO",89,0,0,89,"2011","150"
"2560","SALARA",46,0,0,46,"2011","042"
"2561","SALASSA",3,0,0,3,"2011","231"
"2562","SALBERTRAND",0,0,21,21,"2011","232"
"2563","SALCEDO",539,75,1,615,"2011","090"
"2564","SALE",76,0,5,81,"2011","151"
"2565","SALE DELLE LANGHE",1,0,10,11,"2011","199"
"2566","SALE MARASINO",68,20,0,88,"2011","169"
"2567","SALE SAN GIOVANNI",44,0,0,44,"2011","200"
"2568","SALERANO SUL LAMBRO",3,262,0,265,"2011","046"
"2569","SALETTO",13,54,0,67,"2011","074"
"2570","SALGAREDA",2177,329,1,2507,"2011","070"
"2571","SALICETO",91,0,16,107,"2011","201"
"2572","SALIZZOLE",2669,500,0,3169,"2011","068"
"2573","SALMOUR",215,0,0,215,"2011","202"
"2574","SALO'",7,51,0,58,"2011","170"
"2575","SALSOMAGGIORE TERME",51,1092,20,1163,"2011","032"
"2576","SALTRIO",39,0,0,39,"2011","117"
"2577","SALUDECIO",117,58,0,175,"2011","015"
"2578","SALUGGIA",292,185,102,579,"2011","128"
"2579","SALUSSOLA",304,52,125,481,"2011","058"
"2580","SALUZZO",3081,3366,8,6455,"2011","203"
"2581","SALVIROLA",610,109,0,719,"2011","087"
"2582","SALZANO",262,22,0,284,"2011","032"
"2583","SAMARATE",34,0,0,34,"2011","118"
"2584","SAMBUCO",13,5,1,19,"2011","204"
"2585","SAMOLACO",174,648,1,823,"2011","057"
"2586","SAMONE",0,0,12,12,"2011","235"
"2587","SAMPEYRE",193,37,0,230,"2011","205"
"2588","SAN BARTOLOMEO VAL CAVARGNA",10,0,3,13,"2011","204"
"2589","SAN BASSANO",28,1559,24,1611,"2011","088"
"2590","SAN BELLINO",1648,0,0,1648,"2011","043"
"2591","SAN BENEDETTO BELBO",0,0,78,78,"2011","206"
"2592","SAN BENEDETTO PO",314,1527,1534,3375,"2011","055"
"2593","SAN BENEDETTO VAL DI SAMBRO",213,149,0,362,"2011","051"
"2594","SAN BENIGNO CANAVESE",113,45,208,366,"2011","236"
"2595","SAN BERNARDINO VERBANO",0,0,6,6,"2011","061"
"2596","SAN BIAGIO DI CALLALTA",278,79,13,370,"2011","071"
"2597","SAN BONIFACIO",2545,0,0,2545,"2011","069"
"2598","SAN CARLO CANAVESE",2,266,245,513,"2011","237"
"2599","SAN CESARIO SUL PANARO",43,966,0,1009,"2011","036"
"2600","SAN CIPRIANO PO",99,0,0,99,"2011","133"
"2601","SAN CLEMENTE",28,0,0,28,"2011","016"
"2602","SAN COLOMBANO AL LAMBRO",19,317,0,336,"2011","191"
"2603","SAN COLOMBANO BELMONTE",2,0,23,25,"2011","238"
"2604","SAN CRISTOFORO",8,0,0,8,"2011","152"
"2605","SAN DAMIANO D'ASTI",4281,0,146,4427,"2011","097"
"2606","SAN DAMIANO MACRA",47,0,0,47,"2011","207"
"2607","SAN DANIELE PO",41,1204,0,1245,"2011","089"
"2608","SAN DIDERO",0,7,0,7,"2011","239"
"2609","SAN DONA' DI PIAVE",311,465,8,784,"2011","033"
"2610","SAN DONATO MILANESE",2,0,0,2,"2011","192"
"2611","SAN FEDELE INTELVI",15,17,11,43,"2011","205"
"2612","SAN FELICE DEL BENACO",4,0,0,4,"2011","171"
"2613","SAN FELICE SUL PANARO",0,598,8,606,"2011","037"
"2614","SAN FERMO DELLA BATTAGLIA",7,0,15,22,"2011","206"
"2615","SAN FIOR",49,53,0,102,"2011","072"
"2616","SAN FIORANO",8,116,0,124,"2011","047"
"2617","SAN FRANCESCO AL CAMPO",132,330,282,744,"2011","240"
"2618","SAN GENESIO ED UNITI",2,377,0,379,"2011","135"
"2619","SAN GERMANO CHISONE",1,37,65,103,"2011","242"
"2620","SAN GERMANO DEI BERICI",226,241,8,475,"2011","092"
"2621","SAN GERMANO VERCELLESE",18,0,0,18,"2011","131"
"2622","SAN GERVASIO BRESCIANO",3,246,0,249,"2011","172"
"2623","SAN GIACOMO DELLE SEGNATE",380,153,239,772,"2011","056"
"2624","SAN GIACOMO FILIPPO",2,0,0,2,"2011","058"
"2625","SAN GIACOMO VERCELLESE",1871,0,0,1871,"2011","035"
"2626","SAN GILLIO",16,22,151,189,"2011","243"
"2627","SAN GIORGIO CANAVESE",219,34,160,413,"2011","244"
"2628","SAN GIORGIO DELLE PERTICHE",281,129,3,413,"2011","075"
"2629","SAN GIORGIO DI LOMELLINA",9,0,0,9,"2011","136"
"2630","SAN GIORGIO DI MANTOVA",476,104,80,660,"2011","057"
"2631","SAN GIORGIO DI PIANO",27,0,0,27,"2011","052"
"2632","SAN GIORGIO IN BOSCO",279,1042,0,1321,"2011","076"
"2633","SAN GIORGIO MONFERRATO",16,0,0,16,"2011","153"
"2634","SAN GIORGIO PIACENTINO",213,567,0,780,"2011","040"
"2635","SAN GIORGIO SCARAMPI",34,0,46,80,"2011","098"
"2636","SAN GIORIO DI SUSA",1,15,10,26,"2011","245"
"2637","SAN GIOVANNI BIANCO",46,50,0,96,"2011","188"
"2638","SAN GIOVANNI DEL DOSSO",0,316,69,385,"2011","058"
"2639","SAN GIOVANNI ILARIONE",848,12,0,860,"2011","070"
"2640","SAN GIOVANNI IN CROCE",0,396,2,398,"2011","090"
"2641","SAN GIOVANNI IN MARIGNANO",12,0,0,12,"2011","017"
"2642","SAN GIOVANNI IN PERSICETO",159,741,0,900,"2011","053"
"2643","SAN GIOVANNI LUPATOTO",571,28,0,599,"2011","071"
"2644","SAN GIULIANO MILANESE",11,447,0,458,"2011","195"
"2645","SAN GIUSTO CANAVESE",6,1,134,141,"2011","246"
"2646","SAN GREGORIO NELLE ALPI",24,67,0,91,"2011","045"
"2647","SAN LAZZARO DI SAVENA",10,10,0,20,"2011","054"
"2648","SAN LEO",328,323,9,660,"2011","025"
"2649","SAN MARTINO ALFIERI",16,0,0,16,"2011","099"
"2650","SAN MARTINO BUON ALBERGO",378,888,0,1266,"2011","073"
"2651","SAN MARTINO CANAVESE",3,0,49,52,"2011","247"
"2652","SAN MARTINO DALL'ARGINE",0,707,331,1038,"2011","059"
"2653","SAN MARTINO DEL LAGO",6,0,0,6,"2011","091"
"2654","SAN MARTINO DI LUPARI",2545,345,41,2931,"2011","077"
"2655","SAN MARTINO DI VENEZZE",1,0,1,2,"2011","044"
"2656","SAN MARTINO IN RIO",1,1093,0,1094,"2011","037"
"2657","SAN MARTINO IN STRADA",257,693,0,950,"2011","048"
"2658","SAN MARTINO SICCOMARIO",0,2,0,2,"2011","137"
"2659","SAN MARZANO OLIVETO",14,13,0,27,"2011","100"
"2660","SAN MAURIZIO CANAVESE",0,557,152,709,"2011","248"
"2661","SAN MAURIZIO D'OPAGLIO",10,0,6,16,"2011","133"
"2662","SAN MAURO DI SALINE",101,293,0,394,"2011","074"
"2663","SAN MAURO PASCOLI",2,0,0,2,"2011","041"
"2664","SAN MAURO TORINESE",4,0,22,26,"2011","249"
"2665","SAN MICHELE AL TAGLIAMENTO",1547,50,0,1597,"2011","034"
"2666","SAN MICHELE MONDOVI'",154,0,0,154,"2011","210"
"2667","SAN NAZARIO",18,0,0,18,"2011","093"
"2668","SAN NAZZARO SESIA",88,0,0,88,"2011","134"
"2669","SAN NAZZARO VAL CAVARGNA",8,0,10,18,"2011","207"
"2670","SAN NICOLO' DI COMELICO",1,4,0,5,"2011","046"
"2671","SAN PAOLO",482,1866,30,2378,"2011","138"
"2672","SAN PAOLO CERVO",0,0,2,2,"2011","060"
"2673","SAN PAOLO D'ARGON",49,47,0,96,"2011","189"
"2674","SAN PAOLO SOLBRITO",17,0,0,17,"2011","101"
"2675","SAN PELLEGRINO TERME",38,36,0,74,"2011","190"
"2676","SAN PIETRO DI CADORE",10,34,0,44,"2011","047"
"2677","SAN PIETRO DI FELETTO",29,12,10,51,"2011","073"
"2678","SAN PIETRO DI MORUBIO",3,0,0,3,"2011","075"
"2679","SAN PIETRO IN CARIANO",0,1,0,1,"2011","076"
"2680","SAN PIETRO IN CASALE",45,182,0,227,"2011","055"
"2681","SAN PIETRO IN CERRO",21,794,0,815,"2011","041"
"2682","SAN PIETRO IN GU",802,2871,11,3684,"2011","078"
"2683","SAN PIETRO MOSEZZO",1,0,13,14,"2011","135"
"2684","SAN PIETRO MUSSOLINO",10,0,0,10,"2011","094"
"2685","SAN PIETRO VAL LEMINA",0,0,9,9,"2011","250"
"2686","SAN PIETRO VIMINARIO",1307,148,0,1455,"2011","079"
"2687","SAN POLO D'ENZA",3,807,0,810,"2011","038"
"2688","SAN POLO DI PIAVE",951,85,2,1038,"2011","074"
"2689","SAN PONSO",0,0,52,52,"2011","251"
"2690","SAN POSSIDONIO",595,292,0,887,"2011","038"
"2691","SAN PROSPERO",4,407,0,411,"2011","039"
"2692","SAN RAFFAELE CIMENA",3,0,37,40,"2011","252"
"2693","SAN ROCCO AL PORTO",379,312,0,691,"2011","049"
"2694","SAN SALVATORE MONFERRATO",118,0,35,153,"2011","154"
"2695","SAN SEBASTIANO CURONE",7,0,0,7,"2011","155"
"2696","SAN SEBASTIANO DA PO",8,0,283,291,"2011","253"
"2697","SAN SECONDO DI PINEROLO",133,160,281,574,"2011","254"
"2698","SAN SECONDO PARMENSE",10,1550,0,1560,"2011","033"
"2699","SAN SIRO",0,0,4,4,"2011","248"
"2700","SAN VENDEMIANO",100,161,1,262,"2011","076"
"2701","SAN VITO DI CADORE",1,0,0,1,"2011","051"
"2702","SAN VITO DI LEGUZZANO",207,109,0,316,"2011","096"
"2703","SAN VITTORE OLONA",15,40,0,55,"2011","201"
"2704","SAN ZENO DI MONTAGNA",98,228,29,355,"2011","079"
"2705","SAN ZENO NAVIGLIO",2,483,0,485,"2011","173"
"2706","SAN ZENONE AL LAMBRO",0,735,0,735,"2011","202"
"2707","SAN ZENONE DEGLI EZZELINI",2852,574,7,3433,"2011","077"
"2708","SANDIGLIANO",6,62,46,114,"2011","059"
"2709","SANDRIGO",1916,1365,0,3281,"2011","091"
"2710","SANFRE'",325,0,407,732,"2011","208"
"2711","SANFRONT",2419,200,0,2619,"2011","209"
"2712","SANGANO",80,40,39,159,"2011","241"
"2713","SANGIANO",0,36,0,36,"2011","141"
"2714","SANGUINETTO",8,132,0,140,"2011","072"
"2715","SANNAZZARO DE' BURGONDI",20,70,0,90,"2011","138"
"2716","SANT'AGATA BOLOGNESE",11,534,0,545,"2011","056"
"2717","SANT'AGATA FELTRIA",177,51,5,233,"2011","026"
"2718","SANT'AGATA FOSSILI",50,0,14,64,"2011","156"
"2719","SANT'AGATA SUL SANTERNO",34,0,0,34,"2011","017"
"2720","SANT'AGOSTINO",2,0,0,2,"2011","021"
"2721","SANT'ALBANO STURA",4211,543,307,5061,"2011","211"
"2722","SANT'ALESSIO CON VIALONE",3,0,0,3,"2011","141"
"2723","SANT'AMBROGIO DI TORINO",2,13,62,77,"2011","255"
"2724","SANT'AMBROGIO DI VALPOLICELLA",0,82,0,82,"2011","077"
"2725","SANT'ANGELO DI PIOVE DI SACCO",278,44,0,322,"2011","082"
"2726","SANT'ANGELO LODIGIANO",38,366,0,404,"2011","050"
"2727","SANT'ANGELO LOMELLINA",52,232,0,284,"2011","144"
"2728","SANT'ANNA D'ALFAEDO",201,1199,51,1451,"2011","078"
"2729","SANT'ANTONINO DI SUSA",2,0,78,80,"2011","256"
"2730","SANT'ELENA",56,0,0,56,"2011","083"
"2731","SANT'ILARIO D'ENZA",0,667,0,667,"2011","039"
"2732","SANT'OMOBONO TERME",39,34,0,73,"2011","192"
"2733","SANT'URBANO",747,0,2,749,"2011","084"
"2734","SANTA BRIGIDA",2,30,0,32,"2011","191"
"2735","SANTA CRISTINA E BISSONE",15,205,0,220,"2011","139"
"2736","SANTA GIULETTA",16,0,0,16,"2011","140"
"2737","SANTA GIUSTINA",1773,159,0,1932,"2011","048"
"2738","SANTA GIUSTINA IN COLLE",1113,414,35,1562,"2011","080"
"2739","SANTA LUCIA DI PIAVE",72,110,0,182,"2011","075"
"2740","SANTA MARGHERITA D'ADIGE",259,30,0,289,"2011","081"
"2741","SANTA MARGHERITA DI STAFFORA",97,0,0,97,"2011","142"
"2742","SANTA MARIA DELLA VERSA",4,0,0,4,"2011","143"
"2743","SANTA MARIA DI SALA",102,134,25,261,"2011","035"
"2744","SANTA MARIA HOE'",5,0,0,5,"2011","074"
"2745","SANTA MARIA MAGGIORE",0,0,26,26,"2011","062"
"2746","SANTA SOFIA",277,0,5,282,"2011","043"
"2747","SANTA VITTORIA D'ALBA",28,0,42,70,"2011","212"
"2748","SANTARCANGELO DI ROMAGNA",30,0,0,30,"2011","018"
"2749","SANTENA",533,0,0,533,"2011","257"
"2750","SANTHIA'",145,107,71,323,"2011","133"
"2751","SANTO STEFANO BELBO",8,0,6,14,"2011","213"
"2752","SANTO STEFANO DI CADORE",2,18,0,20,"2011","050"
"2753","SANTO STEFANO LODIGIANO",23,264,0,287,"2011","051"
"2754","SANTO STEFANO ROERO",55,0,71,126,"2011","214"
"2755","SANTO STEFANO TICINO",0,80,0,80,"2011","200"
"2756","SANTO STINO DI LIVENZA",3077,110,0,3187,"2011","036"
"2757","SANTORSO",420,211,2,633,"2011","095"
"2758","SAONARA",232,3,0,235,"2011","085"
"2759","SAPPADA",3,61,0,64,"2011","052"
"2760","SARCEDO",1571,369,0,1940,"2011","097"
"2761","SARDIGLIANO",0,2,4,6,"2011","157"
"2762","SAREGO",391,30,1,422,"2011","098"
"2763","SAREZZO",21,32,0,53,"2011","174"
"2764","SARMATO",8,241,0,249,"2011","042"
"2765","SARMEDE",107,72,0,179,"2011","078"
"2766","SARNICO",11,0,0,11,"2011","193"
"2767","SARONNO",3,0,3,6,"2011","119"
"2768","SARSINA",168,9,0,177,"2011","044"
"2769","SARTIRANA LOMELLINA",1,0,0,1,"2011","146"
"2770","SASSO MARCONI",24,15,0,39,"2011","057"
"2771","SASSUOLO",48,501,0,549,"2011","040"
"2772","SAUZE D'OULX",0,0,4,4,"2011","259"
"2773","SAUZE DI CESANA",0,17,0,17,"2011","258"
"2774","SAVIGLIANO",10571,4307,321,15199,"2011","215"
"2775","SAVIGNANO SUL PANARO",38,87,0,125,"2011","041"
"2776","SAVIGNANO SUL RUBICONE",81,0,0,81,"2011","045"
"2777","SAVIGNO",32,376,0,408,"2011","058"
"2778","SAVIORE DELL'ADAMELLO",5,36,1,42,"2011","175"
"2779","SCAGNELLO",165,0,0,165,"2011","216"
"2780","SCALDASOLE",0,72,0,72,"2011","147"
"2781","SCALENGHE",1291,2190,314,3795,"2011","260"
"2782","SCANDIANO",48,1500,8,1556,"2011","040"
"2783","SCANDOLARA RAVARA",0,499,0,499,"2011","092"
"2784","SCANDOLARA RIPA D'OGLIO",18,737,94,849,"2011","093"
"2785","SCANZOROSCIATE",63,14,0,77,"2011","194"
"2786","SCARMAGNO",3,0,5,8,"2011","261"
"2787","SCARNAFIGI",1205,1740,0,2945,"2011","217"
"2788","SCHIAVON",1919,1661,10,3590,"2011","099"
"2789","SCHIGNANO",0,0,20,20,"2011","211"
"2790","SCHILPARIO",7,52,0,59,"2011","195"
"2791","SCHIO",80,256,0,336,"2011","100"
"2792","SCHIVENOGLIA",0,32,0,32,"2011","060"
"2793","SCIOLZE",8,0,79,87,"2011","262"
"2794","SCOPA",0,15,1,16,"2011","134"
"2795","SCOPELLO",2,6,0,8,"2011","135"
"2796","SCORZE'",3049,104,34,3187,"2011","037"
"2797","SECUGNAGO",21,1170,0,1191,"2011","052"
"2798","SEDICO",1335,73,32,1440,"2011","053"
"2799","SEDRIANO",14,507,0,521,"2011","204"
"2800","SEDRINA",17,12,0,29,"2011","196"
"2801","SEGRATE",7,0,0,7,"2011","205"
"2802","SEGUSINO",7,91,0,98,"2011","079"
"2803","SELLERO",6,37,0,43,"2011","176"
"2804","SELVA DI CADORE",0,11,0,11,"2011","054"
"2805","SELVA DI PROGNO",57,633,0,690,"2011","080"
"2806","SELVAZZANO DENTRO",20,1,85,106,"2011","086"
"2807","SELVINO",5,0,0,5,"2011","197"
"2808","SEMIANA",5,0,0,5,"2011","148"
"2809","SENIGA",2034,1605,0,3639,"2011","177"
"2810","SENNA COMASCO",34,208,16,258,"2011","212"
"2811","SENNA LODIGIANA",12,833,0,845,"2011","053"
"2812","SEREN DEL GRAPPA",68,90,188,346,"2011","055"
"2813","SERGNANO",11,1621,0,1632,"2011","094"
"2814","SERIATE",853,71,0,924,"2011","198"
"2815","SERINA",17,101,0,118,"2011","199"
"2816","SERLE",40,39,0,79,"2011","178"
"2817","SERMIDE",1,232,108,341,"2011","061"
"2818","SERNAGLIA DELLA BATTAGLIA",270,21,0,291,"2011","080"
"2819","SERNIO",4,0,0,4,"2011","059"
"2820","SEROLE",75,0,0,75,"2011","104"
"2821","SERRALUNGA D'ALBA",27,0,0,27,"2011","218"
"2822","SERRALUNGA DI CREA",15,0,0,15,"2011","159"
"2823","SERRAMAZZONI",91,1511,0,1602,"2011","042"
"2824","SERRAVALLE A PO",3,20,347,370,"2011","062"
"2825","SERRAVALLE LANGHE",96,0,57,153,"2011","219"
"2826","SERRAVALLE SCRIVIA",5,0,5,10,"2011","160"
"2827","SERRAVALLE SESIA",8,0,0,8,"2011","137"
"2828","SESTO CALENDE",33,0,0,33,"2011","120"
"2829","SESTO ED UNITI",3,1116,322,1441,"2011","095"
"2830","SESTO SAN GIOVANNI",2,0,0,2,"2011","209"
"2831","SESTOLA",85,323,0,408,"2011","043"
"2832","SETTALA",48,181,0,229,"2011","210"
"2833","SETTIME",282,0,0,282,"2011","106"
"2834","SETTIMO MILANESE",82,336,5,423,"2011","211"
"2835","SETTIMO ROTTARO",9,0,36,45,"2011","264"
"2836","SETTIMO TORINESE",384,283,133,800,"2011","265"
"2837","SETTIMO VITTONE",11,78,223,312,"2011","266"
"2838","SEZZADIO",32,0,3,35,"2011","161"
"2839","SILEA",9,81,3,93,"2011","081"
"2840","SILLAVENGO",22,80,0,102,"2011","138"
"2841","SILVANO D'ORBA",7,0,0,7,"2011","162"
"2842","SINIO",0,1,17,18,"2011","220"
"2843","SIRONE",16,66,1,83,"2011","075"
"2844","SIRTORI",9,0,0,9,"2011","076"
"2845","SISSA",6,413,0,419,"2011","034"
"2846","SIZIANO",58,59,0,117,"2011","150"
"2847","SIZZANO",274,27,183,484,"2011","139"
"2848","SOAVE",169,0,0,169,"2011","081"
"2849","SOGLIANO AL RUBICONE",229,46,0,275,"2011","046"
"2850","SOGLIO",2,0,0,2,"2011","107"
"2851","SOIANO DEL LAGO",19,0,0,19,"2011","180"
"2852","SOLAGNA",0,8,0,8,"2011","101"
"2853","SOLARO",0,6,0,6,"2011","213"
"2854","SOLAROLO",2,0,0,2,"2011","018"
"2855","SOLAROLO RAINERIO",21,242,0,263,"2011","096"
"2856","SOLBIATE",40,41,2,83,"2011","215"
"2857","SOLERO",121,0,191,312,"2011","163"
"2858","SOLESINO",6,0,0,6,"2011","087"
"2859","SOLFERINO",636,285,95,1016,"2011","063"
"2860","SOLIERA",42,469,0,511,"2011","044"
"2861","SOLIGNANO",34,297,0,331,"2011","035"
"2862","SOLONGHELLO",79,0,0,79,"2011","164"
"2863","SOLTO COLLINA",17,0,0,17,"2011","200"
"2864","SOMAGLIA",11,1114,0,1125,"2011","054"
"2865","SOMANO",45,0,0,45,"2011","221"
"2866","SOMMA LOMBARDO",18,9,0,27,"2011","123"
"2867","SOMMACAMPAGNA",1802,406,157,2365,"2011","082"
"2868","SOMMARIVA DEL BOSCO",482,556,859,1897,"2011","222"
"2869","SOMMARIVA PERNO",23,0,3,26,"2011","223"
"2870","SOMMO",43,0,0,43,"2011","151"
"2871","SONA",3038,620,172,3830,"2011","083"
"2872","SONCINO",478,4758,41,5277,"2011","097"
"2873","SONDALO",27,113,5,145,"2011","060"
"2874","SONDRIO",13,31,1,45,"2011","061"
"2875","SONGAVAZZO",2,0,0,2,"2011","201"
"2876","SONICO",4,106,9,119,"2011","181"
"2877","SORAGNA",7,1698,0,1705,"2011","036"
"2878","SORBOLO",661,1483,0,2144,"2011","037"
"2879","SORDEVOLO",20,22,118,160,"2011","063"
"2880","SORDIO",0,309,0,309,"2011","055"
"2881","SORESINA",33,1680,82,1795,"2011","098"
"2882","SORGA'",1708,50,0,1758,"2011","084"
"2883","SORICO",9,19,43,71,"2011","216"
"2884","SORISO",1,0,1,2,"2011","140"
"2885","SORISOLE",62,36,0,98,"2011","202"
"2886","SORMANO",18,0,2,20,"2011","217"
"2887","SOSPIRO",49,462,0,511,"2011","099"
"2888","SOSPIROLO",12,111,0,123,"2011","056"
"2889","SOSSANO",98,470,0,568,"2011","102"
"2890","SOSTEGNO",1,0,0,1,"2011","064"
"2891","SOTTO IL MONTE GIOVANNI XXIII",43,64,0,107,"2011","203"
"2892","SOVERE",87,71,0,158,"2011","204"
"2893","SOVERZENE",1,0,0,1,"2011","057"
"2894","SOVIZZO",959,70,0,1029,"2011","103"
"2895","SOVRAMONTE",8,103,21,132,"2011","058"
"2896","SOZZAGO",13,0,0,13,"2011","141"
"2897","SPARONE",2,18,92,112,"2011","267"
"2898","SPESSA",12,0,0,12,"2011","152"
"2899","SPIGNO MONFERRATO",23,7,127,157,"2011","165"
"2900","SPILAMBERTO",2080,1276,0,3356,"2011","045"
"2901","SPINADESCO",74,0,0,74,"2011","100"
"2902","SPINEA",25,160,0,185,"2011","038"
"2903","SPINEDA",9,646,0,655,"2011","101"
"2904","SPINETO SCRIVIA",2,0,96,98,"2011","166"
"2905","SPINO D'ADDA",748,1883,0,2631,"2011","102"
"2906","SPINONE AL LAGO",9,0,0,9,"2011","205"
"2907","SPIRANO",19,1118,0,1137,"2011","206"
"2908","SPRESIANO",110,231,1,342,"2011","082"
"2909","STAGNO LOMBARDO",33,5432,178,5643,"2011","103"
"2910","STANGHELLA",363,2,0,365,"2011","088"
"2911","STAZZANO",23,0,2,25,"2011","167"
"2912","STAZZONA",15,5,12,32,"2011","218"
"2913","STEZZANO",192,405,0,597,"2011","207"
"2914","STIENTA",138,7,0,145,"2011","045"
"2915","STRA",3,3,0,6,"2011","039"
"2916","STRADELLA",21,32,0,53,"2011","153"
"2917","STRAMBINO",12,26,102,140,"2011","269"
"2918","STRESA",4,0,31,35,"2011","064"
"2919","STREVI",7,0,13,20,"2011","168"
"2920","STRONA",1,0,0,1,"2011","065"
"2921","STROPPO",9,0,0,9,"2011","224"
"2922","STROZZA",6,0,0,6,"2011","208"
"2923","SUARDI",3,0,0,3,"2011","154"
"2924","SUEGLIO",2,0,0,2,"2011","077"
"2925","SUELLO",4,0,4,8,"2011","078"
"2926","SUISIO",3,50,0,53,"2011","209"
"2927","SULZANO",34,181,0,215,"2011","182"
"2928","SUMIRAGO",52,91,0,143,"2011","124"
"2929","SUNO",22,386,0,408,"2011","143"
"2930","SUSA",3,27,80,110,"2011","270"
"2931","SUSEGANA",901,88,0,989,"2011","083"
"2932","SUSTINENTE",511,306,323,1140,"2011","064"
"2933","SUZZARA",2486,1440,752,4678,"2011","065"
"2934","TACENO",18,6,0,24,"2011","079"
"2935","TAGLIO DI PO",7310,0,0,7310,"2011","046"
"2936","TAGLIOLO MONFERRATO",63,0,5,68,"2011","169"
"2937","TAIBON AGORDINO",2,23,0,25,"2011","059"
"2938","TAINO",27,126,0,153,"2011","125"
"2939","TALAMELLO",1,10,0,11,"2011","027"
"2940","TALAMONA",24,137,0,161,"2011","063"
"2941","TALEGGIO",43,28,0,71,"2011","210"
"2942","TAMBRE",16,124,0,140,"2011","060"
"2943","TARANTASCA",3386,411,114,3911,"2011","225"
"2944","TARTANO",2,23,0,25,"2011","064"
"2945","TARZO",63,18,0,81,"2011","084"
"2946","TASSAROLO",0,0,4,4,"2011","170"
"2947","TAVAGNASCO",0,0,122,122,"2011","271"
"2948","TAVAZZANO CON VILLAVESCO",207,823,0,1030,"2011","056"
"2949","TAVERNERIO",1,0,0,1,"2011","222"
"2950","TAVERNOLA BERGAMASCA",17,11,0,28,"2011","211"
"2951","TAVERNOLE SUL MELLA",26,59,0,85,"2011","183"
"2952","TAVIGLIANO",0,12,9,21,"2011","066"
"2953","TEGLIO",29,256,12,297,"2011","065"
"2954","TELGATE",2164,281,0,2445,"2011","212"
"2955","TEMU'",5,9,0,14,"2011","184"
"2956","TEOLO",52,48,22,122,"2011","089"
"2957","TERDOBBIATE",6,123,8,137,"2011","144"
"2958","TERENZO",78,491,0,569,"2011","038"
"2959","TERNO D'ISOLA",2,51,0,53,"2011","213"
"2960","TERRANOVA DEI PASSERINI",102,633,0,735,"2011","057"
"2961","TERRASSA PADOVANA",1290,0,0,1290,"2011","090"
"2962","TERRAZZO",2,20,0,22,"2011","085"
"2963","TERRUGGIA",6,0,34,40,"2011","171"
"2964","TERZO",51,0,27,78,"2011","172"
"2965","TEZZE SUL BRENTA",71,341,0,412,"2011","104"
"2966","THIENE",494,464,0,958,"2011","105"
"2967","TICENGO",9,398,0,407,"2011","104"
"2968","TIGLIOLE",1014,0,13,1027,"2011","108"
"2969","TIGNALE",6,0,1,7,"2011","185"
"2970","TIRANO",27,10,0,37,"2011","066"
"2971","TIZZANO VAL PARMA",2,938,0,940,"2011","039"
"2972","TOANO",11,1579,0,1590,"2011","041"
"2973","TOCENO",2,10,24,36,"2011","065"
"2974","TOLLEGNO",0,5,10,15,"2011","068"
"2975","TOMBOLO",893,103,0,996,"2011","091"
"2976","TONCO",555,0,0,555,"2011","109"
"2977","TONENGO",48,0,20,68,"2011","110"
"2978","TONEZZA DEL CIMONE",3,0,0,3,"2011","106"
"2979","TORBOLE CASAGLIA",20,942,0,962,"2011","186"
"2980","TORINO",160,0,39,199,"2011","272"
"2981","TORLINO VIMERCATI",9,371,0,380,"2011","105"
"2982","TORNATA",13,170,0,183,"2011","106"
"2983","TORNO",1,0,0,1,"2011","223"
"2984","TORNOLO",72,4,0,76,"2011","040"
"2985","TORRAZZA COSTE",16,0,0,16,"2011","155"
"2986","TORRAZZA PIEMONTE",27,0,168,195,"2011","273"
"2987","TORRAZZO",0,0,16,16,"2011","069"
"2988","TORRE BERETTI E CASTELLARO",13,330,0,343,"2011","156"
"2989","TORRE BOLDONE",13,0,0,13,"2011","214"
"2990","TORRE BORMIDA",0,0,8,8,"2011","226"
"2991","TORRE D'ARESE",6,0,0,6,"2011","157"
"2992","TORRE D'ISOLA",0,454,0,454,"2011","159"
"2993","TORRE DE' BUSI",4,0,1,5,"2011","080"
"2994","TORRE DE' NEGRI",19,21,86,126,"2011","158"
"2995","TORRE DE' PICENARDI",1,1012,0,1013,"2011","107"
"2996","TORRE DE' ROVERI",4,0,0,4,"2011","216"
"2997","TORRE DI MOSTO",14,496,0,510,"2011","041"
"2998","TORRE DI SANTA MARIA",16,4,0,20,"2011","067"
"2999","TORRE MONDOVI'",5,0,0,5,"2011","227"
"3000","TORRE PALLAVICINA",288,303,0,591,"2011","217"
"3001","TORRE PELLICE",0,10,80,90,"2011","275"
"3002","TORRE SAN GIORGIO",64,44,0,108,"2011","228"
"3003","TORREBELVICINO",836,21,0,857,"2011","107"
"3004","TORREGLIA",7,0,0,7,"2011","092"
"3005","TORRESINA",3,0,0,3,"2011","229"
"3006","TORREVECCHIA PIA",83,18,0,101,"2011","160"
"3007","TORRI DI QUARTESOLO",98,196,0,294,"2011","108"
"3008","TORRIANA",114,0,0,114,"2011","019"
"3009","TORRILE",1,2088,0,2089,"2011","041"
"3010","TORTONA",2129,225,232,2586,"2011","174"
"3011","TOSCOLANO-MADERNO",21,0,0,21,"2011","187"
"3012","TOVO DI SANT'AGATA",0,54,1,55,"2011","068"
"3013","TRADATE",15,0,21,36,"2011","127"
"3014","TRANA",0,253,70,323,"2011","276"
"3015","TRAONA",45,128,88,261,"2011","069"
"3016","TRAREGO VIGGIONA",1,0,2,3,"2011","066"
"3017","TRASQUERA",0,0,20,20,"2011","067"
"3018","TRAUSELLA",0,0,31,31,"2011","277"
"3019","TRAVACO' SICCOMARIO",2,0,0,2,"2011","162"
"3020","TRAVAGLIATO",1227,510,0,1737,"2011","188"
"3021","TRAVEDONA-MONATE",20,29,0,49,"2011","128"
"3022","TRAVERSELLA",2,0,128,130,"2011","278"
"3023","TRAVERSETOLO",60,1019,0,1079,"2011","042"
"3024","TRAVES",0,0,2,2,"2011","279"
"3025","TRAVO",73,46,0,119,"2011","043"
"3026","TREBASELEGHE",6945,169,0,7114,"2011","093"
"3027","TRECASALI",0,527,0,527,"2011","043"
"3028","TRECATE",2,184,5,191,"2011","149"
"3029","TRECENTA",1463,167,19,1649,"2011","047"
"3030","TREDOZIO",112,0,0,112,"2011","049"
"3031","TREGNAGO",633,130,0,763,"2011","087"
"3032","TREISO",0,0,1,1,"2011","230"
"3033","TREMENICO",0,0,1,1,"2011","081"
"3034","TREMEZZO",3,12,30,45,"2011","225"
"3035","TREMOSINE",33,491,1,525,"2011","189"
"3036","TRENZANO",760,1313,0,2073,"2011","190"
"3037","TRESCORE BALNEARIO",42,66,0,108,"2011","218"
"3038","TRESCORE CREMASCO",81,378,0,459,"2011","109"
"3039","TRESIGALLO",2,0,0,2,"2011","024"
"3040","TRESIVIO",8,10,0,18,"2011","070"
"3041","TREVENZUOLO",161,773,118,1052,"2011","088"
"3042","TREVIGLIO",932,1299,0,2231,"2011","219"
"3043","TREVIGNANO",2238,196,0,2434,"2011","085"
"3044","TREVILLE",1,0,0,1,"2011","175"
"3045","TREVIOLO",53,182,0,235,"2011","220"
"3046","TREVISO",565,197,6,768,"2011","086"
"3047","TREVISO BRESCIANO",5,51,0,56,"2011","191"
"3048","TREZZANO SUL NAVIGLIO",0,274,0,274,"2011","220"
"3049","TREZZO SULL'ADDA",5,319,0,324,"2011","221"
"3050","TREZZO TINELLA",19,0,22,41,"2011","231"
"3051","TREZZONE",5,0,0,5,"2011","226"
"3052","TRIBANO",5,0,0,5,"2011","094"
"3053","TRIBIANO",0,36,0,36,"2011","222"
"3054","TRICHIANA",88,382,1,471,"2011","061"
"3055","TRIGOLO",1,1425,0,1426,"2011","110"
"3056","TRINITA'",2657,213,348,3218,"2011","232"
"3057","TRINO",1,72,74,147,"2011","148"
"3058","TRISOBBIO",165,0,2,167,"2011","176"
"3059","TRISSINO",70,386,0,456,"2011","110"
"3060","TRIVERO",2,29,7,38,"2011","070"
"3061","TROFARELLO",812,60,0,872,"2011","280"
"3062","TROMELLO",68,56,0,124,"2011","164"
"3063","TRONTANO",3,16,6,25,"2011","068"
"3064","TRONZANO LAGO MAGGIORE",2,0,0,2,"2011","129"
"3065","TRONZANO VERCELLESE",140,92,0,232,"2011","150"
"3066","TROVO",11,11,0,22,"2011","165"
"3067","TRUCCAZZANO",103,1347,0,1450,"2011","224"
"3068","TURANO LODIGIANO",41,1756,0,1797,"2011","058"
"3069","TURATE",163,0,0,163,"2011","227"
"3070","TURBIGO",1,44,0,45,"2011","226"
"3071","UBIALE CLANEZZO",5,0,0,5,"2011","221"
"3072","UBOLDO",25,0,0,25,"2011","130"
"3073","UGGIATE-TREVANO",6,58,35,99,"2011","228"
"3074","URAGO D'OGLIO",359,783,0,1142,"2011","192"
"3075","URBANA",590,0,0,590,"2011","095"
"3076","URGNANO",296,804,0,1100,"2011","222"
"3077","USSEAUX",0,93,17,110,"2011","281"
"3078","USSEGLIO",0,39,19,58,"2011","282"
"3079","VAIANO CREMASCO",43,223,0,266,"2011","111"
"3080","VAIE",2,86,16,104,"2011","283"
"3081","VAILATE",7,468,0,475,"2011","112"
"3082","VAL DELLA TORRE",100,0,264,364,"2011","284"
"3083","VAL DI NIZZA",2,5,0,7,"2011","166"
"3084","VAL MASINO",2,0,0,2,"2011","074"
"3085","VAL REZZO",2,8,7,17,"2011","233"
"3086","VALBONDIONE",2,14,0,16,"2011","223"
"3087","VALBREMBO",22,15,0,37,"2011","224"
"3088","VALBRONA",8,0,3,11,"2011","229"
"3089","VALDAGNO",40,185,3,228,"2011","111"
"3090","VALDASTICO",797,15,0,812,"2011","112"
"3091","VALDENGO",56,45,7,108,"2011","071"
"3092","VALDIDENTRO",15,143,6,164,"2011","071"
"3093","VALDIERI",1,0,0,1,"2011","233"
"3094","VALDISOTTO",28,123,2,153,"2011","072"
"3095","VALDOBBIADENE",121,405,0,526,"2011","087"
"3096","VALDUGGIA",9,0,3,12,"2011","152"
"3097","VALEGGIO",91,0,0,91,"2011","167"
"3098","VALEGGIO SUL MINCIO",2071,2078,27,4176,"2011","089"
"3099","VALENZA",10,0,35,45,"2011","177"
"3100","VALERA FRATTA",150,184,0,334,"2011","059"
"3101","VALFENERA",763,218,91,1072,"2011","112"
"3102","VALFURVA",7,95,14,116,"2011","073"
"3103","VALGANNA",22,0,1,23,"2011","131"
"3104","VALGOGLIO",35,47,0,82,"2011","225"
"3105","VALGRANA",83,0,0,83,"2011","234"
"3106","VALGREGHENTINO",4,0,0,4,"2011","082"
"3107","VALLADA AGORDINA",3,2,0,5,"2011","062"
"3108","VALLE DI CADORE",13,0,0,13,"2011","063"
"3109","VALLE LOMELLINA",15,691,0,706,"2011","168"
"3110","VALLE MOSSO",0,0,2,2,"2011","073"
"3111","VALLE SALIMBENE",0,100,0,100,"2011","169"
"3112","VALLE SAN NICOLAO",0,0,5,5,"2011","074"
"3113","VALLEVE",0,15,0,15,"2011","226"
"3114","VALLI DEL PASUBIO",5,10,0,15,"2011","113"
"3115","VALLIO TERME",8,0,0,8,"2011","193"
"3116","VALLO TORINESE",0,0,12,12,"2011","286"
"3117","VALMADRERA",24,0,1,25,"2011","083"
"3118","VALMOREA",3,36,0,39,"2011","232"
"3119","VALMOZZOLA",25,9,0,34,"2011","044"
"3120","VALPERGA",1,122,248,371,"2011","287"
"3121","VALPRATO SOANA",0,0,35,35,"2011","288"
"3122","VALSECCA",56,0,0,56,"2011","228"
"3123","VALSOLDA",7,4,6,17,"2011","234"
"3124","VALSTAGNA",5,0,0,5,"2011","114"
"3125","VALSTRONA",17,0,14,31,"2011","069"
"3126","VALTORTA",18,24,0,42,"2011","229"
"3127","VALVERDE",16,0,0,16,"2011","170"
"3128","VALVESTINO",10,6,0,16,"2011","194"
"3129","VANZAGHELLO",0,2,0,2,"2011","249"
"3130","VANZAGO",19,0,21,40,"2011","229"
"3131","VAPRIO D'ADDA",23,327,0,350,"2011","230"
"3132","VARALLO",69,43,0,112,"2011","156"
"3133","VARALLO POMBIA",9,0,0,9,"2011","154"
"3134","VARANO BORGHI",4,0,0,4,"2011","132"
"3135","VARANO DE' MELEGARI",9,318,0,327,"2011","045"
"3136","VARESE",104,78,0,182,"2011","133"
"3137","VARISELLA",0,30,8,38,"2011","289"
"3138","VARSI",34,307,0,341,"2011","046"
"3139","VARZI",108,7,0,115,"2011","171"
"3140","VARZO",0,26,18,44,"2011","071"
"3141","VAS",0,13,0,13,"2011","064"
"3142","VAUDA CANAVESE",0,0,44,44,"2011","290"
"3143","VAZZOLA",1004,351,13,1368,"2011","088"
"3144","VEDANO OLONA",89,96,0,185,"2011","134"
"3145","VEDDASCA",0,0,11,11,"2011","135"
"3146","VEDELAGO",17887,339,109,18335,"2011","089"
"3147","VEDESETA",10,127,0,137,"2011","230"
"3148","VEGGIANO",85,143,47,275,"2011","096"
"3149","VEGLIO",4,0,19,23,"2011","075"
"3150","VELESO",5,0,15,20,"2011","236"
"3151","VELEZZO LOMELLINA",8,0,0,8,"2011","172"
"3152","VELLEZZO BELLINI",76,300,0,376,"2011","173"
"3153","VELO D'ASTICO",816,26,0,842,"2011","115"
"3154","VELO VERONESE",398,1670,9,2077,"2011","090"
"3155","VENARIA REALE",7,269,52,328,"2011","292"
"3156","VENASCA",282,8,0,290,"2011","237"
"3157","VENAUS",5,26,25,56,"2011","291"
"3158","VENDROGNO",36,0,2,38,"2011","085"
"3159","VENEGONO INFERIORE",2,98,3,103,"2011","136"
"3160","VENEGONO SUPERIORE",0,17,11,28,"2011","137"
"3161","VENEZIA",1590,57,155,1802,"2011","042"
"3162","VENIANO",44,102,0,146,"2011","238"
"3163","VERBANIA",55,0,7,62,"2011","072"
"3164","VERCANA",9,12,0,21,"2011","239"
"3165","VERCEIA",12,6,0,18,"2011","075"
"3166","VERCELLI",27,212,0,239,"2011","158"
"3167","VERCURAGO",1,0,0,1,"2011","086"
"3168","VERDELLINO",0,54,0,54,"2011","232"
"3169","VERDELLO",255,114,0,369,"2011","233"
"3170","VERDERIO INFERIORE",4,0,0,4,"2011","087"
"3171","VERDERIO SUPERIORE",0,33,0,33,"2011","088"
"3172","VERDUNO",0,0,85,85,"2011","238"
"3173","VERGATO",66,0,19,85,"2011","059"
"3174","VERGHERETO",446,0,47,493,"2011","050"
"3175","VERGIATE",43,0,0,43,"2011","138"
"3176","VERMEZZO",0,435,0,435,"2011","235"
"3177","VERNANTE",285,0,49,334,"2011","239"
"3178","VERNASCA",90,83,0,173,"2011","044"
"3179","VERNATE",10,78,0,88,"2011","236"
"3180","VEROLANUOVA",1876,1916,0,3792,"2011","195"
"3181","VEROLAVECCHIA",115,4023,1,4139,"2011","196"
"3182","VEROLENGO",31,139,228,398,"2011","293"
"3183","VERONA",3317,1082,0,4399,"2011","091"
"3184","VERONELLA",5377,250,0,5627,"2011","092"
"3185","VERRETTO",3,0,0,3,"2011","174"
"3186","VERRONE",56,0,4,60,"2011","076"
"3187","VERRUA PO",1,0,0,1,"2011","175"
"3188","VERRUA SAVOIA",590,0,74,664,"2011","294"
"3189","VERTEMATE CON MINOPRIO",6,0,0,6,"2011","242"
"3190","VERTOVA",17,42,0,59,"2011","234"
"3191","VERUCCHIO",113,19,0,132,"2011","020"
"3192","VERUNO",1,0,0,1,"2011","157"
"3193","VERVIO",9,1,0,10,"2011","076"
"3194","VERZUOLO",202,22,0,224,"2011","240"
"3195","VESCOVANA",4,0,0,4,"2011","097"
"3196","VESCOVATO",2748,876,372,3996,"2011","113"
"3197","VESIME",479,21,6,506,"2011","113"
"3198","VESPOLATE",28,109,10,147,"2011","158"
"3199","VESTENANOVA",535,144,0,679,"2011","093"
"3200","VESTIGNE'",1,0,47,48,"2011","295"
"3201","VESTONE",9,0,0,9,"2011","197"
"3202","VESTRENO",0,1,0,1,"2011","089"
"3203","VETTO",7,396,2,405,"2011","042"
"3204","VEZZA D'ALBA",2,0,0,2,"2011","241"
"3205","VEZZA D'OGLIO",1,162,19,182,"2011","198"
"3206","VEZZANO SUL CROSTOLO",37,181,0,218,"2011","043"
"3207","VIADANA",497,1020,293,1810,"2011","066"
"3208","VIADANICA",4,36,0,40,"2011","235"
"3209","VIALE",288,0,0,288,"2011","114"
"3210","VIALFRE'",0,0,8,8,"2011","296"
"3211","VIANO",1,722,14,737,"2011","044"
"3212","VIARIGI",34,0,11,45,"2011","115"
"3213","VICENZA",407,1077,6,1490,"2011","116"
"3214","VICO CANAVESE",7,30,207,244,"2011","297"
"3215","VICOFORTE",527,0,0,527,"2011","242"
"3216","VICOLUNGO",1,0,0,1,"2011","159"
"3217","VIDIGULFO",9,423,0,432,"2011","176"
"3218","VIDOR",35,274,0,309,"2011","090"
"3219","VIDRACCO",0,0,1,1,"2011","298"
"3220","VIGANO SAN MARTINO",11,0,0,11,"2011","236"
"3221","VIGARANO MAINARDA",1,0,0,1,"2011","022"
"3222","VIGASIO",959,472,0,1431,"2011","094"
"3223","VIGEVANO",56,48,0,104,"2011","177"
"3224","VIGGIU'",43,53,0,96,"2011","139"
"3225","VIGHIZZOLO D'ESTE",146,22,0,168,"2011","098"
"3226","VIGLIANO BIELLESE",0,37,0,37,"2011","077"
"3227","VIGLIANO D'ASTI",81,0,0,81,"2011","116"
"3228","VIGNALE MONFERRATO",164,0,44,208,"2011","179"
"3229","VIGNATE",14,447,0,461,"2011","237"
"3230","VIGNOLA",2,110,0,112,"2011","046"
"3231","VIGNOLE BORBERA",25,0,0,25,"2011","180"
"3232","VIGNOLO",680,0,0,680,"2011","243"
"3233","VIGNONE",7,0,1,8,"2011","074"
"3234","VIGO DI CADORE",19,0,0,19,"2011","065"
"3235","VIGODARZERE",328,120,0,448,"2011","099"
"3236","VIGOLO",29,126,0,155,"2011","237"
"3237","VIGOLZONE",120,416,0,536,"2011","045"
"3238","VIGONE",1987,1237,747,3971,"2011","299"
"3239","VIGONOVO",27,15,0,42,"2011","043"
"3240","VIGONZA",407,383,0,790,"2011","100"
"3241","VILLA BARTOLOMEA",34,2,0,36,"2011","095"
"3242","VILLA CARCINA",5,0,0,5,"2011","199"
"3243","VILLA CORTESE",175,0,0,175,"2011","248"
"3244","VILLA D'ADDA",8,0,0,8,"2011","238"
"3245","VILLA D'ALME'",59,27,1,87,"2011","239"
"3246","VILLA D'OGNA",4,49,0,53,"2011","241"
"3247","VILLA DEL BOSCO",2,0,0,2,"2011","078"
"3248","VILLA DEL CONTE",807,703,4,1514,"2011","101"
"3249","VILLA DI CHIAVENNA",0,3,0,3,"2011","077"
"3250","VILLA DI SERIO",4,0,0,4,"2011","240"
"3251","VILLA DI TIRANO",12,133,45,190,"2011","078"
"3252","VILLA ESTENSE",218,0,0,218,"2011","102"
"3253","VILLA GUARDIA",155,0,0,155,"2011","245"
"3254","VILLA MINOZZO",53,576,0,629,"2011","045"
"3255","VILLA POMA",0,589,26,615,"2011","067"
"3256","VILLA SAN SECONDO",13,0,0,13,"2011","119"
"3257","VILLACHIARA",425,1879,622,2926,"2011","200"
"3258","VILLADEATI",23,0,0,23,"2011","182"
"3259","VILLADOSE",764,0,79,843,"2011","048"
"3260","VILLADOSSOLA",4,0,8,12,"2011","075"
"3261","VILLAFALLETTO",2039,600,392,3031,"2011","244"
"3262","VILLAFRANCA D'ASTI",226,0,52,278,"2011","117"
"3263","VILLAFRANCA DI VERONA",7517,2751,260,10528,"2011","096"
"3264","VILLAFRANCA PADOVANA",697,1608,7,2312,"2011","103"
"3265","VILLAFRANCA PIEMONTE",491,2229,1699,4419,"2011","300"
"3266","VILLAGA",31,213,98,342,"2011","117"
"3267","VILLAMARZANA",50,92,0,142,"2011","049"
"3268","VILLAMIROGLIO",86,0,0,86,"2011","184"
"3269","VILLANOVA BIELLESE",220,0,4,224,"2011","079"
"3270","VILLANOVA CANAVESE",1,17,45,63,"2011","301"
"3271","VILLANOVA D'ARDENGHI",4,0,18,22,"2011","179"
"3272","VILLANOVA D'ASTI",3884,110,98,4092,"2011","118"
"3273","VILLANOVA DEL GHEBBO",75,0,1,76,"2011","050"
"3274","VILLANOVA DEL SILLARO",2,1312,0,1314,"2011","060"
"3275","VILLANOVA DI CAMPOSAMPIERO",31,53,6,90,"2011","104"
"3276","VILLANOVA MARCHESANA",7,73,0,80,"2011","051"
"3277","VILLANOVA MONDOVI'",2134,356,57,2547,"2011","245"
"3278","VILLANOVA MONFERRATO",1,69,0,70,"2011","185"
"3279","VILLANOVA SOLARO",192,535,0,727,"2011","246"
"3280","VILLANOVA SULL'ARDA",164,1148,0,1312,"2011","046"
"3281","VILLANTERIO",3,0,0,3,"2011","180"
"3282","VILLANUOVA SUL CLISI",2,0,0,2,"2011","201"
"3283","VILLAR DORA",2,28,34,64,"2011","303"
"3284","VILLAR FOCCHIARDO",2,54,58,114,"2011","305"
"3285","VILLAR PELLICE",2,53,117,172,"2011","306"
"3286","VILLAR PEROSA",2,9,6,17,"2011","307"
"3287","VILLAR SAN COSTANZO",291,24,338,653,"2011","247"
"3288","VILLARBASSE",8,32,212,252,"2011","302"
"3289","VILLARBOIT",3,0,0,3,"2011","163"
"3290","VILLAREGGIA",0,29,133,162,"2011","304"
"3291","VILLAROMAGNANO",61,0,0,61,"2011","186"
"3292","VILLASTELLONE",989,586,131,1706,"2011","308"
"3293","VILLATA",14,33,0,47,"2011","164"
"3294","VILLAVERLA",90,1147,7,1244,"2011","118"
"3295","VILLETTE",38,0,6,44,"2011","076"
"3296","VILLIMPENTA",574,149,33,756,"2011","068"
"3297","VILLONGO",12,0,0,12,"2011","242"
"3298","VILLORBA",103,32,0,135,"2011","091"
"3299","VILMINORE DI SCALVE",16,173,0,189,"2011","243"
"3300","VINADIO",122,19,0,141,"2011","248"
"3301","VINCHIO",31,0,0,31,"2011","120"
"3302","VINOVO",284,126,13,423,"2011","309"
"3303","VINZAGLIO",19,42,0,61,"2011","164"
"3304","VIOLA",75,0,10,85,"2011","249"
"3305","VIONE",2,42,0,44,"2011","202"
"3306","VIRGILIO",92,1579,569,2240,"2011","069"
"3307","VIRLE PIEMONTE",61,465,254,780,"2011","310"
"3308","VISANO",2733,581,0,3314,"2011","203"
"3309","VISCHE",4,0,8,12,"2011","311"
"3310","VISONE",5,0,32,37,"2011","187"
"3311","VISTARINO",55,116,0,171,"2011","181"
"3312","VISTRORIO",0,0,15,15,"2011","312"
"3313","VITTORIO VENETO",224,187,13,424,"2011","092"
"3314","VITTUONE",10,159,0,169,"2011","243"
"3315","VIU'",4,26,111,141,"2011","313"
"3316","VIVERONE",26,0,20,46,"2011","080"
"3317","VIZZOLO PREDABISSI",22,29,0,51,"2011","244"
"3318","VO'",111,16,48,175,"2011","105"
"3319","VOBARNO",55,85,2,142,"2011","204"
"3320","VOCCA",0,6,0,6,"2011","166"
"3321","VODO CADORE",26,0,0,26,"2011","066"
"3322","VOGHERA",53,0,0,53,"2011","182"
"3323","VOGHIERA",2,0,0,2,"2011","023"
"3324","VOGOGNA",3,0,10,13,"2011","077"
"3325","VOLONGO",46,0,0,46,"2011","114"
"3326","VOLPAGO DEL MONTELLO",1295,546,29,1870,"2011","093"
"3327","VOLPEDO",2,0,0,2,"2011","188"
"3328","VOLPEGLINO",0,0,2,2,"2011","189"
"3329","VOLPIANO",6,132,354,492,"2011","314"
"3330","VOLTA MANTOVANA",2526,1593,486,4605,"2011","070"
"3331","VOLTAGGIO",3,67,6,76,"2011","190"
"3332","VOLTIDO",0,284,0,284,"2011","115"
"3333","VOLVERA",912,444,356,1712,"2011","315"
"3334","VOTTIGNASCO",2248,53,26,2327,"2011","250"
"3335","ZANDOBBIO",7,26,0,33,"2011","244"
"3336","ZANE'",703,137,46,886,"2011","119"
"3337","ZANICA",829,1160,0,1989,"2011","245"
"3338","ZAVATTARELLO",129,0,0,129,"2011","184"
"3339","ZECCONE",9,216,0,225,"2011","185"
"3340","ZELBIO",0,0,11,11,"2011","246"
"3341","ZELO BUON PERSICO",0,872,0,872,"2011","061"
"3342","ZELO SURRIGONE",0,189,0,189,"2011","246"
"3343","ZEME",46,28,0,74,"2011","186"
"3344","ZENEVREDO",4,0,0,4,"2011","187"
"3345","ZENSON DI PIAVE",12,0,0,12,"2011","094"
"3346","ZERBOLO'",2,206,0,208,"2011","189"
"3347","ZERMEGHEDO",0,48,0,48,"2011","120"
"3348","ZERO BRANCO",216,140,28,384,"2011","095"
"3349","ZEVIO",3854,804,0,4658,"2011","097"
"3350","ZIANO PIACENTINO",87,0,0,87,"2011","048"
"3351","ZIBELLO",6,917,0,923,"2011","048"
"3352","ZIBIDO SAN GIACOMO",37,597,0,634,"2011","247"
"3353","ZIMELLA",7162,405,50,7617,"2011","098"
"3354","ZINASCO",2,0,0,2,"2011","190"
"3355","ZOCCA",126,700,0,826,"2011","047"
"3356","ZOGNO",119,68,0,187,"2011","246"
"3357","ZOLA PREDOSA",28,5,0,33,"2011","060"
"3358","ZOLDO ALTO",15,0,0,15,"2011","068"
"3359","ZONE",5,25,0,30,"2011","205"
"3360","ZOVENCEDO",8,0,0,8,"2011","121"
"3361","ZUBIENA",12,7,30,49,"2011","082"
"3362","ZUGLIANO",333,180,18,531,"2011","122"
"3363","ZUMAGLIA",0,0,33,33,"2011","083"
"3364","ABANO TERME",21,73,33,127,"2012","001"
"3365","ABBADIA CERRETO",0,1073,0,1073,"2012","001"
"3366","ABBADIA LARIANA",11,21,1,33,"2012","001"
"3367","ABBIATEGRASSO",94,1450,0,1544,"2012","002"
"3368","ACCEGLIO",27,22,0,49,"2012","001"
"3369","ACQUAFREDDA",1610,123,0,1733,"2012","001"
"3370","ACQUANEGRA CREMONESE",88,63,508,659,"2012","001"
"3371","ACQUANEGRA SUL CHIESE",1769,666,78,2513,"2012","001"
"3372","ACQUI TERME",270,0,0,270,"2012","001"
"3373","ADRARA SAN MARTINO",34,44,0,78,"2012","001"
"3374","ADRARA SAN ROCCO",10,3,0,13,"2012","002"
"3375","ADRIA",2678,280,0,2958,"2012","001"
"3376","ADRO",541,18,0,559,"2012","002"
"3377","AFFI",1,20,0,21,"2012","001"
"3378","AGAZZANO",174,435,0,609,"2012","001"
"3379","AGLIANO TERME",75,0,0,75,"2012","001"
"3380","AGLIE'",179,22,0,201,"2012","001"
"3381","AGNA",389,0,0,389,"2012","002"
"3382","AGNADELLO",68,1619,0,1687,"2012","002"
"3383","AGNOSINE",15,33,0,48,"2012","003"
"3384","AGORDO",3,22,0,25,"2012","001"
"3385","AGRATE CONTURBIA",28,0,0,28,"2012","001"
"3386","AGUGLIARO",362,68,47,477,"2012","001"
"3387","AILOCHE",7,0,0,7,"2012","001"
"3388","AIRASCA",912,287,90,1289,"2012","002"
"3389","AIRUNO",8,0,1,9,"2012","002"
"3390","AISONE",21,15,0,36,"2012","002"
"3391","ALA DI STURA",40,31,0,71,"2012","003"
"3392","ALAGNA VALSESIA",12,12,7,31,"2012","002"
"3393","ALANO DI PIAVE",370,62,0,432,"2012","002"
"3394","ALBA",877,0,6,883,"2012","003"
"3395","ALBAIRATE",43,613,0,656,"2012","005"
"3396","ALBANO SANT'ALESSANDRO",21,0,0,21,"2012","003"
"3397","ALBAREDO D'ADIGE",10826,199,0,11025,"2012","002"
"3398","ALBAREDO PER SAN MARCO",5,30,0,35,"2012","001"
"3399","ALBARETO",91,129,0,220,"2012","001"
"3400","ALBARETTO DELLA TORRE",29,0,0,29,"2012","004"
"3401","ALBAVILLA",2,0,0,2,"2012","003"
"3402","ALBERA LIGURE",11,0,0,11,"2012","002"
"3403","ALBESE CON CASSANO",1,0,3,4,"2012","004"
"3404","ALBETTONE",1912,562,15,2489,"2012","002"
"3405","ALBIANO D'IVREA",141,49,0,190,"2012","004"
"3406","ALBIGNASEGO",196,60,120,376,"2012","003"
"3407","ALBINEA",5,1488,1,1494,"2012","001"
"3408","ALBINO",75,42,0,117,"2012","004"
"3409","ALBIOLO",30,0,0,30,"2012","005"
"3410","ALBIZZATE",6,0,0,6,"2012","002"
"3411","ALBOSAGGIA",7,119,0,126,"2012","002"
"3412","ALBUGNANO",76,0,0,76,"2012","002"
"3413","ALBUZZANO",27,0,0,27,"2012","004"
"3414","ALESSANDRIA",9326,1703,0,11029,"2012","003"
"3415","ALFIANELLO",9,485,7,501,"2012","004"
"3416","ALFIANO NATTA",31,0,0,31,"2012","004"
"3417","ALFONSINE",61,0,0,61,"2012","001"
"3418","ALGUA",1,4,0,5,"2012","248"
"3419","ALICE BEL COLLE",6,0,0,6,"2012","005"
"3420","ALICE CASTELLO",531,32,0,563,"2012","004"
"3421","ALICE SUPERIORE",33,0,0,33,"2012","005"
"3422","ALLEGHE",5,0,0,5,"2012","003"
"3423","ALLUVIONI CAMBIO'",30,0,0,30,"2012","006"
"3424","ALME'",5,0,4,9,"2012","005"
"3425","ALMENNO SAN BARTOLOMEO",31,0,0,31,"2012","006"
"3426","ALMENNO SAN SALVATORE",7,0,0,7,"2012","007"
"3427","ALMESE",41,17,0,58,"2012","006"
"3428","ALONTE",495,14,0,509,"2012","003"
"3429","ALPETTE",0,22,0,22,"2012","007"
"3430","ALPIGNANO",278,172,96,546,"2012","008"
"3431","ALSENO",652,990,0,1642,"2012","002"
"3432","ALSERIO",7,0,0,7,"2012","006"
"3433","ALTAVILLA MONFERRATO",77,0,0,77,"2012","007"
"3434","ALTAVILLA VICENTINA",140,0,0,140,"2012","004"
"3435","ALTISSIMO",36,52,0,88,"2012","005"
"3436","ALTIVOLE",11187,91,25,11303,"2012","001"
"3437","ALZANO LOMBARDO",23,51,0,74,"2012","008"
"3438","ALZANO SCRIVIA",3,0,0,3,"2012","008"
"3439","ALZATE BRIANZA",7,155,0,162,"2012","007"
"3440","AMBIVERE",4,0,0,4,"2012","009"
"3441","AMENO",10,7,15,32,"2012","002"
"3442","ANDEZENO",499,0,0,499,"2012","009"
"3443","ANDORNO MICCA",29,0,28,57,"2012","002"
"3444","ANDRATE",39,0,0,39,"2012","010"
"3445","ANFO",0,20,0,20,"2012","005"
"3446","ANGERA",80,216,0,296,"2012","003"
"3447","ANGOLO TERME",8,90,0,98,"2012","006"
"3448","ANGROGNA",78,0,8,86,"2012","011"
"3449","ANGUILLARA VENETA",16,0,0,16,"2012","004"
"3450","ANNICCO",38,734,164,936,"2012","003"
"3451","ANNONE DI BRIANZA",26,14,0,40,"2012","003"
"3452","ANNONE VENETO",40,72,0,112,"2012","001"
"3453","ANTEGNATE",1425,1094,0,2519,"2012","010"
"3454","ANTIGNANO",72,0,0,72,"2012","003"
"3455","ANTRONA SCHIERANCO",11,0,0,11,"2012","001"
"3456","ANZANO DEL PARCO",0,155,0,155,"2012","009"
"3457","ANZOLA D'OSSOLA",1,105,0,106,"2012","002"
"3458","ANZOLA DELL'EMILIA",121,506,0,627,"2012","001"
"3459","APPIANO GENTILE",49,317,19,385,"2012","010"
"3460","APRICA",7,9,0,16,"2012","004"
"3461","ARAMENGO",199,0,0,199,"2012","004"
"3462","ARCADE",1217,99,0,1316,"2012","002"
"3463","ARCENE",4,331,0,335,"2012","011"
"3464","ARCISATE",60,695,0,755,"2012","004"
"3465","ARCOLE",1526,156,0,1682,"2012","004"
"3466","ARCONATE",29,118,0,147,"2012","007"
"3467","ARCUGNANO",136,5,0,141,"2012","006"
"3468","ARDENNO",91,48,5,144,"2012","005"
"3469","ARDESIO",54,38,0,92,"2012","012"
"3470","ARENA PO",143,367,0,510,"2012","005"
"3471","ARESE",0,158,0,158,"2012","009"
"3472","ARGEGNO",2,0,0,2,"2012","011"
"3473","ARGELATO",68,46,0,114,"2012","002"
"3474","ARGENTA",1812,2,3,1817,"2012","001"
"3475","ARGUELLO",80,0,0,80,"2012","007"
"3476","ARIANO NEL POLESINE",1385,172,0,1557,"2012","002"
"3477","ARIGNANO",531,0,0,531,"2012","012"
"3478","ARLUNO",48,231,0,279,"2012","010"
"3479","ARMENO",42,80,4,126,"2012","006"
"3480","AROLA",4,0,8,12,"2012","004"
"3481","ARONA",5,0,0,5,"2012","008"
"3482","AROSIO",3,4,0,7,"2012","012"
"3483","ARQUA' PETRARCA",99,0,0,99,"2012","005"
"3484","ARQUA' POLESINE",918,8,0,926,"2012","003"
"3485","ARQUATA SCRIVIA",9,0,0,9,"2012","009"
"3486","ARRE",7,23,0,30,"2012","006"
"3487","ARSAGO SEPRIO",7,0,0,7,"2012","005"
"3488","ARSIE'",21,85,441,547,"2012","004"
"3489","ARSIERO",13,13,0,26,"2012","007"
"3490","ARTOGNE",1,460,40,501,"2012","007"
"3491","ARZAGO D'ADDA",296,759,0,1055,"2012","013"
"3492","ARZERGRANDE",290,110,7,407,"2012","007"
"3493","ARZIGNANO",216,243,0,459,"2012","008"
"3494","ASIAGO",92,1190,0,1282,"2012","009"
"3495","ASIGLIANO VENETO",252,0,0,252,"2012","010"
"3496","ASIGLIANO VERCELLESE",17,0,0,17,"2012","007"
"3497","ASOLA",8539,1791,1164,11494,"2012","002"
"3498","ASOLO",8745,548,0,9293,"2012","003"
"3499","ASSAGO",0,0,4,4,"2012","011"
"3500","ASSO",19,0,0,19,"2012","013"
"3501","ASTI",2825,0,0,2825,"2012","005"
"3502","AURANO",4,0,0,4,"2012","005"
"3503","AURONZO DI CADORE",23,6,0,29,"2012","005"
"3504","AVERARA",1,0,0,1,"2012","014"
"3505","AVIATICO",1,19,0,20,"2012","015"
"3506","AVIGLIANA",190,55,0,245,"2012","013"
"3507","AVOLASCA",85,0,0,85,"2012","010"
"3508","AZEGLIO",61,113,0,174,"2012","014"
"3509","AZZANELLO",0,329,0,329,"2012","004"
"3510","AZZANO MELLA",278,722,0,1000,"2012","008"
"3511","AZZANO SAN PAOLO",22,126,0,148,"2012","016"
"3512","AZZATE",9,42,0,51,"2012","006"
"3513","AZZIO",13,59,0,72,"2012","007"
"3514","AZZONE",1,0,0,1,"2012","017"
"3515","BACENO",6,26,8,40,"2012","006"
"3516","BADIA CALAVENA",813,287,39,1139,"2012","005"
"3517","BADIA PAVESE",36,0,0,36,"2012","006"
"3518","BADIA POLESINE",179,0,18,197,"2012","004"
"3519","BAGNACAVALLO",41,0,0,41,"2012","002"
"3520","BAGNARA DI ROMAGNA",12,0,0,12,"2012","003"
"3521","BAGNARIA",22,0,0,22,"2012","007"
"3522","BAGNASCO",162,0,0,162,"2012","008"
"3523","BAGNATICA",1,177,0,178,"2012","018"
"3524","BAGNO DI ROMAGNA",744,14,0,758,"2012","001"
"3525","BAGNOLI DI SOPRA",848,13,0,861,"2012","008"
"3526","BAGNOLO CREMASCO",3,1585,0,1588,"2012","005"
"3527","BAGNOLO DI PO",2,0,0,2,"2012",NA
"3528","BAGNOLO IN PIANO",14,619,0,633,"2012","002"
"3529","BAGNOLO MELLA",329,2739,124,3192,"2012","009"
"3530","BAGNOLO PIEMONTE",880,85,0,965,"2012","009"
"3531","BAGNOLO SAN VITO",84,2603,1112,3799,"2012","003"
"3532","BAGOLINO",4,355,4,363,"2012","010"
"3533","BAIRO",79,82,0,161,"2012","015"
"3534","BAISO",2,821,24,847,"2012","003"
"3535","BALANGERO",168,103,39,310,"2012","016"
"3536","BALDICHIERI D'ASTI",86,0,0,86,"2012","007"
"3537","BALDISSERO CANAVESE",0,65,0,65,"2012","017"
"3538","BALDISSERO D'ALBA",683,0,0,683,"2012","010"
"3539","BALDISSERO TORINESE",218,0,0,218,"2012","018"
"3540","BALLABIO",16,74,0,90,"2012","004"
"3541","BALME",13,0,0,13,"2012","019"
"3542","BALOCCO",18,31,0,49,"2012","009"
"3543","BANCHETTE",6,0,0,6,"2012","020"
"3544","BANNIO ANZINO",42,0,0,42,"2012","007"
"3545","BAONE",22,0,0,22,"2012","009"
"3546","BARBANIA",42,166,39,247,"2012","021"
"3547","BARBARANO VICENTINO",327,187,0,514,"2012","011"
"3548","BARBARESCO",41,0,0,41,"2012","011"
"3549","BARBARIGA",833,1217,0,2050,"2012","011"
"3550","BARBATA",40,991,0,1031,"2012","019"
"3551","BARBIANELLO",172,4,0,176,"2012","008"
"3552","BARBONA",1699,2,0,1701,"2012","010"
"3553","BARDELLO",26,0,0,26,"2012","009"
"3554","BARDI",24,616,0,640,"2012","002"
"3555","BARDOLINO",25,100,0,125,"2012","006"
"3556","BARDONECCHIA",11,36,0,47,"2012","022"
"3557","BAREGGIO",107,283,0,390,"2012","012"
"3558","BARENGO",9,108,0,117,"2012","012"
"3559","BARGE",2866,1662,232,4760,"2012","012"
"3560","BARGHE",6,17,0,23,"2012","012"
"3561","BARIANO",1,374,0,375,"2012","020"
"3562","BARNI",14,9,0,23,"2012","015"
"3563","BAROLO",42,0,0,42,"2012","013"
"3564","BARONE CANAVESE",6,37,0,43,"2012","023"
"3565","BARZAGO",285,21,0,306,"2012","005"
"3566","BARZANA",1,0,0,1,"2012",NA
"3567","BARZANO'",14,0,0,14,"2012","006"
"3568","BARZIO",5,53,9,67,"2012","007"
"3569","BASALUZZO",128,0,0,128,"2012","012"
"3570","BASCAPE'",64,782,0,846,"2012","009"
"3571","BASIGLIO",0,53,0,53,"2012","015"
"3572","BASSANO BRESCIANO",2,92,0,94,"2012","013"
"3573","BASSANO DEL GRAPPA",295,172,14,481,"2012","012"
"3574","BASSIGNANA",4,0,0,4,"2012","013"
"3575","BASTIA MONDOVI'",762,0,0,762,"2012","014"
"3576","BASTIDA DE' DOSSI",2,0,0,2,"2012","010"
"3577","BASTIDA PANCARANA",2,0,0,2,"2012","011"
"3578","BASTIGLIA",136,0,0,136,"2012","001"
"3579","BATTAGLIA TERME",5,0,0,5,"2012","011"
"3580","BAZZANO",0,159,0,159,"2012","004"
"3581","BEDERO VALCUVIA",17,0,0,17,"2012","010"
"3582","BEDIZZOLE",3584,1410,0,4994,"2012","014"
"3583","BEDONIA",233,141,0,374,"2012","003"
"3584","BEDULITA",12,5,0,17,"2012","022"
"3585","BEE",1,0,0,1,"2012","009"
"3586","BEINASCO",17,0,0,17,"2012","024"
"3587","BEINETTE",756,260,14,1030,"2012","016"
"3588","BELFIORE",2240,0,30,2270,"2012","007"
"3589","BELGIOIOSO",2,141,0,143,"2012","013"
"3590","BELLAGIO",8,48,21,77,"2012","019"
"3591","BELLANO",4,0,0,4,"2012","008"
"3592","BELLARIA-IGEA MARINA",15,0,0,15,"2012","001"
"3593","BELLINO",100,0,0,100,"2012","017"
"3594","BELLINZAGO LOMBARDO",49,1517,0,1566,"2012","016"
"3595","BELLINZAGO NOVARESE",84,392,0,476,"2012","016"
"3596","BELLUNO",1143,362,38,1543,"2012","006"
"3597","BELVEDERE LANGHE",185,0,62,247,"2012","018"
"3598","BEMA",0,1,0,1,"2012","006"
"3599","BENE LARIO",3,57,0,60,"2012","021"
"3600","BENE VAGIENNA",1721,274,83,2078,"2012","019"
"3601","BENEVELLO",277,0,0,277,"2012","020"
"3602","BENNA",1,34,6,41,"2012","003"
"3603","BENTIVOGLIO",31,270,0,301,"2012","005"
"3604","BERBENNO",15,26,0,41,"2012","023"
"3605","BERBENNO DI VALTELLINA",39,145,3,187,"2012","007"
"3606","BERCETO",44,108,0,152,"2012","004"
"3607","BEREGAZZO CON FIGLIARO",27,0,0,27,"2012","022"
"3608","BEREGUARDO",4,645,0,649,"2012","014"
"3609","BERGAMASCO",87,0,0,87,"2012","015"
"3610","BERGAMO",131,250,0,381,"2012","024"
"3611","BERGOLO",4,0,0,4,"2012","021"
"3612","BERLINGO",3089,308,5,3402,"2012","015"
"3613","BERNATE TICINO",193,142,0,335,"2012","019"
"3614","BERNEZZO",280,50,0,330,"2012","022"
"3615","BERRA",907,79,0,986,"2012","002"
"3616","BERTINORO",187,24,0,211,"2012","003"
"3617","BERTONICO",78,2294,0,2372,"2012","002"
"3618","BERZANO DI SAN PIETRO",14,0,0,14,"2012","009"
"3619","BERZO DEMO",12,42,9,63,"2012","016"
"3620","BERZO INFERIORE",7,141,0,148,"2012","017"
"3621","BERZO SAN FERMO",552,105,21,678,"2012","025"
"3622","BESANO",30,10,0,40,"2012","011"
"3623","BESATE",173,0,0,173,"2012","022"
"3624","BESENZONE",662,1366,0,2028,"2012","003"
"3625","BESNATE",9,229,0,238,"2012","012"
"3626","BESOZZO",23,68,0,91,"2012","013"
"3627","BETTOLA",223,151,0,374,"2012","004"
"3628","BEURA-CARDEZZA",9,8,0,17,"2012","011"
"3629","BEVILACQUA",161,66,0,227,"2012","008"
"3630","BIANDRONNO",13,0,0,13,"2012","014"
"3631","BIANZANO",5,21,0,26,"2012","026"
"3632","BIANZE'",125,173,0,298,"2012","011"
"3633","BIANZONE",3,27,0,30,"2012","008"
"3634","BIBBIANO",12,1962,0,1974,"2012","004"
"3635","BIBIANA",587,0,5,592,"2012","025"
"3636","BIELLA",101,41,165,307,"2012","004"
"3637","BIENNO",2,73,0,75,"2012","018"
"3638","BIGARELLO",3088,193,443,3724,"2012","004"
"3639","BINAGO",15,83,72,170,"2012","023"
"3640","BIOGLIO",15,0,0,15,"2012","005"
"3641","BIONE",20,9,5,34,"2012","019"
"3642","BISTAGNO",26,0,0,26,"2012","017"
"3643","BIZZARONE",13,27,0,40,"2012","024"
"3644","BLELLO",14,20,0,34,"2012","027"
"3645","BLESSAGNO",0,0,6,6,"2012","025"
"3646","BOARA PISANI",6,0,0,6,"2012","012"
"3647","BOBBIO",145,33,0,178,"2012","005"
"3648","BOBBIO PELLICE",44,11,119,174,"2012","026"
"3649","BOCA",2,0,0,2,"2012","019"
"3650","BOCCIOLETO",2,0,0,2,"2012","014"
"3651","BOFFALORA D'ADDA",398,360,29,787,"2012","003"
"3652","BOFFALORA SOPRA TICINO",235,183,0,418,"2012","026"
"3653","BOGNANCO",1,0,0,1,"2012",NA
"3654","BOGOGNO",1,0,0,1,"2012",NA
"3655","BOLGARE",65,270,0,335,"2012","028"
"3656","BOLLATE",0,301,0,301,"2012","027"
"3657","BOLLENGO",72,44,0,116,"2012","027"
"3658","BOLOGNA",24,45,0,69,"2012","006"
"3659","BOLTIERE",28,83,0,111,"2012","029"
"3660","BOLZANO NOVARESE",0,23,0,23,"2012","022"
"3661","BOLZANO VICENTINO",197,1368,7,1572,"2012","013"
"3662","BOMPORTO",1493,107,0,1600,"2012","002"
"3663","BONATE SOPRA",286,11,0,297,"2012","030"
"3664","BONATE SOTTO",79,1,0,80,"2012","031"
"3665","BONAVIGO",3151,30,0,3181,"2012","009"
"3666","BONDENO",724,384,0,1108,"2012","003"
"3667","BONEMERSE",19,249,0,268,"2012","006"
"3668","BORDOLANO",18,479,0,497,"2012","007"
"3669","BORE",28,9,0,37,"2012","005"
"3670","BORETTO",0,327,0,327,"2012","005"
"3671","BORGARELLO",2,0,0,2,"2012","015"
"3672","BORGARO TORINESE",93,86,29,208,"2012","028"
"3673","BORGHETTO DI BORBERA",171,7,0,178,"2012","018"
"3674","BORGHETTO LODIGIANO",31,1385,36,1452,"2012","004"
"3675","BORGHI",1554,0,0,1554,"2012","004"
"3676","BORGIALLO",5,29,0,34,"2012","029"
"3677","BORGO D'ALE",86,0,118,204,"2012","015"
"3678","BORGO DI TERZO",6,0,0,6,"2012","032"
"3679","BORGO PRIOLO",8,0,0,8,"2012","016"
"3680","BORGO SAN DALMAZZO",345,122,84,551,"2012","025"
"3681","BORGO SAN GIACOMO",1852,2901,12,4765,"2012","020"
"3682","BORGO SAN GIOVANNI",8,712,0,720,"2012","005"
"3683","BORGO SAN SIRO",2,514,0,516,"2012","018"
"3684","BORGO TICINO",35,0,0,35,"2012","025"
"3685","BORGO TOSSIGNANO",7,0,0,7,"2012","007"
"3686","BORGO VAL DI TARO",130,224,0,354,"2012","006"
"3687","BORGO VERCELLI",0,30,0,30,"2012","017"
"3688","BORGOFORTE",25,2286,1308,3619,"2012","005"
"3689","BORGOFRANCO D'IVREA",176,18,0,194,"2012","030"
"3690","BORGOFRANCO SUL PO",3,23,53,79,"2012","006"
"3691","BORGOLAVEZZARO",7,0,0,7,"2012","023"
"3692","BORGOMALE",141,0,0,141,"2012","024"
"3693","BORGOMANERO",134,56,0,190,"2012","024"
"3694","BORGOMASINO",50,0,0,50,"2012","031"
"3695","BORGONE SUSA",17,18,0,35,"2012","032"
"3696","BORGONOVO VAL TIDONE",577,1700,0,2277,"2012","006"
"3697","BORGORATTO ALESSANDRINO",40,0,0,40,"2012","019"
"3698","BORGORATTO MORMOROLO",25,0,0,25,"2012","017"
"3699","BORGORICCO",101,64,3,168,"2012","013"
"3700","BORGOSATOLLO",11,641,28,680,"2012","021"
"3701","BORGOSESIA",50,30,0,80,"2012","016"
"3702","BORMIO",9,308,27,344,"2012","009"
"3703","BORNASCO",156,510,0,666,"2012","019"
"3704","BORNO",14,176,36,226,"2012","022"
"3705","BORRIANA",75,39,23,137,"2012","006"
"3706","BORSO DEL GRAPPA",133,222,7,362,"2012","004"
"3707","BOSARO",7,0,0,7,"2012","007"
"3708","BOSCHI SANT'ANNA",10,16,0,26,"2012","010"
"3709","BOSCO CHIESANUOVA",439,1313,0,1752,"2012","011"
"3710","BOSCO MARENGO",131,18,0,149,"2012","021"
"3711","BOSCONERO",61,36,0,97,"2012","033"
"3712","BOSIA",403,0,0,403,"2012","026"
"3713","BOSIO",44,0,1,45,"2012","022"
"3714","BOSISIO PARINI",10,115,0,125,"2012","009"
"3715","BOSSICO",22,90,0,112,"2012","033"
"3716","BOSSOLASCO",75,82,0,157,"2012","027"
"3717","BOTTANUCO",19,259,343,621,"2012","034"
"3718","BOTTICINO",28,0,0,28,"2012","023"
"3719","BOVEGNO",78,112,4,194,"2012","024"
"3720","BOVES",628,483,335,1446,"2012","028"
"3721","BOVOLENTA",3497,309,0,3806,"2012","014"
"3722","BOVOLONE",3628,366,0,3994,"2012","012"
"3723","BOZZOLO",87,930,21,1038,"2012","007"
"3724","BRA",4033,1214,0,5247,"2012","029"
"3725","BRACCA",2,0,0,2,"2012","035"
"3726","BRALLO DI PREGOLA",17,22,0,39,"2012","021"
"3727","BRANDICO",111,216,1,328,"2012","026"
"3728","BRANDIZZO",8,65,0,73,"2012","034"
"3729","BRANZI",3,29,0,32,"2012","036"
"3730","BRAONE",1,16,0,17,"2012","027"
"3731","BREBBIA",88,0,0,88,"2012","017"
"3732","BREDA DI PIAVE",67,362,0,429,"2012","005"
"3733","BREGANO",1,0,0,1,"2012","018"
"3734","BREGANZE",250,797,175,1222,"2012","014"
"3735","BREGNANO",7,94,2,103,"2012","028"
"3736","BREIA",4,0,0,4,"2012","019"
"3737","BREMBATE",9,223,0,232,"2012","037"
"3738","BREMBATE DI SOPRA",3,192,0,195,"2012","038"
"3739","BREMBILLA",64,41,0,105,"2012","039"
"3740","BREMBIO",164,1638,60,1862,"2012","006"
"3741","BREME",29,0,0,29,"2012","022"
"3742","BRENDOLA",293,99,0,392,"2012","015"
"3743","BRENNA",5,0,0,5,"2012","029"
"3744","BRENO",8,260,0,268,"2012","028"
"3745","BRENTA",5,0,0,5,"2012","019"
"3746","BRENTINO BELLUNO",2,0,0,2,"2012","013"
"3747","BRENZONE",21,0,0,21,"2012","014"
"3748","BRESCELLO",5,40,6,51,"2012","006"
"3749","BRESCIA",148,615,0,763,"2012","029"
"3750","BRESSANA BOTTARONE",4,0,0,4,"2012","023"
"3751","BRESSANVIDO",48,1267,0,1315,"2012","016"
"3752","BREZZO DI BEDERO",6,0,0,6,"2012","020"
"3753","BRIAGLIA",69,0,0,69,"2012","030"
"3754","BRICHERASIO",985,52,17,1054,"2012","035"
"3755","BRIGA NOVARESE",12,63,0,75,"2012","026"
"3756","BRIGNANO GERA D'ADDA",184,1386,0,1570,"2012","040"
"3757","BRIGNANO-FRASCATA",5,0,0,5,"2012","024"
"3758","BRINZIO",8,0,0,8,"2012","021"
"3759","BRIONA",10,1432,0,1442,"2012","027"
"3760","BRIONE",9,0,0,9,"2012","030"
"3761","BRISIGHELLA",404,91,0,495,"2012","004"
"3762","BRISSAGO-VALTRAVAGLIA",2,0,0,2,"2012","022"
"3763","BRIVIO",55,82,1,138,"2012","010"
"3764","BROGLIANO",28,35,0,63,"2012","017"
"3765","BRONDELLO",5,0,0,5,"2012","032"
"3766","BRONI",156,0,0,156,"2012","024"
"3767","BROSSASCO",83,0,0,83,"2012","033"
"3768","BROSSO",32,26,0,58,"2012","036"
"3769","BROVELLO-CARPUGNINO",16,0,2,18,"2012","013"
"3770","BROZOLO",135,0,0,135,"2012","037"
"3771","BRUGINE",4282,93,37,4412,"2012","015"
"3772","BRUINO",131,0,0,131,"2012","038"
"3773","BRUMANO",11,17,0,28,"2012","041"
"3774","BRUNELLO",21,3,0,24,"2012","023"
"3775","BRUNO",23,0,0,23,"2012","010"
"3776","BRUSAPORTO",19,40,0,59,"2012","042"
"3777","BRUSASCO",115,0,0,115,"2012","039"
"3778","BRUSNENGO",22,0,0,22,"2012","007"
"3779","BRUZOLO",67,12,10,89,"2012","040"
"3780","BUBBIANO",3,29,0,32,"2012","035"
"3781","BUBBIO",72,0,0,72,"2012","011"
"3782","BUCCINASCO",13,509,0,522,"2012","036"
"3783","BUDRIO",350,390,0,740,"2012","008"
"3784","BUGLIO IN MONTE",18,223,32,273,"2012","010"
"3785","BUGUGGIATE",7,0,0,7,"2012","025"
"3786","BULCIAGO",10,108,50,168,"2012","011"
"3787","BULGAROGRASSO",36,274,7,317,"2012","034"
"3788","BURIASCO",1131,640,257,2028,"2012","041"
"3789","BUROLO",7,0,0,7,"2012","042"
"3790","BURONZO",3,8,0,11,"2012","021"
"3791","BUSANA",0,32,0,32,"2012","007"
"3792","BUSANO",19,41,0,60,"2012","043"
"3793","BUSCA",4661,1010,689,6360,"2012","034"
"3794","BUSCATE",48,0,0,48,"2012","038"
"3795","BUSSERO",2,619,0,621,"2012","040"
"3796","BUSSETO",2,3657,0,3659,"2012","007"
"3797","BUSSOLENGO",2134,122,26,2282,"2012","015"
"3798","BUSSOLENO",45,224,0,269,"2012","044"
"3799","BUSTO ARSIZIO",50,245,13,308,"2012","026"
"3800","BUSTO GAROLFO",85,200,0,285,"2012","041"
"3801","BUTTAPIETRA",16,284,0,300,"2012","016"
"3802","BUTTIGLIERA ALTA",80,45,0,125,"2012","045"
"3803","BUTTIGLIERA D'ASTI",1803,76,62,1941,"2012","012"
"3804","CA' D'ANDREA",1,1154,4,1159,"2012","008"
"3805","CABELLA LIGURE",73,0,0,73,"2012","025"
"3806","CABIATE",2,0,0,2,"2012","035"
"3807","CADEGLIANO-VICONAGO",4,0,0,4,"2012","027"
"3808","CADELBOSCO DI SOPRA",54,1347,0,1401,"2012","008"
"3809","CADEO",30,2145,0,2175,"2012","007"
"3810","CADONEGHE",12,3,14,29,"2012","016"
"3811","CADORAGO",5,54,0,59,"2012","036"
"3812","CADREZZATE",3,0,0,3,"2012","028"
"3813","CAERANO DI SAN MARCO",208,128,7,343,"2012","006"
"3814","CAFASSE",95,22,5,122,"2012","046"
"3815","CAGLIO",10,3,0,13,"2012","037"
"3816","CAGNO",0,47,0,47,"2012","038"
"3817","CAINO",11,0,0,11,"2012","031"
"3818","CAIOLO",3,57,0,60,"2012","011"
"3819","CAIRATE",4,5,0,9,"2012","029"
"3820","CALAMANDRANA",97,0,0,97,"2012","013"
"3821","CALASCA-CASTIGLIONE",21,0,0,21,"2012","014"
"3822","CALCINATE",206,245,0,451,"2012","043"
"3823","CALCINATO",3266,1767,1039,6072,"2012","032"
"3824","CALCIO",265,1319,0,1584,"2012","044"
"3825","CALCO",15,151,0,166,"2012","012"
"3826","CALDERARA DI RENO",36,109,0,145,"2012","009"
"3827","CALDIERO",1,0,0,1,"2012","017"
"3828","CALDOGNO",233,323,10,566,"2012","018"
"3829","CALENDASCO",134,384,0,518,"2012","008"
"3830","CALESTANO",12,481,0,493,"2012","008"
"3831","CALLABIANA",12,0,0,12,"2012","008"
"3832","CALLIANO",286,0,0,286,"2012","014"
"3833","CALOLZIOCORTE",8,0,13,21,"2012","013"
"3834","CALOSSO",20,0,0,20,"2012","015"
"3835","CALTIGNAGA",708,238,0,946,"2012","030"
"3836","CALTO",8,0,0,8,"2012","008"
"3837","CALTRANO",1572,3,0,1575,"2012","019"
"3838","CALUSCO D'ADDA",16,0,0,16,"2012","046"
"3839","CALUSO",704,162,0,866,"2012","047"
"3840","CALVAGESE DELLA RIVIERA",69,162,0,231,"2012","033"
"3841","CALVATONE",92,108,0,200,"2012","009"
"3842","CALVENE",5,77,0,82,"2012","020"
"3843","CALVENZANO",5,423,0,428,"2012","047"
"3844","CALVIGNASCO",1,40,0,41,"2012","042"
"3845","CALVISANO",13785,4076,48,17909,"2012","034"
"3846","CAMAGNA MONFERRATO",30,0,0,30,"2012","026"
"3847","CAMAIRAGO",0,1141,0,1141,"2012","007"
"3848","CAMANDONA",3,0,0,3,"2012","009"
"3849","CAMBIAGO",12,92,0,104,"2012","044"
"3850","CAMBIANO",330,0,0,330,"2012","048"
"3851","CAMBIASCA",6,0,0,6,"2012","015"
"3852","CAMBURZANO",84,0,14,98,"2012","010"
"3853","CAMERANA",290,0,0,290,"2012","035"
"3854","CAMERANO CASASCO",26,0,0,26,"2012","016"
"3855","CAMERATA CORNELLO",15,58,0,73,"2012","048"
"3856","CAMERI",108,592,46,746,"2012","032"
"3857","CAMINATA",18,0,0,18,"2012","009"
"3858","CAMISANO",170,2757,0,2927,"2012","010"
"3859","CAMISANO VICENTINO",435,1337,49,1821,"2012","021"
"3860","CAMPAGNA LUPIA",84,148,0,232,"2012","002"
"3861","CAMPAGNOLA CREMASCA",135,444,0,579,"2012","011"
"3862","CAMPAGNOLA EMILIA",12,739,0,751,"2012","009"
"3863","CAMPEGINE",15,1069,0,1084,"2012","010"
"3864","CAMPERTOGNO",111,35,13,159,"2012","025"
"3865","CAMPIGLIA CERVO",0,0,10,10,"2012","011"
"3866","CAMPIGLIA DEI BERICI",752,130,0,882,"2012","022"
"3867","CAMPIGLIONE-FENILE",773,0,92,865,"2012","049"
"3868","CAMPO SAN MARTINO",105,118,0,223,"2012","020"
"3869","CAMPODARSEGO",710,74,0,784,"2012","017"
"3870","CAMPODOLCINO",2,0,0,2,"2012",NA
"3871","CAMPODORO",71,308,0,379,"2012","018"
"3872","CAMPOGALLIANO",0,569,0,569,"2012","003"
"3873","CAMPOLONGO MAGGIORE",53,56,0,109,"2012","003"
"3874","CAMPOLONGO SUL BRENTA",27,0,0,27,"2012","023"
"3875","CAMPONOGARA",126,45,17,188,"2012","004"
"3876","CAMPOSAMPIERO",158,129,0,287,"2012","019"
"3877","CAMPOSPINOSO",4,0,0,4,"2012","026"
"3878","CAMUGNANO",174,133,0,307,"2012","010"
"3879","CANALE",733,0,0,733,"2012","037"
"3880","CANARO",240,29,0,269,"2012","009"
"3881","CANDA",33,0,0,33,"2012","010"
"3882","CANDELO",96,99,48,243,"2012","012"
"3883","CANDIA CANAVESE",29,0,0,29,"2012","050"
"3884","CANDIANA",9989,214,0,10203,"2012","021"
"3885","CANDIOLO",78,523,108,709,"2012","051"
"3886","CANEGRATE",4,0,0,4,"2012","046"
"3887","CANELLI",6,0,0,6,"2012","017"
"3888","CANEVINO",9,0,0,9,"2012","028"
"3889","CANISCHIO",4,0,0,4,"2012","052"
"3890","CANNERO RIVIERA",1,0,0,1,"2012","016"
"3891","CANNETO SULL'OGLIO",1260,1436,1028,3724,"2012","008"
"3892","CANNOBIO",17,0,0,17,"2012","017"
"3893","CANONICA D'ADDA",71,372,0,443,"2012","049"
"3894","CANOSIO",13,0,37,50,"2012","038"
"3895","CANOSSA",24,339,0,363,"2012","018"
"3896","CANTALUPA",119,0,0,119,"2012","053"
"3897","CANTALUPO LIGURE",31,0,0,31,"2012","028"
"3898","CANTARANA",110,0,0,110,"2012","018"
"3899","CANTELLO",129,157,0,286,"2012","030"
"3900","CANTOIRA",77,12,13,102,"2012","054"
"3901","CANTU'",245,259,9,513,"2012","041"
"3902","CANZO",2,0,6,8,"2012","042"
"3903","CAORLE",691,172,0,863,"2012","005"
"3904","CAORSO",19,473,0,492,"2012","010"
"3905","CAPERGNANICA",359,1209,0,1568,"2012","012"
"3906","CAPIAGO INTIMIANO",10,36,0,46,"2012","043"
"3907","CAPIZZONE",8,10,0,18,"2012","050"
"3908","CAPO DI PONTE",15,70,0,85,"2012","035"
"3909","CAPOVALLE",22,12,0,34,"2012","036"
"3910","CAPPELLA CANTONE",0,472,0,472,"2012","013"
"3911","CAPPELLA DE' PICENARDI",22,308,0,330,"2012","014"
"3912","CAPPELLA MAGGIORE",28,25,0,53,"2012","007"
"3913","CAPRALBA",2,1533,0,1535,"2012","015"
"3914","CAPRAUNA",5,0,0,5,"2012","039"
"3915","CAPRIANO DEL COLLE",16,871,2,889,"2012","037"
"3916","CAPRIATA D'ORBA",35,0,0,35,"2012","029"
"3917","CAPRIE",27,0,0,27,"2012","055"
"3918","CAPRIGLIO",1,0,0,1,"2012","019"
"3919","CAPRILE",20,2,0,22,"2012","013"
"3920","CAPRINO BERGAMASCO",17,42,0,59,"2012","052"
"3921","CAPRINO VERONESE",114,690,19,823,"2012","018"
"3922","CAPRIOLO",260,35,0,295,"2012","038"
"3923","CARAGLIO",3009,803,305,4117,"2012","040"
"3924","CARAMAGNA PIEMONTE",1201,570,83,1854,"2012","041"
"3925","CARAVAGGIO",410,2825,42,3277,"2012","053"
"3926","CARAVATE",2,101,0,103,"2012","031"
"3927","CARAVINO",3,0,0,3,"2012","056"
"3928","CARBONARA AL TICINO",0,195,0,195,"2012","030"
"3929","CARBONARA DI PO",0,464,36,500,"2012","009"
"3930","CARBONARA SCRIVIA",12,0,0,12,"2012","030"
"3931","CARBONATE",76,41,7,124,"2012","045"
"3932","CARBONERA",110,366,0,476,"2012","008"
"3933","CARCERI",789,0,0,789,"2012","022"
"3934","CARCOFORO",0,4,0,4,"2012","029"
"3935","CARDANO AL CAMPO",10,0,0,10,"2012","032"
"3936","CARDE'",2831,1674,0,4505,"2012","042"
"3937","CAREMA",76,11,0,87,"2012","057"
"3938","CARENNO",23,0,9,32,"2012","014"
"3939","CARENTINO",142,484,0,626,"2012","031"
"3940","CARESANA",3,0,0,3,"2012","030"
"3941","CAREZZANO",3,0,0,3,"2012","032"
"3942","CARIGNANO",3052,1567,130,4749,"2012","058"
"3943","CARISIO",34,0,0,34,"2012","032"
"3944","CARLAZZO",16,40,20,76,"2012","047"
"3945","CARMAGNOLA",6250,2635,189,9074,"2012","059"
"3946","CARMIGNANO DI BRENTA",291,1361,5,1657,"2012","023"
"3947","CARNAGO",20,40,0,60,"2012","033"
"3948","CAROBBIO DEGLI ANGELI",88,35,0,123,"2012","055"
"3949","CARONNO PERTUSELLA",5,0,0,5,"2012","034"
"3950","CARONNO VARESINO",19,0,0,19,"2012","035"
"3951","CARPANETO PIACENTINO",145,3475,0,3620,"2012","011"
"3952","CARPENEDOLO",1611,3641,3,5255,"2012","039"
"3953","CARPENETO",135,0,0,135,"2012","033"
"3954","CARPI",11,1804,0,1815,"2012","005"
"3955","CARPIANO",82,1156,0,1238,"2012","050"
"3956","CARPIGNANO SESIA",94,28,0,122,"2012","036"
"3957","CARPINETI",103,1429,4,1536,"2012","011"
"3958","CARRE'",405,151,0,556,"2012","024"
"3959","CARREGA LIGURE",56,0,0,56,"2012","034"
"3960","CARROSIO",1,0,0,1,"2012","035"
"3961","CARRU'",795,33,0,828,"2012","043"
"3962","CARTIGLIANO",21,53,0,74,"2012","025"
"3963","CARTIGNANO",187,88,0,275,"2012","044"
"3964","CARTOSIO",48,0,0,48,"2012","036"
"3965","CARTURA",500,23,0,523,"2012","026"
"3966","CARUGATE",1,89,0,90,"2012","051"
"3967","CARUGO",11,0,0,11,"2012","048"
"3968","CARVICO",14,0,0,14,"2012","057"
"3969","CASAL CERMELLI",17,0,0,17,"2012","037"
"3970","CASALBELTRAME",1,0,130,131,"2012","037"
"3971","CASALBORGONE",77,0,0,77,"2012","060"
"3972","CASALBUTTANO ED UNITI",10,1238,0,1248,"2012","016"
"3973","CASALE CORTE CERRO",11,0,0,11,"2012","019"
"3974","CASALE CREMASCO-VIDOLASCO",94,1612,0,1706,"2012","017"
"3975","CASALE DI SCODOSIA",659,0,0,659,"2012","027"
"3976","CASALE LITTA",22,145,8,175,"2012","036"
"3977","CASALE MONFERRATO",124,190,0,314,"2012","039"
"3978","CASALE SUL SILE",126,178,0,304,"2012","009"
"3979","CASALECCHIO DI RENO",2,0,0,2,"2012","011"
"3980","CASALEGGIO BOIRO",8,0,0,8,"2012","038"
"3981","CASALEONE",354,0,0,354,"2012","019"
"3982","CASALETTO CEREDANO",6,23,0,29,"2012","018"
"3983","CASALETTO DI SOPRA",10,290,0,300,"2012","019"
"3984","CASALETTO LODIGIANO",10,527,0,537,"2012","008"
"3985","CASALETTO VAPRIO",105,578,0,683,"2012","020"
"3986","CASALFIUMANESE",300,138,0,438,"2012","012"
"3987","CASALGRANDE",5,1081,0,1086,"2012","012"
"3988","CASALGRASSO",182,373,0,555,"2012","045"
"3989","CASALINO",3,397,0,400,"2012","040"
"3990","CASALMAGGIORE",23,720,3,746,"2012","021"
"3991","CASALMAIOCCO",15,608,0,623,"2012","009"
"3992","CASALMORANO",97,1711,0,1808,"2012","022"
"3993","CASALMORO",1110,249,283,1642,"2012","010"
"3994","CASALNOCETO",10,0,0,10,"2012","040"
"3995","CASALOLDO",988,1032,766,2786,"2012","011"
"3996","CASALPUSTERLENGO",0,1369,0,1369,"2012","010"
"3997","CASALROMANO",200,338,139,677,"2012","012"
"3998","CASALSERUGO",82,7,55,144,"2012","028"
"3999","CASALVOLONE",8,65,0,73,"2012","041"
"4000","CASALZUIGNO",5,101,0,106,"2012","037"
"4001","CASANOVA ELVO",3,0,0,3,"2012","033"
"4002","CASARGO",23,0,0,23,"2012","015"
"4003","CASARILE",16,20,0,36,"2012","055"
"4004","CASASCO",68,0,0,68,"2012","041"
"4005","CASATENOVO",271,19,0,290,"2012","016"
"4006","CASAZZA",8,7,10,25,"2012","058"
"4007","CASCIAGO",30,48,0,78,"2012","038"
"4008","CASEI GEROLA",534,0,0,534,"2012","033"
"4009","CASELETTE",90,318,35,443,"2012","062"
"4010","CASELLE LANDI",376,502,0,878,"2012","011"
"4011","CASELLE LURANI",93,242,0,335,"2012","012"
"4012","CASELLE TORINESE",241,1345,54,1640,"2012","063"
"4013","CASIER",16,102,0,118,"2012","010"
"4014","CASINA",164,882,0,1046,"2012","013"
"4015","CASIRATE D'ADDA",173,433,0,606,"2012","059"
"4016","CASLINO D'ERBA",0,20,0,20,"2012","052"
"4017","CASNATE CON BERNATE",66,0,0,66,"2012","053"
"4018","CASNIGO",39,156,0,195,"2012","060"
"4019","CASOLA VALSENIO",140,103,0,243,"2012","005"
"4020","CASORATE PRIMO",15,135,0,150,"2012","034"
"4021","CASORATE SEMPIONE",1,0,0,1,"2012","039"
"4022","CASOREZZO",2,341,0,343,"2012","058"
"4023","CASORZO",4,0,0,4,"2012","020"
"4024","CASPOGGIO",0,35,0,35,"2012","013"
"4025","CASSAGO BRIANZA",4,37,1,42,"2012","017"
"4026","CASSANO D'ADDA",163,303,0,466,"2012","059"
"4027","CASSANO MAGNAGO",28,103,19,150,"2012","040"
"4028","CASSANO SPINOLA",441,0,0,441,"2012","042"
"4029","CASSANO VALCUVIA",1,0,0,1,"2012","041"
"4030","CASSIGLIO",1,0,0,1,"2012",NA
"4031","CASSINA DE' PECCHI",0,463,0,463,"2012","060"
"4032","CASSINA RIZZARDI",3,0,0,3,"2012","055"
"4033","CASSINA VALSASSINA",3,62,0,65,"2012","018"
"4034","CASSINASCO",47,20,0,67,"2012","021"
"4035","CASSINE",160,0,0,160,"2012","043"
"4036","CASSINELLE",6,0,0,6,"2012","044"
"4037","CASSINETTA DI LUGAGNANO",4,164,0,168,"2012","061"
"4038","CASSOLA",988,28,0,1016,"2012","026"
"4039","CASSOLNOVO",36,53,0,89,"2012","035"
"4040","CASTAGNARO",396,0,0,396,"2012","020"
"4041","CASTAGNETO PO",51,0,0,51,"2012","064"
"4042","CASTAGNITO",257,0,0,257,"2012","046"
"4043","CASTAGNOLE DELLE LANZE",282,0,0,282,"2012","022"
"4044","CASTAGNOLE MONFERRATO",55,0,0,55,"2012","023"
"4045","CASTAGNOLE PIEMONTE",1166,948,0,2114,"2012","065"
"4046","CASTANA",4,0,0,4,"2012","036"
"4047","CASTANO PRIMO",94,0,0,94,"2012","062"
"4048","CASTEGGIO",19,0,0,19,"2012","037"
"4049","CASTEGNATO",89,950,18,1057,"2012","040"
"4050","CASTEGNERO",66,53,1,120,"2012","027"
"4051","CASTEL BOGLIONE",55,0,0,55,"2012","024"
"4052","CASTEL BOLOGNESE",26,0,0,26,"2012","006"
"4053","CASTEL D'AIANO",39,491,78,608,"2012","013"
"4054","CASTEL D'ARIO",0,313,732,1045,"2012","014"
"4055","CASTEL D'AZZANO",2007,133,0,2140,"2012","021"
"4056","CASTEL DEL RIO",9,23,0,32,"2012","014"
"4057","CASTEL DI CASIO",60,25,2,87,"2012","015"
"4058","CASTEL GABBIANO",0,1446,0,1446,"2012","024"
"4059","CASTEL GOFFREDO",2548,449,444,3441,"2012","015"
"4060","CASTEL GUELFO DI BOLOGNA",160,266,0,426,"2012","016"
"4061","CASTEL MAGGIORE",12,0,0,12,"2012","019"
"4062","CASTEL MELLA",2,367,0,369,"2012","042"
"4063","CASTEL ROCCHERO",19,0,0,19,"2012","032"
"4064","CASTEL ROZZONE",7,40,0,47,"2012","063"
"4065","CASTEL SAN GIOVANNI",146,821,0,967,"2012","013"
"4066","CASTEL SAN PIETRO TERME",643,311,0,954,"2012","020"
"4067","CASTELBALDO",7,0,0,7,"2012","029"
"4068","CASTELBELFORTE",1618,109,0,1727,"2012","013"
"4069","CASTELCOVATI",8,285,0,293,"2012","041"
"4070","CASTELCUCCO",32,234,0,266,"2012","011"
"4071","CASTELDELCI",156,0,1,157,"2012","021"
"4072","CASTELDELFINO",65,0,0,65,"2012","047"
"4073","CASTELDIDONE",39,0,0,39,"2012","023"
"4074","CASTELFRANCO EMILIA",957,2260,0,3217,"2012","006"
"4075","CASTELFRANCO VENETO",5668,216,11,5895,"2012","012"
"4076","CASTELGOMBERTO",543,474,0,1017,"2012","028"
"4077","CASTELGUGLIELMO",442,0,0,442,"2012","011"
"4078","CASTELL'ALFERO",408,0,0,408,"2012","025"
"4079","CASTELL'ARQUATO",104,719,0,823,"2012","012"
"4080","CASTELLAMONTE",289,298,0,587,"2012","066"
"4081","CASTELLAR",4,7,0,11,"2012","048"
"4082","CASTELLARANO",26,322,0,348,"2012","014"
"4083","CASTELLAVAZZO",3,0,0,3,"2012","009"
"4084","CASTELLAZZO BORMIDA",136,7,0,143,"2012","047"
"4085","CASTELLAZZO NOVARESE",6,0,0,6,"2012","042"
"4086","CASTELLEONE",713,3339,0,4052,"2012","025"
"4087","CASTELLERO",1,0,0,1,"2012","026"
"4088","CASTELLETTO CERVO",36,0,0,36,"2012","015"
"4089","CASTELLETTO D'ORBA",11,0,0,11,"2012","049"
"4090","CASTELLETTO DI BRANDUZZO",11,0,0,11,"2012","038"
"4091","CASTELLETTO MERLI",85,0,0,85,"2012","050"
"4092","CASTELLETTO MONFERRATO",106,0,0,106,"2012","051"
"4093","CASTELLETTO SOPRA TICINO",119,52,0,171,"2012","043"
"4094","CASTELLETTO STURA",1295,68,93,1456,"2012","049"
"4095","CASTELLETTO UZZONE",53,0,0,53,"2012","050"
"4096","CASTELLI CALEPIO",51,260,0,311,"2012","062"
"4097","CASTELLINALDO",945,0,0,945,"2012","051"
"4098","CASTELLINO TANARO",125,0,0,125,"2012","052"
"4099","CASTELLO CABIAGLIO",8,0,0,8,"2012","043"
"4100","CASTELLO D'ARGILE",18,78,20,116,"2012","017"
"4101","CASTELLO DELL'ACQUA",17,19,0,36,"2012","014"
"4102","CASTELLO DI ANNONE",163,0,0,163,"2012","028"
"4103","CASTELLO DI BRIANZA",9,0,0,9,"2012","019"
"4104","CASTELLO DI GODEGO",5399,165,6,5570,"2012","013"
"4105","CASTELLO DI SERRAVALLE",86,354,0,440,"2012","018"
"4106","CASTELLUCCHIO",1126,1722,1229,4077,"2012","016"
"4107","CASTELMAGNO",59,16,0,75,"2012","053"
"4108","CASTELMARTE",10,1,0,11,"2012","058"
"4109","CASTELMASSA",0,108,0,108,"2012","012"
"4110","CASTELNOVETTO",1,0,0,1,"2012","040"
"4111","CASTELNOVO BARIANO",1295,76,0,1371,"2012","013"
"4112","CASTELNOVO DI SOTTO",9,1006,8,1023,"2012","015"
"4113","CASTELNOVO NE' MONTI",82,1377,32,1491,"2012","016"
"4114","CASTELNUOVO BELBO",5,0,0,5,"2012","029"
"4115","CASTELNUOVO BOCCA D'ADDA",2871,90,0,2961,"2012","013"
"4116","CASTELNUOVO BORMIDA",9,0,0,9,"2012","052"
"4117","CASTELNUOVO BOZZENTE",6,18,0,24,"2012","059"
"4118","CASTELNUOVO CALCEA",1,0,0,1,"2012","030"
"4119","CASTELNUOVO DEL GARDA",2813,284,0,3097,"2012","022"
"4120","CASTELNUOVO DON BOSCO",201,0,0,201,"2012","031"
"4121","CASTELNUOVO NIGRA",44,0,0,44,"2012","067"
"4122","CASTELNUOVO RANGONE",30,779,0,809,"2012","007"
"4123","CASTELNUOVO SCRIVIA",160,0,14,174,"2012","053"
"4124","CASTELSEPRIO",3,0,2,5,"2012","044"
"4125","CASTELSPINA",17,0,0,17,"2012","054"
"4126","CASTELVECCANA",13,0,8,21,"2012","045"
"4127","CASTELVERDE",210,3137,109,3456,"2012","026"
"4128","CASTELVETRO DI MODENA",33,1280,7,1320,"2012","008"
"4129","CASTELVETRO PIACENTINO",521,867,0,1388,"2012","014"
"4130","CASTELVISCONTI",14,1663,0,1677,"2012","027"
"4131","CASTENASO",65,220,0,285,"2012","021"
"4132","CASTENEDOLO",797,1539,13,2349,"2012","043"
"4133","CASTIGLIONE D'ADDA",2,466,0,468,"2012","014"
"4134","CASTIGLIONE D'INTELVI",3,12,8,23,"2012","060"
"4135","CASTIGLIONE DEI PEPOLI",123,74,0,197,"2012","022"
"4136","CASTIGLIONE DELLE STIVIERE",3455,1482,1326,6263,"2012","017"
"4137","CASTIGLIONE FALLETTO",27,0,0,27,"2012","055"
"4138","CASTIGLIONE OLONA",1,13,8,22,"2012","046"
"4139","CASTIGLIONE TINELLA",27,0,0,27,"2012","056"
"4140","CASTIGLIONE TORINESE",10,0,0,10,"2012","068"
"4141","CASTINO",199,0,0,199,"2012","057"
"4142","CASTIONE ANDEVENNO",19,36,1,56,"2012","015"
"4143","CASTIONE DELLA PRESOLANA",38,8,0,46,"2012","064"
"4144","CASTIRAGA VIDARDO",4,339,0,343,"2012","015"
"4145","CASTO",28,41,0,69,"2012","044"
"4146","CASTREZZATO",350,1054,0,1404,"2012","045"
"4147","CASTRO",2,0,0,2,"2012","065"
"4148","CASTROCARO TERME E TERRA DEL SOLE",21,15,0,36,"2012","005"
"4149","CASTRONNO",4,0,0,4,"2012","047"
"4150","CAVACURTA",70,476,0,546,"2012","016"
"4151","CAVAGLIA'",1174,205,8,1387,"2012","016"
"4152","CAVAGLIETTO",0,191,0,191,"2012","044"
"4153","CAVAGNOLO",32,0,0,32,"2012","069"
"4154","CAVAION VERONESE",9,0,0,9,"2012","023"
"4155","CAVALLASCA",1,0,45,46,"2012","061"
"4156","CAVALLERLEONE",428,834,71,1333,"2012","058"
"4157","CAVALLERMAGGIORE",2438,2070,41,4549,"2012","059"
"4158","CAVALLINO-TREPORTI",16,0,0,16,"2012","044"
"4159","CAVALLIRIO",1,0,0,1,"2012","047"
"4160","CAVARGNA",1,0,12,13,"2012","062"
"4161","CAVARIA CON PREMEZZO",2,0,3,5,"2012","048"
"4162","CAVARZERE",6000,11,0,6011,"2012","006"
"4163","CAVASO DEL TOMBA",74,125,0,199,"2012","014"
"4164","CAVATORE",5,0,0,5,"2012","055"
"4165","CAVENAGO D'ADDA",5,706,130,841,"2012","017"
"4166","CAVERNAGO",1,0,0,1,"2012","066"
"4167","CAVEZZO",0,298,0,298,"2012","009"
"4168","CAVOUR",2854,257,1053,4164,"2012","070"
"4169","CAVRIAGO",7,508,0,515,"2012","017"
"4170","CAVRIANA",2066,1643,378,4087,"2012","018"
"4171","CAZZAGO BRABBIA",1,0,0,1,"2012",NA
"4172","CAZZAGO SAN MARTINO",4385,263,236,4884,"2012","046"
"4173","CAZZANO DI TRAMIGNA",3,0,0,3,"2012","024"
"4174","CAZZANO SANT'ANDREA",312,12,0,324,"2012","067"
"4175","CECIMA",17,0,0,17,"2012","042"
"4176","CEDEGOLO",3,21,1,25,"2012","047"
"4177","CEDRASCO",0,60,0,60,"2012","016"
"4178","CEGGIA",17,0,0,17,"2012","007"
"4179","CELLA DATI",270,156,126,552,"2012","028"
"4180","CELLA MONTE",156,0,0,156,"2012","056"
"4181","CELLARENGO",310,91,143,544,"2012","033"
"4182","CELLATICA",3,70,0,73,"2012","048"
"4183","CELLE DI MACRA",91,9,0,100,"2012","060"
"4184","CELLE ENOMONDO",159,0,0,159,"2012","034"
"4185","CELLIO",3,0,0,3,"2012","038"
"4186","CENATE SOPRA",18,0,0,18,"2012","068"
"4187","CENATE SOTTO",21,0,0,21,"2012","069"
"4188","CENCENIGHE AGORDINO",0,6,0,6,"2012","010"
"4189","CENE",29,54,0,83,"2012","070"
"4190","CENESELLI",1,206,57,264,"2012","014"
"4191","CENTALLO",6911,562,373,7846,"2012","061"
"4192","CENTO",2,0,0,2,"2012","004"
"4193","CEPPO MORELLI",18,0,0,18,"2012","021"
"4194","CERANO",81,0,0,81,"2012","049"
"4195","CERANO D'INTELVI",5,0,38,43,"2012","063"
"4196","CERANOVA",0,617,0,617,"2012","043"
"4197","CERCENASCO",168,198,0,366,"2012","071"
"4198","CERCINO",13,74,0,87,"2012","017"
"4199","CEREA",1591,180,0,1771,"2012","025"
"4200","CERES",8,0,0,8,"2012","072"
"4201","CERESARA",1575,432,98,2105,"2012","019"
"4202","CERESETO",93,0,0,93,"2012","057"
"4203","CERESOLE ALBA",3010,580,0,3590,"2012","062"
"4204","CERESOLE REALE",0,24,0,24,"2012","073"
"4205","CERETE",6,158,0,164,"2012","071"
"4206","CERETTO LOMELLINA",3,0,0,3,"2012","044"
"4207","CERIGNALE",33,0,0,33,"2012","015"
"4208","CERMENATE",0,202,0,202,"2012","064"
"4209","CERNUSCO LOMBARDONE",12,0,0,12,"2012","020"
"4210","CERNUSCO SUL NAVIGLIO",7,175,0,182,"2012","070"
"4211","CERRETO CASTELLO",36,73,0,109,"2012","017"
"4212","CERRETO D'ASTI",5,0,0,5,"2012","035"
"4213","CERRETO GRUE",68,0,0,68,"2012","058"
"4214","CERRETTO LANGHE",20,0,0,20,"2012","063"
"4215","CERRINA MONFERRATO",37,0,0,37,"2012","059"
"4216","CERRIONE",106,422,0,528,"2012","018"
"4217","CERRO AL LAMBRO",1,642,0,643,"2012","071"
"4218","CERRO MAGGIORE",13,82,0,95,"2012","072"
"4219","CERRO TANARO",302,0,0,302,"2012","036"
"4220","CERRO VERONESE",33,146,0,179,"2012","026"
"4221","CERTOSA DI PAVIA",11,0,0,11,"2012","046"
"4222","CERVARESE SANTA CROCE",40,162,136,338,"2012","030"
"4223","CERVASCA",1014,315,8,1337,"2012","064"
"4224","CERVATTO",10,0,0,10,"2012",NA
"4225","CERVENO",13,15,0,28,"2012","049"
"4226","CERVERE",1814,239,166,2219,"2012","065"
"4227","CERVIA",11,0,0,11,"2012","007"
"4228","CERVIGNANO D'ADDA",0,816,0,816,"2012","018"
"4229","CESANA BRIANZA",4,19,0,23,"2012","021"
"4230","CESANA TORINESE",16,0,67,83,"2012","074"
"4231","CESANO BOSCONE",0,49,0,49,"2012","074"
"4232","CESARA",7,1,0,8,"2012","022"
"4233","CESENA",119,14,0,133,"2012","007"
"4234","CESENATICO",4,103,0,107,"2012","008"
"4235","CESIOMAGGIORE",165,91,63,319,"2012","011"
"4236","CESSALTO",44,127,22,193,"2012","015"
"4237","CESSOLE",140,0,0,140,"2012","037"
"4238","CETO",5,47,1,53,"2012","050"
"4239","CEVA",889,0,0,889,"2012","066"
"4240","CEVO",30,2,1,33,"2012","051"
"4241","CHERASCO",4254,952,0,5206,"2012","067"
"4242","CHIALAMBERTO",17,54,0,71,"2012","075"
"4243","CHIAMPO",47,103,0,150,"2012","029"
"4244","CHIANOCCO",84,0,0,84,"2012","076"
"4245","CHIARANO",21,457,0,478,"2012","016"
"4246","CHIARI",1273,4832,0,6105,"2012","052"
"4247","CHIAVENNA",3,10,0,13,"2012","018"
"4248","CHIAVERANO",30,0,0,30,"2012","077"
"4249","CHIERI",2427,423,40,2890,"2012","078"
"4250","CHIES D'ALPAGO",14,0,0,14,"2012","012"
"4251","CHIESA IN VALMALENCO",9,51,2,62,"2012","019"
"4252","CHIESANUOVA",37,104,0,141,"2012","079"
"4253","CHIEVE",160,940,0,1100,"2012","029"
"4254","CHIGNOLO D'ISOLA",49,304,0,353,"2012","072"
"4255","CHIGNOLO PO",33,96,0,129,"2012","048"
"4256","CHIOGGIA",2431,0,0,2431,"2012","008"
"4257","CHIOMONTE",2,23,0,25,"2012","080"
"4258","CHIUDUNO",57,8,0,65,"2012","073"
"4259","CHIUPPANO",18,35,0,53,"2012","030"
"4260","CHIURO",1,81,0,82,"2012","020"
"4261","CHIUSA DI PESIO",1338,266,212,1816,"2012","068"
"4262","CHIUSA DI SAN MICHELE",3,0,56,59,"2012","081"
"4263","CHIUSANO D'ASTI",25,0,0,25,"2012","038"
"4264","CHIVASSO",1684,259,0,1943,"2012","082"
"4265","CICOGNOLO",0,798,0,798,"2012","030"
"4266","CICONIO",102,76,0,178,"2012","083"
"4267","CIGLIANO",315,69,28,412,"2012","042"
"4268","CIGLIE'",479,0,0,479,"2012","069"
"4269","CIGOGNOLA",17,0,0,17,"2012","049"
"4270","CIGOLE",1300,1493,0,2793,"2012","053"
"4271","CILAVEGNA",23,41,0,64,"2012","050"
"4272","CIMADOLMO",21,146,14,181,"2012","017"
"4273","CIMBERGO",3,0,0,3,"2012","054"
"4274","CINAGLIO",795,0,0,795,"2012","039"
"4275","CINGIA DE' BOTTI",9,1019,0,1028,"2012","031"
"4276","CINO",9,15,0,24,"2012","021"
"4277","CINTANO",24,3,0,27,"2012","084"
"4278","CINTO CAOMAGGIORE",317,14,24,355,"2012","009"
"4279","CINTO EUGANEO",83,28,0,111,"2012","031"
"4280","CINZANO",11,0,0,11,"2012","085"
"4281","CIRIE'",241,268,49,558,"2012","086"
"4282","CIRIMIDO",5,24,0,29,"2012","068"
"4283","CISANO BERGAMASCO",22,0,0,22,"2012","074"
"4284","CISERANO",23,30,0,53,"2012","075"
"4285","CISLAGO",32,0,0,32,"2012","050"
"4286","CISLIANO",200,448,0,648,"2012","078"
"4287","CISMON DEL GRAPPA",2,5,0,7,"2012","031"
"4288","CISON DI VALMARINO",96,27,0,123,"2012","018"
"4289","CISSONE",7,0,0,7,"2012","070"
"4290","CISTERNA D'ASTI",88,0,0,88,"2012","040"
"4291","CITTADELLA",1600,1178,0,2778,"2012","032"
"4292","CITTIGLIO",22,13,0,35,"2012","051"
"4293","CIVATE",6,0,0,6,"2012","022"
"4294","CIVENNA",7,11,0,18,"2012","070"
"4295","CIVIASCO",6,10,0,16,"2012","043"
"4296","CIVIDATE AL PIANO",1014,714,0,1728,"2012","076"
"4297","CIVIDATE CAMUNO",7,1,0,8,"2012","055"
"4298","CIVITELLA DI ROMAGNA",443,0,47,490,"2012","009"
"4299","CIVO",10,25,0,35,"2012","022"
"4300","CLAINO CON OSTENO",1,0,7,8,"2012","071"
"4301","CLAVESANA",384,0,0,384,"2012","071"
"4302","CLIVIO",28,60,0,88,"2012","052"
"4303","CLUSONE",59,206,0,265,"2012","077"
"4304","COASSOLO TORINESE",29,0,2,31,"2012","088"
"4305","COAZZE",17,0,7,24,"2012","089"
"4306","COAZZOLO",36,0,0,36,"2012","041"
"4307","COCCAGLIO",370,655,3,1028,"2012","056"
"4308","COCCONATO",100,0,0,100,"2012","042"
"4309","COCQUIO-TREVISAGO",21,0,0,21,"2012","053"
"4310","CODEVIGO",577,131,11,719,"2012","033"
"4311","CODEVILLA",2,0,0,2,"2012","051"
"4312","CODIGORO",4729,0,201,4930,"2012","005"
"4313","CODOGNE'",45,229,7,281,"2012","019"
"4314","CODOGNO",20,917,0,937,"2012","019"
"4315","COGGIOLA",7,0,0,7,"2012","019"
"4316","COGOLLO DEL CENGIO",453,121,0,574,"2012","032"
"4317","COLERE",1,0,0,1,"2012","078"
"4318","COLI",34,0,0,34,"2012","016"
"4319","COLICO",107,122,18,247,"2012","023"
"4320","COLLAGNA",10,59,0,69,"2012","019"
"4321","COLLE BRIANZA",17,5,3,25,"2012","024"
"4322","COLLE SANTA LUCIA",0,18,0,18,"2012","014"
"4323","COLLE UMBERTO",29,243,0,272,"2012","020"
"4324","COLLECCHIO",28,2163,0,2191,"2012","009"
"4325","COLLEGNO",111,365,13,489,"2012","090"
"4326","COLLERETTO CASTELNUOVO",2,28,0,30,"2012","091"
"4327","COLLERETTO GIACOSA",32,0,0,32,"2012","092"
"4328","COLLIO",43,87,0,130,"2012","058"
"4329","COLOGNA VENETA",9879,198,0,10077,"2012","027"
"4330","COLOGNE",414,650,0,1064,"2012","059"
"4331","COLOGNO AL SERIO",54,960,0,1014,"2012","079"
"4332","COLOGNO MONZESE",4,0,0,4,"2012","081"
"4333","COLORINA",42,423,0,465,"2012","023"
"4334","COLORNO",31,1424,0,1455,"2012","010"
"4335","COLTURANO",0,68,0,68,"2012","082"
"4336","COLZATE",13,51,0,64,"2012","080"
"4337","COMACCHIO",461,193,0,654,"2012","006"
"4338","COMAZZO",30,631,15,676,"2012","020"
"4339","COMELICO SUPERIORE",22,150,0,172,"2012","015"
"4340","COMERIO",4,0,0,4,"2012","055"
"4341","COMEZZANO-CIZZAGO",232,1715,0,1947,"2012","060"
"4342","COMIGNAGO",4,0,0,4,"2012","052"
"4343","COMMESSAGGIO",18,14,0,32,"2012","020"
"4344","COMO",12,54,7,73,"2012","075"
"4345","COMPIANO",9,7,0,16,"2012","011"
"4346","COMUN NUOVO",59,34,0,93,"2012","081"
"4347","CONA",11440,0,0,11440,"2012","010"
"4348","CONCAMARISE",2,199,0,201,"2012","029"
"4349","CONCESIO",18,45,0,63,"2012","061"
"4350","CONCO",39,226,1,266,"2012","033"
"4351","CONCORDIA SAGITTARIA",1024,306,0,1330,"2012","011"
"4352","CONCORDIA SULLA SECCHIA",210,350,79,639,"2012","010"
"4353","CONDOVE",146,26,47,219,"2012","093"
"4354","CONEGLIANO",51,103,0,154,"2012","021"
"4355","CONFIENZA",59,15,49,123,"2012","052"
"4356","CONIOLO",184,0,0,184,"2012","060"
"4357","CONSELICE",571,223,0,794,"2012","008"
"4358","CONSELVE",1558,44,0,1602,"2012","034"
"4359","CONZANO",139,0,0,139,"2012","061"
"4360","COPPARO",107,0,0,107,"2012","007"
"4361","CORBETTA",992,41,26,1059,"2012","085"
"4362","CORBOLA",90,157,0,247,"2012","017"
"4363","CORDIGNANO",117,318,0,435,"2012","022"
"4364","CORIANO",44,226,0,270,"2012","003"
"4365","CORIO",166,20,0,186,"2012","094"
"4366","CORNA IMAGNA",26,18,0,44,"2012","082"
"4367","CORNALBA",2,8,0,10,"2012","249"
"4368","CORNAREDO",43,185,12,240,"2012","087"
"4369","CORNEDO VICENTINO",25,140,0,165,"2012","034"
"4370","CORNEGLIANO LAUDENSE",0,227,0,227,"2012","021"
"4371","CORNELIANO D'ALBA",134,0,0,134,"2012","072"
"4372","CORNIGLIO",44,484,0,528,"2012","012"
"4373","CORNO GIOVINE",171,115,0,286,"2012","022"
"4374","CORNOVECCHIO",115,0,0,115,"2012","023"
"4375","CORNUDA",1423,363,0,1786,"2012","023"
"4376","CORREGGIO",9,1986,4,1999,"2012","020"
"4377","CORREZZOLA",5023,22,0,5045,"2012","035"
"4378","CORRIDO",18,3,14,35,"2012","077"
"4379","CORSIONE",5,0,0,5,"2012","044"
"4380","CORTANZE",86,0,0,86,"2012","046"
"4381","CORTAZZONE",10,0,0,10,"2012","047"
"4382","CORTE BRUGNATELLA",105,15,0,120,"2012","017"
"4383","CORTE DE' CORTESI CON CIGNONE",10,123,0,133,"2012","032"
"4384","CORTE DE' FRATI",45,940,0,985,"2012","033"
"4385","CORTE FRANCA",67,73,0,140,"2012","062"
"4386","CORTE PALASIO",8,1512,13,1533,"2012","024"
"4387","CORTEMAGGIORE",174,1650,0,1824,"2012","018"
"4388","CORTEMILIA",272,0,0,272,"2012","073"
"4389","CORTENO GOLGI",10,99,4,113,"2012","063"
"4390","CORTENOVA",7,29,0,36,"2012","025"
"4391","CORTENUOVA",216,1189,0,1405,"2012","083"
"4392","CORTEOLONA",13,0,0,13,"2012","056"
"4393","CORTIGLIONE",2,0,0,2,"2012","048"
"4394","CORTINA D'AMPEZZO",49,27,0,76,"2012","016"
"4395","CORVINO SAN QUIRICO",3,0,0,3,"2012","057"
"4396","CORZANO",125,231,0,356,"2012","064"
"4397","COSIO VALTELLINO",13,659,0,672,"2012","024"
"4398","COSSANO BELBO",430,0,0,430,"2012","074"
"4399","COSSATO",163,202,0,365,"2012","020"
"4400","COSSOGNO",4,0,0,4,"2012","023"
"4401","COSTA DE' NOBILI",90,22,21,133,"2012","058"
"4402","COSTA DI MEZZATE",38,0,0,38,"2012","084"
"4403","COSTA DI ROVIGO",1,248,0,249,"2012","018"
"4404","COSTA MASNAGA",21,11,0,32,"2012","026"
"4405","COSTA SERINA",12,7,0,19,"2012","247"
"4406","COSTA VALLE IMAGNA",4,0,0,4,"2012","085"
"4407","COSTA VESCOVATO",1,0,20,21,"2012","062"
"4408","COSTA VOLPINO",36,24,0,60,"2012","086"
"4409","COSTABISSARA",31,92,0,123,"2012","035"
"4410","COSTERMANO",30,28,0,58,"2012","030"
"4411","COSTIGLIOLE D'ASTI",597,0,0,597,"2012","050"
"4412","COSTIGLIOLE SALUZZO",539,69,0,608,"2012","075"
"4413","COTIGNOLA",92,0,0,92,"2012","009"
"4414","COVO",1045,1382,0,2427,"2012","087"
"4415","COZZO",2,0,0,2,"2012",NA
"4416","CRANDOLA VALSASSINA",8,3,0,11,"2012","027"
"4417","CRAVAGLIANA",6,12,0,18,"2012","048"
"4418","CRAVEGGIA",17,0,0,17,"2012","024"
"4419","CREAZZO",12,29,0,41,"2012","036"
"4420","CREDARO",6,151,0,157,"2012","088"
"4421","CREDERA RUBBIANO",0,1488,0,1488,"2012","034"
"4422","CREMA",520,2264,0,2784,"2012","035"
"4423","CREMELLA",7,0,0,7,"2012","028"
"4424","CREMENO",6,22,40,68,"2012","029"
"4425","CREMIA",4,3,0,7,"2012","083"
"4426","CREMOLINO",79,0,0,79,"2012","063"
"4427","CREMONA",68,1798,0,1866,"2012","036"
"4428","CREMOSANO",28,571,0,599,"2012","037"
"4429","CRESCENTINO",97,0,24,121,"2012","049"
"4430","CRESPADORO",41,76,1,118,"2012","037"
"4431","CRESPANO DEL GRAPPA",1229,635,0,1864,"2012","024"
"4432","CRESPELLANO",254,93,0,347,"2012","023"
"4433","CRESPIATICA",122,313,0,435,"2012","025"
"4434","CRESPINO",1888,0,0,1888,"2012","019"
"4435","CRESSA",28,252,0,280,"2012","055"
"4436","CREVACUORE",3,0,0,3,"2012","021"
"4437","CREVALCORE",537,29,0,566,"2012","024"
"4438","CREVOLADOSSOLA",93,50,0,143,"2012","025"
"4439","CROCETTA DEL MONTELLO",27,66,1,94,"2012","025"
"4440","CRODO",36,85,8,129,"2012","026"
"4441","CROSIO DELLA VALLE",8,0,0,8,"2012","057"
"4442","CROTTA D'ADDA",0,574,0,574,"2012","038"
"4443","CROVA",2,0,0,2,"2012","052"
"4444","CUASSO AL MONTE",16,0,0,16,"2012","058"
"4445","CUCCARO MONFERRATO",17,0,0,17,"2012","064"
"4446","CUCCIAGO",8,0,10,18,"2012","084"
"4447","CUCEGLIO",51,0,0,51,"2012","096"
"4448","CUGGIONO",512,76,0,588,"2012","096"
"4449","CUGLIATE-FABIASCO",2,0,0,2,"2012","059"
"4450","CUMIANA",1412,359,105,1876,"2012","097"
"4451","CUMIGNANO SUL NAVIGLIO",0,1314,0,1314,"2012","039"
"4452","CUNARDO",1,0,0,1,"2012","060"
"4453","CUNEO",7262,567,1894,9723,"2012","078"
"4454","CUNICO",1819,0,0,1819,"2012","051"
"4455","CUORGNE'",176,107,0,283,"2012","098"
"4456","CURA CARPIGNANO",0,235,2,237,"2012","060"
"4457","CUREGGIO",33,42,0,75,"2012","058"
"4458","CURIGLIA CON MONTEVIASCO",1,4,4,9,"2012","061"
"4459","CURINO",7,0,0,7,"2012","023"
"4460","CURNO",52,91,0,143,"2012","089"
"4461","CURSOLO-ORASSO",20,0,0,20,"2012","027"
"4462","CURTAROLO",70,209,76,355,"2012","036"
"4463","CURTATONE",3088,1178,1307,5573,"2012","021"
"4464","CUSAGO",114,279,1,394,"2012","097"
"4465","CUSINO",2,0,6,8,"2012","085"
"4466","CUSIO",3,0,0,3,"2012","090"
"4467","CUVEGLIO",14,0,0,14,"2012","062"
"4468","CUVIO",5,78,0,83,"2012","063"
"4469","DAIRAGO",18,15,0,33,"2012","099"
"4470","DALMINE",79,115,0,194,"2012","091"
"4471","DANTA DI CADORE",2,0,0,2,"2012",NA
"4472","DARFO BOARIO TERME",7,328,10,345,"2012","065"
"4473","DAVERIO",16,0,0,16,"2012","064"
"4474","DAZIO",0,16,0,16,"2012","025"
"4475","DELEBIO",35,180,0,215,"2012","026"
"4476","DELLO",787,1669,0,2456,"2012","066"
"4477","DEMONTE",1425,169,4,1598,"2012","079"
"4478","DENICE",6,0,0,6,"2012","065"
"4479","DERNICE",5,1,0,6,"2012","066"
"4480","DEROVERE",2,166,0,168,"2012","040"
"4481","DESANA",40,0,0,40,"2012","054"
"4482","DESENZANO DEL GARDA",195,1777,89,2061,"2012","067"
"4483","DIANO D'ALBA",147,0,1,148,"2012","080"
"4484","DIVIGNANO",67,0,0,67,"2012","060"
"4485","DIZZASCO",0,0,4,4,"2012","087"
"4486","DOGLIANI",1702,0,0,1702,"2012","081"
"4487","DOLO",248,236,0,484,"2012","012"
"4488","DOMASO",6,7,2,15,"2012","089"
"4489","DOMEGGE DI CADORE",0,1,0,1,"2012","018"
"4490","DOMODOSSOLA",39,13,15,67,"2012","028"
"4491","DONATO",138,0,33,171,"2012","024"
"4492","DONGO",7,2,3,12,"2012","090"
"4493","DORIO",3,0,0,3,"2012","032"
"4494","DORMELLETTO",4,0,0,4,"2012","062"
"4495","DORNO",17,41,69,127,"2012","061"
"4496","DORZANO",2,0,0,2,"2012","025"
"4497","DOSOLO",174,194,120,488,"2012","022"
"4498","DOSSENA",18,47,0,65,"2012","092"
"4499","DOSSO DEL LIRO",3,10,4,17,"2012","092"
"4500","DOVADOLA",134,0,0,134,"2012","011"
"4501","DOVERA",24,1389,0,1413,"2012","041"
"4502","DOZZA",6,28,0,34,"2012","025"
"4503","DRESANO",20,0,0,20,"2012","101"
"4504","DREZZO",0,0,4,4,"2012","093"
"4505","DRIZZONA",3,439,0,442,"2012","042"
"4506","DRONERO",2020,217,87,2324,"2012","082"
"4507","DRUENTO",610,78,69,757,"2012","099"
"4508","DRUOGNO",14,9,0,23,"2012","029"
"4509","DUBINO",11,643,1,655,"2012","027"
"4510","DUE CARRARE",169,0,0,169,"2012","106"
"4511","DUEVILLE",453,637,17,1107,"2012","038"
"4512","DUMENZA",3,0,5,8,"2012","065"
"4513","DUSINO SAN MICHELE",417,39,0,456,"2012","052"
"4514","EDOLO",9,66,3,78,"2012","068"
"4515","ELLO",6,0,0,6,"2012","033"
"4516","ELVA",16,0,8,24,"2012","083"
"4517","ENDINE GAIANO",57,124,0,181,"2012","093"
"4518","ENEGO",25,203,7,235,"2012","039"
"4519","ENTRACQUE",83,0,0,83,"2012","084"
"4520","ENTRATICO",63,9,0,72,"2012","094"
"4521","ENVIE",1815,520,71,2406,"2012","085"
"4522","ERACLEA",3776,335,0,4111,"2012","013"
"4523","ERBA",73,382,3,458,"2012","095"
"4524","ERBE'",218,36,0,254,"2012","032"
"4525","ERBEZZO",14,718,0,732,"2012","033"
"4526","ERBUSCO",231,64,0,295,"2012","069"
"4527","ERVE",4,0,0,4,"2012","034"
"4528","ESINE",2,172,2,176,"2012","070"
"4529","ESINO LARIO",18,0,0,18,"2012","035"
"4530","ESTE",780,72,0,852,"2012","037"
"4531","EUPILIO",12,34,11,57,"2012","097"
"4532","EXILLES",2,0,0,2,"2012",NA
"4533","FABBRICA CURONE",34,28,0,62,"2012","067"
"4534","FABBRICO",4,155,0,159,"2012","021"
"4535","FAEDO VALTELLINO",5,13,0,18,"2012","028"
"4536","FAENZA",263,106,0,369,"2012","010"
"4537","FAGGETO LARIO",12,0,3,15,"2012","098"
"4538","FAGNANO OLONA",23,77,9,109,"2012","067"
"4539","FALCADE",8,22,0,30,"2012","019"
"4540","FALOPPIO",2,3,33,38,"2012","099"
"4541","FANANO",80,456,0,536,"2012","011"
"4542","FARA GERA D'ADDA",178,470,0,648,"2012","096"
"4543","FARA NOVARESE",8,0,0,8,"2012","065"
"4544","FARA OLIVANA CON SOLA",563,309,0,872,"2012","097"
"4545","FARA VICENTINO",490,568,157,1215,"2012","040"
"4546","FARIGLIANO",507,0,0,507,"2012","086"
"4547","FARINI",106,121,0,227,"2012","019"
"4548","FARRA D'ALPAGO",7,128,0,135,"2012","020"
"4549","FARRA DI SOLIGO",111,59,0,170,"2012","026"
"4550","FAULE",42,142,0,184,"2012","087"
"4551","FAVRIA",362,581,0,943,"2012","101"
"4552","FEISOGLIO",77,0,0,77,"2012","088"
"4553","FELETTO",33,21,0,54,"2012","102"
"4554","FELINO",38,1076,0,1114,"2012","013"
"4555","FELIZZANO",52,0,0,52,"2012","068"
"4556","FELTRE",162,1147,0,1309,"2012","021"
"4557","FENEGRO'",30,13,39,82,"2012","100"
"4558","FENESTRELLE",15,0,0,15,"2012","103"
"4559","FERNO",1,43,0,44,"2012","068"
"4560","FERRARA",346,268,0,614,"2012","008"
"4561","FERRARA DI MONTE BALDO",28,35,0,63,"2012","034"
"4562","FERRERA DI VARESE",5,0,0,5,"2012","069"
"4563","FERRERA ERBOGNONE",42,0,0,42,"2012","062"
"4564","FERRERE",1093,0,0,1093,"2012","053"
"4565","FERRIERE",128,13,0,141,"2012","020"
"4566","FIANO",11,0,0,11,"2012","104"
"4567","FICAROLO",10,0,0,10,"2012","021"
"4568","FIDENZA",632,3392,50,4074,"2012","014"
"4569","FIESCO",29,512,0,541,"2012","043"
"4570","FIESSE",1012,403,240,1655,"2012","071"
"4571","FIESSO D'ARTICO",11,43,0,54,"2012","014"
"4572","FIESSO UMBERTIANO",120,38,0,158,"2012","022"
"4573","FIGINO SERENZA",48,80,0,128,"2012","101"
"4574","FILAGO",14,24,0,38,"2012","098"
"4575","FILIGHERA",0,155,0,155,"2012","063"
"4576","FINALE EMILIA",72,72,0,144,"2012","012"
"4577","FINO DEL MONTE",4,26,0,30,"2012","099"
"4578","FINO MORNASCO",17,0,2,19,"2012","102"
"4579","FIORANO AL SERIO",11,18,0,29,"2012","100"
"4580","FIORANO CANAVESE",12,0,0,12,"2012","105"
"4581","FIORANO MODENESE",21,61,0,82,"2012","013"
"4582","FIORENZUOLA D'ARDA",156,1883,0,2039,"2012","021"
"4583","FIUMALBO",123,70,0,193,"2012","014"
"4584","FLERO",331,426,0,757,"2012","072"
"4585","FOBELLO",8,2,0,10,"2012","057"
"4586","FOGLIZZO",159,0,0,159,"2012","106"
"4587","FOLLINA",184,100,0,284,"2012","027"
"4588","FOMBIO",214,286,0,500,"2012","026"
"4589","FONTANELICE",233,146,0,379,"2012","026"
"4590","FONTANELLA",3324,2411,0,5735,"2012","101"
"4591","FONTANELLATO",145,2350,0,2495,"2012","015"
"4592","FONTANELLE",102,731,19,852,"2012","028"
"4593","FONTANETO D'AGOGNA",11,73,0,84,"2012","066"
"4594","FONTANETTO PO",2,0,0,2,"2012","058"
"4595","FONTANILE",4,0,0,4,"2012","054"
"4596","FONTANIVA",264,367,0,631,"2012","038"
"4597","FONTE",1276,595,0,1871,"2012","029"
"4598","FONTENO",13,5,0,18,"2012","102"
"4599","FONTEVIVO",0,1276,0,1276,"2012","016"
"4600","FONZASO",58,52,0,110,"2012","022"
"4601","FOPPOLO",0,21,0,21,"2012","103"
"4602","FORCOLA",9,153,0,162,"2012","029"
"4603","FORESTO SPARSO",20,77,0,97,"2012","104"
"4604","FORLI'",598,106,63,767,"2012","012"
"4605","FORLIMPOPOLI",94,17,0,111,"2012","013"
"4606","FORMAZZA",2,17,15,34,"2012","031"
"4607","FORMIGARA",0,1027,202,1229,"2012","044"
"4608","FORMIGINE",28,1711,2,1741,"2012","015"
"4609","FORMIGLIANA",26,0,0,26,"2012","059"
"4610","FORMIGNANA",8,0,0,8,"2012","009"
"4611","FORNO CANAVESE",62,0,0,62,"2012","107"
"4612","FORNO DI ZOLDO",14,0,0,14,"2012","024"
"4613","FORNOVO DI TARO",22,388,0,410,"2012","017"
"4614","FORNOVO SAN GIOVANNI",20,809,0,829,"2012","105"
"4615","FORTUNAGO",45,0,0,45,"2012","064"
"4616","FOSSALTA DI PIAVE",7,0,0,7,"2012","015"
"4617","FOSSALTA DI PORTOGRUARO",1,899,0,900,"2012","016"
"4618","FOSSANO",17514,3825,1171,22510,"2012","089"
"4619","FOSSO'",101,23,0,124,"2012","017"
"4620","FOZA",55,59,6,120,"2012","041"
"4621","FRABOSA SOPRANA",204,205,0,409,"2012","090"
"4622","FRABOSA SOTTANA",426,1,34,461,"2012","091"
"4623","FRACONALTO",10,0,0,10,"2012","069"
"4624","FRASCARO",6,60,0,66,"2012","071"
"4625","FRASCAROLO",120,54,0,174,"2012","065"
"4626","FRASSINELLE POLESINE",413,0,0,413,"2012","023"
"4627","FRASSINELLO MONFERRATO",53,0,0,53,"2012","072"
"4628","FRASSINETO PO",33,0,0,33,"2012","073"
"4629","FRASSINETTO",108,11,0,119,"2012","108"
"4630","FRASSINO",30,3,0,33,"2012","092"
"4631","FRASSINORO",104,181,2,287,"2012","016"
"4632","FRATTA POLESINE",21,96,25,142,"2012","024"
"4633","FREGONA",14,43,0,57,"2012","030"
"4634","FRESONARA",22,0,0,22,"2012","074"
"4635","FRINCO",232,0,0,232,"2012","055"
"4636","FRONT",82,0,0,82,"2012","109"
"4637","FROSSASCO",2014,0,78,2092,"2012","110"
"4638","FRUGAROLO",189,140,0,329,"2012","075"
"4639","FUBINE",363,0,0,363,"2012","076"
"4640","FUIPIANO VALLE IMAGNA",4,50,0,54,"2012","106"
"4641","FUMANE",19,22,8,49,"2012","035"
"4642","FUSIGNANO",5,0,0,5,"2012","011"
"4643","FUSINE",0,33,0,33,"2012","030"
"4644","GABBIONETA-BINANUOVA",172,586,0,758,"2012","045"
"4645","GABIANO",86,0,0,86,"2012","077"
"4646","GADESCO-PIEVE DELMONA",2,385,60,447,"2012","046"
"4647","GAGGIANO",105,488,0,593,"2012","103"
"4648","GAGGIO MONTANO",252,367,0,619,"2012","027"
"4649","GAGLIANICO",3,0,0,3,"2012","026"
"4650","GAIARINE",808,2,0,810,"2012","031"
"4651","GAIBA",16,0,0,16,"2012","025"
"4652","GAIOLA",0,2,0,2,"2012","093"
"4653","GALBIATE",53,10,0,63,"2012","036"
"4654","GALEATA",205,0,28,233,"2012","014"
"4655","GALGAGNANO",0,782,0,782,"2012","027"
"4656","GALLARATE",6,51,0,57,"2012","070"
"4657","GALLIATE",44,22,0,66,"2012","068"
"4658","GALLIATE LOMBARDO",7,0,0,7,"2012","071"
"4659","GALLIERA",13,37,0,50,"2012","028"
"4660","GALLIERA VENETA",2214,110,0,2324,"2012","039"
"4661","GALLIO",19,208,0,227,"2012","042"
"4662","GALZIGNANO TERME",28,0,0,28,"2012","040"
"4663","GAMALERO",28,0,0,28,"2012","078"
"4664","GAMBARA",5163,1812,213,7188,"2012","073"
"4665","GAMBARANA",0,1,0,1,"2012","067"
"4666","GAMBASCA",4,0,0,4,"2012","094"
"4667","GAMBOLO'",82,159,0,241,"2012","068"
"4668","GAMBUGLIANO",5,42,0,47,"2012","044"
"4669","GANDELLINO",15,0,0,15,"2012","107"
"4670","GANDINO",54,128,0,182,"2012","108"
"4671","GANDOSSO",3,30,0,33,"2012","109"
"4672","GARBAGNA",155,0,0,155,"2012","079"
"4673","GARBAGNA NOVARESE",1,1,0,2,"2012","069"
"4674","GARBAGNATE MONASTERO",8,0,0,8,"2012","037"
"4675","GARDA",3,0,0,3,"2012","036"
"4676","GARDONE RIVIERA",12,0,0,12,"2012","074"
"4677","GARDONE VAL TROMPIA",38,0,0,38,"2012","075"
"4678","GARESSIO",158,0,0,158,"2012","095"
"4679","GARGALLO",1,0,0,1,"2012","070"
"4680","GARGNANO",25,0,41,66,"2012","076"
"4681","GARLASCO",10,0,0,10,"2012","069"
"4682","GARLATE",2,0,0,2,"2012","038"
"4683","GARZENO",16,5,14,35,"2012","106"
"4684","GARZIGLIANA",354,0,39,393,"2012","111"
"4685","GASSINO TORINESE",42,3,0,45,"2012","112"
"4686","GATTATICO",16,2240,0,2256,"2012","022"
"4687","GATTEO",1,0,0,1,"2012","016"
"4688","GATTICO",34,117,159,310,"2012","071"
"4689","GATTINARA",46,0,0,46,"2012","061"
"4690","GAVARDO",121,391,0,512,"2012","077"
"4691","GAVERINA TERME",24,39,0,63,"2012","110"
"4692","GAVI",42,0,0,42,"2012","081"
"4693","GAVIRATE",52,0,0,52,"2012","072"
"4694","GAZOLDO DEGLI IPPOLITI",348,85,11,444,"2012","024"
"4695","GAZZADA SCHIANNO",10,8,0,18,"2012","073"
"4696","GAZZANIGA",22,68,0,90,"2012","111"
"4697","GAZZO",123,3003,0,3126,"2012","041"
"4698","GAZZO VERONESE",1378,301,0,1679,"2012","037"
"4699","GAZZOLA",138,1248,0,1386,"2012","022"
"4700","GAZZUOLO",729,33,0,762,"2012","025"
"4701","GEMMANO",27,61,0,88,"2012","004"
"4702","GEMONIO",5,0,3,8,"2012","074"
"4703","GENIVOLTA",26,1856,46,1928,"2012","047"
"4704","GENOLA",1929,1219,94,3242,"2012","096"
"4705","GENZONE",160,66,0,226,"2012","070"
"4706","GERA LARIO",72,217,0,289,"2012","107"
"4707","GERENZAGO",0,59,0,59,"2012","071"
"4708","GERENZANO",81,81,0,162,"2012","075"
"4709","GERMAGNANO",10,1,0,11,"2012","113"
"4710","GERMAGNO",1,0,0,1,"2012","032"
"4711","GERMIGNAGA",12,50,0,62,"2012","076"
"4712","GEROSA",17,9,0,26,"2012","112"
"4713","GERRE DE' CAPRIOLI",0,340,0,340,"2012","048"
"4714","GESSATE",47,376,0,423,"2012","106"
"4715","GHEDI",3839,6067,27,9933,"2012","078"
"4716","GHEMME",7,0,0,7,"2012","073"
"4717","GHIFFA",3,0,0,3,"2012","033"
"4718","GHISALBA",17,718,0,735,"2012","113"
"4719","GHISLARENGO",12,0,0,12,"2012","062"
"4720","GIACCIANO CON BARUCHELLA",2,0,15,17,"2012","027"
"4721","GIAGLIONE",17,0,0,17,"2012","114"
"4722","GIANICO",99,159,87,345,"2012","079"
"4723","GIAVENO",237,451,141,829,"2012","115"
"4724","GIAVERA DEL MONTELLO",559,143,4,706,"2012","032"
"4725","GIFFLENGA",1,0,0,1,"2012","027"
"4726","GIGNESE",5,0,1,6,"2012","034"
"4727","GIRONICO",36,76,8,120,"2012","109"
"4728","GIUSSAGO",46,193,0,239,"2012","072"
"4729","GIVOLETTO",23,0,0,23,"2012","116"
"4730","GODEGA DI SANT'URBANO",45,127,0,172,"2012","033"
"4731","GODIASCO",10,0,0,10,"2012","073"
"4732","GOITO",3635,4479,1198,9312,"2012","026"
"4733","GOLASECCA",27,30,0,57,"2012","077"
"4734","GOLFERENZO",0,0,16,16,"2012","074"
"4735","GOMBITO",7,767,0,774,"2012","049"
"4736","GONZAGA",18741,2988,1963,23692,"2012","027"
"4737","GORDONA",91,131,2,224,"2012","032"
"4738","GORGO AL MONTICANO",70,375,0,445,"2012","034"
"4739","GORGONZOLA",14,323,0,337,"2012","108"
"4740","GORLA MAGGIORE",8,178,0,186,"2012","078"
"4741","GORLA MINORE",61,0,0,61,"2012","079"
"4742","GORLAGO",53,303,0,356,"2012","114"
"4743","GORLE",1,0,0,1,"2012","115"
"4744","GORNATE-OLONA",12,0,1,13,"2012","080"
"4745","GORNO",32,73,0,105,"2012","116"
"4746","GORZEGNO",42,0,0,42,"2012","097"
"4747","GOSSOLENGO",73,512,0,585,"2012","023"
"4748","GOTTASECCA",43,0,0,43,"2012","098"
"4749","GOTTOLENGO",11277,1439,65,12781,"2012","080"
"4750","GOVONE",237,0,72,309,"2012","099"
"4751","GOZZANO",13,0,0,13,"2012","076"
"4752","GRAFFIGNANA",49,157,115,321,"2012","028"
"4753","GRAGLIA",138,11,80,229,"2012","028"
"4754","GRAGNANO TREBBIENSE",29,2142,0,2171,"2012","024"
"4755","GRANA",57,0,0,57,"2012","056"
"4756","GRANAGLIONE",4,0,0,4,"2012","029"
"4757","GRANAROLO DELL'EMILIA",19,179,0,198,"2012","030"
"4758","GRANCONA",37,148,0,185,"2012","045"
"4759","GRANDOLA ED UNITI",5,40,12,57,"2012","111"
"4760","GRANOZZO CON MONTICELLO",1,45,0,46,"2012","077"
"4761","GRANTOLA",60,0,0,60,"2012","081"
"4762","GRANTORTO",73,949,0,1022,"2012","042"
"4763","GRANZE",771,0,0,771,"2012","043"
"4764","GRASSOBBIO",11,187,0,198,"2012","117"
"4765","GRAVEDONA ED UNITI",16,25,90,131,"2012","249"
"4766","GRAVELLONA LOMELLINA",10,0,0,10,"2012","075"
"4767","GRAVELLONA TOCE",26,0,0,26,"2012","035"
"4768","GRAZZANO BADOGLIO",415,0,0,415,"2012","057"
"4769","GREMIASCO",36,0,0,36,"2012","083"
"4770","GREZZAGO",8,0,0,8,"2012","110"
"4771","GREZZANA",181,773,0,954,"2012","038"
"4772","GRIANTE",1,0,5,6,"2012","113"
"4773","GRIGNASCO",4,48,0,52,"2012","079"
"4774","GRINZANE CAVOUR",66,0,0,66,"2012","100"
"4775","GRISIGNANO DI ZOCCO",47,700,7,754,"2012","046"
"4776","GRIZZANA MORANDI",61,0,0,61,"2012","031"
"4777","GROMO",56,88,9,153,"2012","118"
"4778","GRONDONA",7,0,0,7,"2012","085"
"4779","GRONE",26,26,0,52,"2012","119"
"4780","GRONTARDO",0,1973,0,1973,"2012","050"
"4781","GROPELLO CAIROLI",54,0,0,54,"2012","076"
"4782","GROPPARELLO",106,23,0,129,"2012","025"
"4783","GROSCAVALLO",23,0,13,36,"2012","118"
"4784","GROSIO",29,195,5,229,"2012","033"
"4785","GROSOTTO",18,43,0,61,"2012","034"
"4786","GROSSO",53,0,0,53,"2012","119"
"4787","GRUARO",10,143,0,153,"2012","018"
"4788","GRUGLIASCO",134,32,51,217,"2012","120"
"4789","GRUMELLO CREMONESE ED UNITI",26,1171,213,1410,"2012","051"
"4790","GRUMELLO DEL MONTE",414,116,0,530,"2012","120"
"4791","GRUMOLO DELLE ABBADESSE",74,262,0,336,"2012","047"
"4792","GUALTIERI",1237,552,15,1804,"2012","023"
"4793","GUANZATE",31,0,2,33,"2012","114"
"4794","GUARDA VENETA",668,0,0,668,"2012","028"
"4795","GUARDABOSONE",34,19,0,53,"2012","066"
"4796","GUARDAMIGLIO",0,340,0,340,"2012","029"
"4797","GUARENE",346,0,0,346,"2012","101"
"4798","GUASTALLA",44,1099,10,1153,"2012","024"
"4799","GUDO VISCONTI",19,0,0,19,"2012","112"
"4800","GUIDIZZOLO",923,766,232,1921,"2012","028"
"4801","GUIGLIA",62,553,0,615,"2012","017"
"4802","GUSSAGO",104,751,0,855,"2012","081"
"4803","GUSSOLA",8,48,0,56,"2012","052"
"4804","IDRO",3,0,0,3,"2012","082"
"4805","IESOLO",31,46,1,78,"2012","019"
"4806","IGLIANO",60,0,17,77,"2012","102"
"4807","ILLASI",0,60,0,60,"2012","039"
"4808","IMBERSAGO",2,0,0,2,"2012","039"
"4809","IMOLA",111,21,0,132,"2012","032"
"4810","INARZO",8,0,0,8,"2012","082"
"4811","INCISA SCAPACCINO",39,0,0,39,"2012","058"
"4812","INCUDINE",4,2,0,6,"2012","083"
"4813","INDUNO OLONA",12,63,0,75,"2012","083"
"4814","INTRAGNA",2,0,0,2,"2012","037"
"4815","INTROBIO",43,19,0,62,"2012","040"
"4816","INTROZZO",1,0,0,1,"2012","041"
"4817","INVERIGO",88,0,21,109,"2012","118"
"4818","INVERNO E MONTELEONE",92,176,0,268,"2012","077"
"4819","INVERSO PINASCA",25,0,0,25,"2012","122"
"4820","INVERUNO",25,167,0,192,"2012","113"
"4821","INVORIO",45,130,0,175,"2012","082"
"4822","INZAGO",87,722,30,839,"2012","114"
"4823","IRMA",11,0,2,13,"2012","084"
"4824","ISASCA",9,0,0,9,"2012","103"
"4825","ISEO",53,26,0,79,"2012","085"
"4826","ISOLA D'ASTI",307,0,0,307,"2012","059"
"4827","ISOLA DELLA SCALA",4411,287,0,4698,"2012","040"
"4828","ISOLA DI FONDRA",2,20,0,22,"2012","121"
"4829","ISOLA DOVARESE",0,477,0,477,"2012","053"
"4830","ISOLA RIZZA",2040,429,0,2469,"2012","041"
"4831","ISOLA SANT'ANTONIO",1,0,0,1,"2012","087"
"4832","ISOLA VICENTINA",1890,639,85,2614,"2012","048"
"4833","ISOLABELLA",119,405,0,524,"2012","123"
"4834","ISORELLA",11813,680,13,12506,"2012","086"
"4835","ISPRA",79,129,0,208,"2012","084"
"4836","ISSIGLIO",56,24,0,80,"2012","124"
"4837","ISSO",8,1140,0,1148,"2012","122"
"4838","ISTRANA",3031,373,17,3421,"2012","035"
"4839","IVREA",216,205,0,421,"2012","125"
"4840","IZANO",29,948,0,977,"2012","054"
"4841","JERAGO CON ORAGO",2,0,0,2,"2012","085"
"4842","JOLANDA DI SAVOIA",72,0,0,72,"2012","010"
"4843","LA CASSA",3,0,329,332,"2012","126"
"4844","LA LOGGIA",290,0,65,355,"2012","127"
"4845","LA MORRA",105,0,0,105,"2012","105"
"4846","LA VALLE AGORDINA",12,37,0,49,"2012","027"
"4847","LACCHIARELLA",13,91,0,104,"2012","115"
"4848","LAGNASCO",31,17,0,48,"2012","104"
"4849","LAGOSANTO",52,0,0,52,"2012","011"
"4850","LAINATE",16,0,6,22,"2012","116"
"4851","LAINO",1,4,0,5,"2012","120"
"4852","LAMA MOCOGNO",105,425,0,530,"2012","018"
"4853","LAMBRUGO",0,68,0,68,"2012","121"
"4854","LAMON",6,32,0,38,"2012","026"
"4855","LAMPORO",24,0,0,24,"2012","067"
"4856","LANDRIANO",29,248,0,277,"2012","078"
"4857","LANGHIRANO",0,880,0,880,"2012","018"
"4858","LANGOSCO",4,0,0,4,"2012","079"
"4859","LANZADA",18,71,0,89,"2012","036"
"4860","LANZO D'INTELVI",9,7,1,17,"2012","122"
"4861","LANZO TORINESE",127,0,0,127,"2012","128"
"4862","LASNIGO",7,29,0,36,"2012","123"
"4863","LAURIANO",10,0,0,10,"2012","129"
"4864","LAVENA PONTE TRESA",3,0,0,3,"2012","086"
"4865","LAVENO-MOMBELLO",17,0,0,17,"2012","087"
"4866","LAVENONE",23,6,0,29,"2012","087"
"4867","LAZISE",39,106,6,151,"2012","043"
"4868","LECCO",14,59,7,80,"2012","042"
"4869","LEFFE",55,63,0,118,"2012","124"
"4870","LEGGIUNO",7,0,0,7,"2012","088"
"4871","LEGNAGO",116,23,0,139,"2012","044"
"4872","LEGNANO",0,59,0,59,"2012","118"
"4873","LEGNARO",108,29,96,233,"2012","044"
"4874","LEINI'",456,732,0,1188,"2012","130"
"4875","LEMIE",16,58,0,74,"2012","131"
"4876","LENDINARA",600,202,0,802,"2012","029"
"4877","LENNA",4,8,0,12,"2012","125"
"4878","LENNO",15,0,0,15,"2012","125"
"4879","LENO",4235,6279,824,11338,"2012","088"
"4880","LENTA",1,28,0,29,"2012","068"
"4881","LENTIAI",100,93,0,193,"2012","028"
"4882","LEQUIO BERRIA",57,0,0,57,"2012","106"
"4883","LEQUIO TANARO",1088,69,0,1157,"2012","107"
"4884","LERMA",16,0,0,16,"2012","088"
"4885","LESA",5,0,0,5,"2012","084"
"4886","LESEGNO",556,0,0,556,"2012","108"
"4887","LESIGNANO DE' BAGNI",20,1112,0,1132,"2012","019"
"4888","LESSOLO",121,2,0,123,"2012","132"
"4889","LESSONA",5,15,0,20,"2012","029"
"4890","LEVATE",0,30,0,30,"2012","126"
"4891","LEVICE",111,5,0,116,"2012","109"
"4892","LEZZENO",4,0,0,4,"2012","126"
"4893","LIERNA",7,0,0,7,"2012","043"
"4894","LIGNANA",1,0,0,1,"2012","070"
"4895","LIGONCHIO",24,62,0,86,"2012","025"
"4896","LIMANA",20,131,0,151,"2012","029"
"4897","LIMENA",625,433,98,1156,"2012","045"
"4898","LIMIDO COMASCO",3,22,1,26,"2012","128"
"4899","LIMONE PIEMONTE",62,0,0,62,"2012","110"
"4900","LINAROLO",137,253,0,390,"2012","081"
"4901","LIPOMO",1,0,0,1,"2012",NA
"4902","LIRIO",20,0,0,20,"2012","082"
"4903","LISCATE",29,0,0,29,"2012","122"
"4904","LISIO",59,0,0,59,"2012","111"
"4905","LIVIGNO",31,309,10,350,"2012","037"
"4906","LIVINALLONGO DEL COL DI LANA",1,69,0,70,"2012","030"
"4907","LIVO",5,0,0,5,"2012","130"
"4908","LIVORNO FERRARIS",132,38,0,170,"2012","071"
"4909","LIVRAGA",31,1225,64,1320,"2012","030"
"4910","LIZZANO IN BELVEDERE",51,65,47,163,"2012","033"
"4911","LOAZZOLO",10,0,0,10,"2012","060"
"4912","LOCANA",132,185,0,317,"2012","134"
"4913","LOCATE DI TRIULZI",0,1090,0,1090,"2012","125"
"4914","LOCATE VARESINO",9,0,0,9,"2012","131"
"4915","LOCATELLO",32,19,0,51,"2012","127"
"4916","LODI",391,1260,56,1707,"2012","031"
"4917","LODI VECCHIO",0,986,0,986,"2012","032"
"4918","LODRINO",24,0,0,24,"2012","090"
"4919","LOGRATO",637,835,0,1472,"2012","091"
"4920","LOIANO",32,354,0,386,"2012","034"
"4921","LOMAGNA",1,0,0,1,"2012","044"
"4922","LOMAZZO",1,42,0,43,"2012","133"
"4923","LOMBARDORE",49,0,0,49,"2012","135"
"4924","LOMBRIASCO",80,96,0,176,"2012","136"
"4925","LOMELLO",4,75,0,79,"2012","083"
"4926","LONATE CEPPINO",2,231,2,235,"2012","089"
"4927","LONATE POZZOLO",22,0,6,28,"2012","090"
"4928","LONATO",3050,4237,127,7414,"2012","092"
"4929","LONGARE",82,225,0,307,"2012","051"
"4930","LONGARONE",1,0,0,1,"2012","031"
"4931","LONGHENA",0,270,0,270,"2012","093"
"4932","LONGIANO",14,0,0,14,"2012","018"
"4933","LONIGO",5502,495,7,6004,"2012","052"
"4934","LORANZE'",12,26,0,38,"2012","137"
"4935","LOREGGIA",407,449,0,856,"2012","046"
"4936","LOREGLIA",5,0,0,5,"2012","038"
"4937","LORENZAGO DI CADORE",2,0,0,2,"2012","032"
"4938","LOREO",851,159,0,1010,"2012","030"
"4939","LORIA",7138,29,4,7171,"2012","036"
"4940","LOSINE",0,19,0,19,"2012","094"
"4941","LOVERE",21,14,0,35,"2012","128"
"4942","LOVERO",2,10,0,12,"2012","038"
"4943","LOZZA",0,136,0,136,"2012","091"
"4944","LOZZO ATESTINO",1772,6,4,1782,"2012","047"
"4945","LOZZO DI CADORE",4,0,0,4,"2012","033"
"4946","LOZZOLO",27,0,0,27,"2012","072"
"4947","LU",67,0,0,67,"2012","089"
"4948","LUGAGNANO VAL D'ARDA",37,201,0,238,"2012","026"
"4949","LUGNACCO",0,3,0,3,"2012","138"
"4950","LUGO",476,101,0,577,"2012","012"
"4951","LUGO DI VICENZA",20,137,0,157,"2012","053"
"4952","LUINO",15,23,0,38,"2012","092"
"4953","LUISAGO",13,0,0,13,"2012","135"
"4954","LUMEZZANE",26,0,0,26,"2012","096"
"4955","LURAGO D'ERBA",4,0,0,4,"2012","136"
"4956","LURAGO MARINONE",0,89,0,89,"2012","137"
"4957","LURANO",25,0,0,25,"2012","129"
"4958","LURATE CACCIVIO",24,0,78,102,"2012","138"
"4959","LUSERNA SAN GIOVANNI",409,61,56,526,"2012","139"
"4960","LUSERNETTA",85,0,0,85,"2012","140"
"4961","LUSIA",26,0,0,26,"2012","031"
"4962","LUSIANA",29,84,0,113,"2012","054"
"4963","LUSIGLIE'",71,0,0,71,"2012","141"
"4964","LUVINATE",1,0,0,1,"2012","093"
"4965","LUZZANA",14,0,0,14,"2012","130"
"4966","LUZZARA",1514,1552,0,3066,"2012","026"
"4967","MACCAGNO",0,4,0,4,"2012","094"
"4968","MACCASTORNA",459,0,0,459,"2012","033"
"4969","MACELLO",1273,258,279,1810,"2012","142"
"4970","MACLODIO",127,257,0,384,"2012","097"
"4971","MACUGNAGA",1,7,0,8,"2012","039"
"4972","MADESIMO",0,4,0,4,"2012","035"
"4973","MADIGNANO",23,514,0,537,"2012","055"
"4974","MADONE",28,0,0,28,"2012","131"
"4975","MADONNA DEL SASSO",14,0,0,14,"2012","040"
"4976","MAGASA",8,15,0,23,"2012","098"
"4977","MAGENTA",45,641,0,686,"2012","130"
"4978","MAGGIORA",120,28,0,148,"2012","088"
"4979","MAGHERNO",0,84,0,84,"2012","085"
"4980","MAGLIANO ALFIERI",623,0,0,623,"2012","113"
"4981","MAGLIANO ALPI",536,128,0,664,"2012","114"
"4982","MAGNACAVALLO",53,248,354,655,"2012","029"
"4983","MAGNAGO",64,0,0,64,"2012","131"
"4984","MAGNANO",19,9,0,28,"2012","030"
"4985","MAIOLO",88,4,0,92,"2012","022"
"4986","MAIRAGO",6,522,0,528,"2012","034"
"4987","MAIRANO",186,649,17,852,"2012","099"
"4988","MALAGNINO",100,667,0,767,"2012","056"
"4989","MALCESINE",20,92,0,112,"2012","045"
"4990","MALEGNO",4,48,6,58,"2012","100"
"4991","MALEO",153,1388,0,1541,"2012","035"
"4992","MALESCO",5,22,9,36,"2012","041"
"4993","MALGESSO",32,0,0,32,"2012","095"
"4994","MALNATE",32,34,0,66,"2012","096"
"4995","MALO",2320,331,0,2651,"2012","055"
"4996","MALONNO",14,262,3,279,"2012","101"
"4997","MALVICINO",5,5,0,10,"2012","090"
"4998","MANDELLO DEL LARIO",17,0,0,17,"2012","046"
"4999","MANDELLO VITTA",2,0,0,2,"2012","090"
"5000","MANERBA DEL GARDA",23,0,13,36,"2012","102"
"5001","MANERBIO",1149,1312,0,2461,"2012","103"
"5002","MANGO",15,0,14,29,"2012","115"
"5003","MANSUE'",75,369,10,454,"2012","037"
"5004","MANTA",4,0,0,4,"2012","116"
"5005","MANTELLO",7,94,0,101,"2012","039"
"5006","MANTOVA",386,414,458,1258,"2012","030"
"5007","MAPELLO",26,18,0,44,"2012","132"
"5008","MARANELLO",10,549,0,559,"2012","019"
"5009","MARANO DI VALPOLICELLA",39,82,5,126,"2012","046"
"5010","MARANO SUL PANARO",63,743,0,806,"2012","020"
"5011","MARANO TICINO",5,257,0,262,"2012","091"
"5012","MARANO VICENTINO",186,289,0,475,"2012","056"
"5013","MARCALLO CON CASONE",2,222,0,224,"2012","134"
"5014","MARCARIA",2180,2116,1947,6243,"2012","031"
"5015","MARCHENO",9,5,0,14,"2012","104"
"5016","MARCHIROLO",3,0,0,3,"2012","097"
"5017","MARCIGNAGO",36,0,0,36,"2012","086"
"5018","MARCON",752,82,0,834,"2012","020"
"5019","MARENE",3368,1892,159,5419,"2012","117"
"5020","MARENO DI PIAVE",1277,223,0,1500,"2012","038"
"5021","MARENTINO",113,0,33,146,"2012","144"
"5022","MARETTO",175,0,0,175,"2012","062"
"5023","MARGARITA",805,0,0,805,"2012","118"
"5024","MARGNO",2,11,0,13,"2012","047"
"5025","MARIANA MANTOVANA",85,301,39,425,"2012","032"
"5026","MARIANO COMENSE",568,91,0,659,"2012","143"
"5027","MARMENTINO",32,10,1,43,"2012","105"
"5028","MARMIROLO",3337,2383,2527,8247,"2012","033"
"5029","MARMORA",41,80,0,121,"2012","119"
"5030","MARONE",39,47,0,86,"2012","106"
"5031","MAROSTICA",230,682,0,912,"2012","057"
"5032","MARSAGLIA",175,0,0,175,"2012","120"
"5033","MARTELLAGO",43,16,8,67,"2012","021"
"5034","MARTIGNANA DI PO",1,0,0,1,"2012","057"
"5035","MARTINENGO",666,2447,0,3113,"2012","133"
"5036","MARTINIANA PO",70,98,0,168,"2012","121"
"5037","MARUDO",0,297,0,297,"2012","036"
"5038","MARZABOTTO",3,76,46,125,"2012","036"
"5039","MARZANO",33,187,0,220,"2012","087"
"5040","MARZIO",0,0,3,3,"2012","099"
"5041","MASATE",0,0,152,152,"2012","136"
"5042","MASCIAGO PRIMO",29,0,0,29,"2012","100"
"5043","MASER",4183,49,0,4232,"2012","039"
"5044","MASERA",18,68,2,88,"2012","042"
"5045","MASERA' DI PADOVA",270,55,135,460,"2012","048"
"5046","MASERADA SUL PIAVE",2289,116,0,2405,"2012","040"
"5047","MASI",52,0,0,52,"2012","049"
"5048","MASI TORELLO",5,66,0,71,"2012","012"
"5049","MASIO",334,0,0,334,"2012","091"
"5050","MASON VICENTINO",89,438,12,539,"2012","058"
"5051","MASSA LOMBARDA",14,0,0,14,"2012","013"
"5052","MASSALENGO",0,178,0,178,"2012","037"
"5053","MASSANZAGO",619,134,0,753,"2012","050"
"5054","MASSAZZA",16,22,0,38,"2012","031"
"5055","MASSELLO",4,0,0,4,"2012","145"
"5056","MASSERANO",96,0,0,96,"2012","032"
"5057","MASSINO VISCONTI",10,38,0,48,"2012","093"
"5058","MASSIOLA",1,0,0,1,"2012","043"
"5059","MATHI",100,0,0,100,"2012","146"
"5060","MATTIE",7,0,0,7,"2012","147"
"5061","MAZZANO",122,763,0,885,"2012","107"
"5062","MAZZE'",1353,0,0,1353,"2012","148"
"5063","MAZZO DI VALTELLINA",2,28,5,35,"2012","040"
"5064","MEANA DI SUSA",4,0,0,4,"2012","149"
"5065","MEDE",19,65,0,84,"2012","088"
"5066","MEDESANO",87,1245,0,1332,"2012","020"
"5067","MEDICINA",296,126,0,422,"2012","037"
"5068","MEDIGLIA",16,1398,0,1414,"2012","139"
"5069","MEDOLAGO",10,0,0,10,"2012","250"
"5070","MEDOLE",908,682,556,2146,"2012","034"
"5071","MEDOLLA",5,447,0,452,"2012","021"
"5072","MEDUNA DI LIVENZA",21,19,0,40,"2012","041"
"5073","MEGLIADINO SAN FIDENZIO",927,0,0,927,"2012","051"
"5074","MEGLIADINO SAN VITALE",1426,0,0,1426,"2012","052"
"5075","MEL",63,309,0,372,"2012","034"
"5076","MELARA",232,0,0,232,"2012","032"
"5077","MELAZZO",207,0,0,207,"2012","092"
"5078","MELDOLA",185,93,0,278,"2012","019"
"5079","MELEGNANO",2,65,0,67,"2012","140"
"5080","MELETI",59,424,0,483,"2012","038"
"5081","MELLE",257,32,0,289,"2012","122"
"5082","MELLO",21,52,0,73,"2012","041"
"5083","MELZO",14,309,0,323,"2012","142"
"5084","MENAGGIO",2,0,0,2,"2012","145"
"5085","MENCONICO",24,0,0,24,"2012","089"
"5086","MEOLO",1492,122,0,1614,"2012","022"
"5087","MERANA",384,0,0,384,"2012","093"
"5088","MERATE",136,300,36,472,"2012","048"
"5089","MERCATO SARACENO",215,17,3,235,"2012","020"
"5090","MERCENASCO",324,0,0,324,"2012","150"
"5091","MERGOZZO",21,0,0,21,"2012","044"
"5092","MERLARA",608,9,0,617,"2012","053"
"5093","MERLINO",17,822,0,839,"2012","039"
"5094","MERONE",21,74,0,95,"2012","147"
"5095","MESE",17,42,0,59,"2012","043"
"5096","MESENZANA",1,20,0,21,"2012","102"
"5097","MESERO",0,71,6,77,"2012","144"
"5098","MESOLA",2083,213,0,2296,"2012","014"
"5099","MESTRINO",96,150,22,268,"2012","054"
"5100","MEUGLIANO",10,0,0,10,"2012","151"
"5101","MEZZANA BIGLI",73,0,0,73,"2012","090"
"5102","MEZZANE DI SOTTO",4,18,0,22,"2012","047"
"5103","MEZZANI",10,406,0,416,"2012","021"
"5104","MEZZANINO",7,0,0,7,"2012","092"
"5105","MEZZEGRA",7,4,12,23,"2012","148"
"5106","MEZZENILE",32,40,0,72,"2012","152"
"5107","MEZZOLDO",5,25,0,30,"2012","134"
"5108","MEZZOMERICO",7,0,0,7,"2012","097"
"5109","MIAGLIANO",9,0,0,9,"2012","034"
"5110","MIANE",20,8,0,28,"2012","042"
"5111","MIASINO",0,0,22,22,"2012","098"
"5112","MIAZZINA",2,0,0,2,"2012","045"
"5113","MIGLIARINO",1631,0,0,1631,"2012","015"
"5114","MIGLIARO",1579,92,0,1671,"2012","026"
"5115","MILANO",359,119,0,478,"2012","146"
"5116","MILZANO",2,814,0,816,"2012","108"
"5117","MINERBE",2649,252,0,2901,"2012","048"
"5118","MINERBIO",65,0,0,65,"2012","038"
"5119","MIRA",1360,667,8,2035,"2012","023"
"5120","MIRABELLO MONFERRATO",80,0,0,80,"2012","094"
"5121","MIRADOLO TERME",29,82,0,111,"2012","093"
"5122","MIRANDOLA",221,902,0,1123,"2012","022"
"5123","MIRANO",704,729,17,1450,"2012","024"
"5124","MISANO ADRIATICO",13,0,0,13,"2012","005"
"5125","MISANO DI GERA D'ADDA",23,186,0,209,"2012","135"
"5126","MISSAGLIA",24,211,279,514,"2012","049"
"5127","MODENA",791,2463,0,3254,"2012","023"
"5128","MODIGLIANA",107,1,11,119,"2012","022"
"5129","MOGLIA",4138,838,475,5451,"2012","035"
"5130","MOGLIANO VENETO",1122,364,117,1603,"2012","043"
"5131","MOIO DE' CALVI",4,7,0,11,"2012","136"
"5132","MOIOLA",2,2,0,4,"2012","123"
"5133","MOLARE",3,0,0,3,"2012","095"
"5134","MOLINELLA",2218,122,0,2340,"2012","039"
"5135","MOLLIA",5,0,0,5,"2012","078"
"5136","MOLTENO",16,44,0,60,"2012","051"
"5137","MOLVENA",18,6,0,24,"2012","059"
"5138","MOMBALDONE",57,0,3,60,"2012","064"
"5139","MOMBARCARO",108,0,0,108,"2012","124"
"5140","MOMBARUZZO",46,0,0,46,"2012","065"
"5141","MOMBASIGLIO",121,0,1,122,"2012","125"
"5142","MOMBELLO DI TORINO",38,0,0,38,"2012","153"
"5143","MOMBELLO MONFERRATO",49,0,0,49,"2012","097"
"5144","MOMBERCELLI",59,0,0,59,"2012","066"
"5145","MOMO",133,710,0,843,"2012","100"
"5146","MOMPERONE",7,0,0,7,"2012","098"
"5147","MONALE",48,0,0,48,"2012","067"
"5148","MONASTERO BORMIDA",416,0,0,416,"2012","068"
"5149","MONASTERO DI LANZO",20,40,2,62,"2012","155"
"5150","MONASTERO DI VASCO",475,6,41,522,"2012","126"
"5151","MONASTEROLO CASOTTO",48,0,0,48,"2012","127"
"5152","MONASTEROLO DEL CASTELLO",2,16,0,18,"2012","137"
"5153","MONASTEROLO DI SAVIGLIANO",456,251,34,741,"2012","128"
"5154","MONASTIER DI TREVISO",2319,328,0,2647,"2012","044"
"5155","MONCALIERI",337,368,0,705,"2012","156"
"5156","MONCALVO",133,0,0,133,"2012","069"
"5157","MONCENISIO",5,0,0,5,"2012","157"
"5158","MONCESTINO",7,0,0,7,"2012","099"
"5159","MONCHIERO",185,0,2,187,"2012","129"
"5160","MONCHIO DELLE CORTI",32,125,0,157,"2012","022"
"5161","MONCRIVELLO",129,164,0,293,"2012","079"
"5162","MONCUCCO TORINESE",50,0,0,50,"2012","070"
"5163","MONDAINO",7,0,0,7,"2012","006"
"5164","MONDOVI'",5701,364,22,6087,"2012","130"
"5165","MONESIGLIO",102,0,0,102,"2012","131"
"5166","MONFORTE D'ALBA",252,0,2,254,"2012","132"
"5167","MONFUMO",55,277,0,332,"2012","045"
"5168","MONGARDINO",31,0,0,31,"2012","071"
"5169","MONGHIDORO",33,67,34,134,"2012","040"
"5170","MONGIARDINO LIGURE",15,0,23,38,"2012","100"
"5171","MONGRANDO",91,132,0,223,"2012","035"
"5172","MONGUZZO",19,7,0,26,"2012","153"
"5173","MONIGA DEL GARDA",0,16,0,16,"2012","109"
"5174","MONNO",3,47,0,50,"2012","110"
"5175","MONSELICE",521,49,0,570,"2012","055"
"5176","MONTA'",147,0,0,147,"2012","133"
"5177","MONTABONE",106,0,0,106,"2012","072"
"5178","MONTACUTO",29,0,0,29,"2012","102"
"5179","MONTAFIA",54,0,0,54,"2012","073"
"5180","MONTAGNA IN VALTELLINA",3,72,0,75,"2012","044"
"5181","MONTAGNANA",1510,37,18,1565,"2012","056"
"5182","MONTALDO BORMIDA",3,0,0,3,"2012","104"
"5183","MONTALDO DI MONDOVI'",93,6,0,99,"2012","134"
"5184","MONTALDO ROERO",28,0,0,28,"2012","135"
"5185","MONTALDO SCARAMPI",26,0,0,26,"2012","074"
"5186","MONTALDO TORINESE",514,0,0,514,"2012","158"
"5187","MONTALENGHE",2,0,0,2,"2012","159"
"5188","MONTALTO DORA",22,0,0,22,"2012","160"
"5189","MONTALTO PAVESE",77,0,0,77,"2012","094"
"5190","MONTANARO",164,141,17,322,"2012","161"
"5191","MONTANASO LOMBARDO",166,446,0,612,"2012","040"
"5192","MONTANERA",1686,849,119,2654,"2012","136"
"5193","MONTANO LUCINO",8,0,21,29,"2012","154"
"5194","MONTE COLOMBO",74,0,0,74,"2012","007"
"5195","MONTE CREMASCO",313,193,0,506,"2012","058"
"5196","MONTE DI MALO",1109,147,0,1256,"2012","063"
"5197","MONTE ISOLA",24,0,0,24,"2012","111"
"5198","MONTE MARENZO",11,0,1,12,"2012","052"
"5199","MONTE SAN PIETRO",98,139,0,237,"2012","042"
"5200","MONTEBELLO DELLA BATTAGLIA",2,51,0,53,"2012","095"
"5201","MONTEBELLO VICENTINO",77,0,140,217,"2012","060"
"5202","MONTEBELLUNA",3568,541,35,4144,"2012","046"
"5203","MONTECALVO VERSIGGIA",2,0,0,2,"2012",NA
"5204","MONTECASTELLO",168,0,0,168,"2012","105"
"5205","MONTECCHIA DI CROSARA",986,0,0,986,"2012","049"
"5206","MONTECCHIO EMILIA",23,1499,0,1522,"2012","027"
"5207","MONTECCHIO MAGGIORE",187,62,8,257,"2012","061"
"5208","MONTECCHIO PRECALCINO",261,144,96,501,"2012","062"
"5209","MONTECHIARO D'ACQUI",82,0,0,82,"2012","106"
"5210","MONTECHIARO D'ASTI",362,0,0,362,"2012","075"
"5211","MONTECHIARUGOLO",13,3159,0,3172,"2012","023"
"5212","MONTECRESTESE",42,38,0,80,"2012","046"
"5213","MONTECRETO",7,401,0,408,"2012","024"
"5214","MONTEFIORE CONCA",25,9,0,34,"2012","008"
"5215","MONTEFIORINO",31,378,4,413,"2012","025"
"5216","MONTEFORTE D'ALPONE",803,47,0,850,"2012","050"
"5217","MONTEGALDA",240,212,0,452,"2012","064"
"5218","MONTEGALDELLA",97,243,64,404,"2012","065"
"5219","MONTEGIOCO",26,0,0,26,"2012","107"
"5220","MONTEGRINO VALTRAVAGLIA",14,0,0,14,"2012","103"
"5221","MONTEGROSSO D'ASTI",33,0,0,33,"2012","076"
"5222","MONTEGROTTO TERME",14,0,44,58,"2012","057"
"5223","MONTELLO",2,0,0,2,"2012","139"
"5224","MONTELUPO ALBESE",83,0,0,83,"2012","137"
"5225","MONTEMAGNO",145,0,0,145,"2012","077"
"5226","MONTEMALE DI CUNEO",33,0,0,33,"2012","138"
"5227","MONTEMARZINO",2,0,0,2,"2012","108"
"5228","MONTERENZIO",369,150,6,525,"2012","041"
"5229","MONTEROSSO GRANA",17,143,0,160,"2012","139"
"5230","MONTESCANO",2,0,0,2,"2012","097"
"5231","MONTESCHENO",2,0,0,2,"2012","047"
"5232","MONTESCUDO",200,0,0,200,"2012","010"
"5233","MONTESE",63,1224,0,1287,"2012","026"
"5234","MONTESEGALE",19,0,0,19,"2012","098"
"5235","MONTEU DA PO",104,0,0,104,"2012","162"
"5236","MONTEU ROERO",787,0,0,787,"2012","140"
"5237","MONTEVECCHIA",15,6,0,21,"2012","053"
"5238","MONTEVEGLIO",30,55,2,87,"2012","043"
"5239","MONTEVIALE",243,15,0,258,"2012","066"
"5240","MONTEZEMOLO",153,0,0,153,"2012","141"
"5241","MONTIANO",4,0,0,4,"2012","028"
"5242","MONTICELLI BRUSATI",11,207,1,219,"2012","112"
"5243","MONTICELLI D'ONGINA",346,589,0,935,"2012","027"
"5244","MONTICELLI PAVESE",1343,439,0,1782,"2012","099"
"5245","MONTICELLO BRIANZA",10,0,254,264,"2012","054"
"5246","MONTICELLO CONTE OTTO",25,818,0,843,"2012","067"
"5247","MONTICELLO D'ALBA",93,0,0,93,"2012","142"
"5248","MONTICHIARI",9285,7168,49,16502,"2012","113"
"5249","MONTIGLIO MONFERRATO",292,0,0,292,"2012","121"
"5250","MONTIRONE",4174,661,0,4835,"2012","114"
"5251","MONTODINE",6,1020,0,1026,"2012","059"
"5252","MONTORFANO",6,0,0,6,"2012","157"
"5253","MONTORSO VICENTINO",654,135,0,789,"2012","068"
"5254","MONTU' BECCARIA",5,0,0,5,"2012","100"
"5255","MONVALLE",15,21,0,36,"2012","104"
"5256","MONZAMBANO",1014,741,869,2624,"2012","036"
"5257","MONZUNO",86,90,0,176,"2012","044"
"5258","MORANO SUL PO",2,0,0,2,"2012","109"
"5259","MORANSENGO",128,0,0,128,"2012","079"
"5260","MORAZZONE",27,89,0,116,"2012","105"
"5261","MORBEGNO",24,90,2,116,"2012","045"
"5262","MORBELLO",12,0,0,12,"2012","110"
"5263","MORCIANO DI ROMAGNA",1,0,0,1,"2012","011"
"5264","MORDANO",4,0,0,4,"2012","045"
"5265","MORENGO",19,43,0,62,"2012","140"
"5266","MORETTA",1788,751,196,2735,"2012","143"
"5267","MORFASSO",127,6,0,133,"2012","028"
"5268","MORGANO",2016,10,0,2026,"2012","047"
"5269","MORIAGO DELLA BATTAGLIA",2048,62,0,2110,"2012","048"
"5270","MORIMONDO",42,1406,0,1448,"2012","150"
"5271","MORIONDO TORINESE",277,0,0,277,"2012","163"
"5272","MORNAGO",29,0,0,29,"2012","106"
"5273","MORNESE",39,0,0,39,"2012","111"
"5274","MORNICO AL SERIO",2545,318,73,2936,"2012","141"
"5275","MORNICO LOSANA",4,0,0,4,"2012","101"
"5276","MOROZZO",1944,526,543,3013,"2012","144"
"5277","MORSASCO",158,0,0,158,"2012","112"
"5278","MORTARA",58,0,0,58,"2012","102"
"5279","MORTERONE",18,0,0,18,"2012","055"
"5280","MOSCAZZANO",118,1021,203,1342,"2012","060"
"5281","MOSSANO",381,62,0,443,"2012","069"
"5282","MOSSO",21,15,17,53,"2012","084"
"5283","MOTTA BALUFFI",5,96,0,101,"2012","061"
"5284","MOTTA DI LIVENZA",957,40,1,998,"2012","049"
"5285","MOTTA VISCONTI",5,0,0,5,"2012","151"
"5286","MOTTALCIATA",41,65,0,106,"2012","037"
"5287","MOTTEGGIANA",1153,1147,517,2817,"2012","037"
"5288","MOZZANICA",164,622,0,786,"2012","142"
"5289","MOZZATE",19,88,0,107,"2012","159"
"5290","MOZZECANE",3382,619,18,4019,"2012","051"
"5291","MULAZZANO",8,1138,0,1146,"2012","041"
"5292","MURA",39,55,2,96,"2012","115"
"5293","MURAZZANO",326,0,76,402,"2012","145"
"5294","MURELLO",471,1158,177,1806,"2012","146"
"5295","MURISENGO",293,0,0,293,"2012","113"
"5296","MUSCOLINE",62,348,5,415,"2012","116"
"5297","MUSILE DI PIAVE",38,47,0,85,"2012","025"
"5298","MUSSO",5,3,2,10,"2012","160"
"5299","MUSSOLENTE",223,208,67,498,"2012","070"
"5300","MUZZANO",47,0,0,47,"2012","038"
"5301","NANTO",300,176,0,476,"2012","071"
"5302","NARZOLE",1009,45,116,1170,"2012","147"
"5303","NAVE",56,165,0,221,"2012","117"
"5304","NEBBIUNO",28,10,9,47,"2012","103"
"5305","NEGRAR",15,119,0,134,"2012","052"
"5306","NEIVE",20,0,10,30,"2012","148"
"5307","NEMBRO",42,0,0,42,"2012","144"
"5308","NERVESA DELLA BATTAGLIA",602,284,0,886,"2012","050"
"5309","NERVIANO",41,138,0,179,"2012","154"
"5310","NESSO",0,8,0,8,"2012","161"
"5311","NETRO",126,81,0,207,"2012","039"
"5312","NEVIANO DEGLI ARDUINI",33,1762,0,1795,"2012","024"
"5313","NEVIGLIE",23,0,0,23,"2012","149"
"5314","NIARDO",3,131,17,151,"2012","118"
"5315","NIBBIANO",244,0,0,244,"2012","029"
"5316","NIBBIOLA",2,0,0,2,"2012",NA
"5317","NIBIONNO",1,19,0,20,"2012","056"
"5318","NICHELINO",81,0,0,81,"2012","164"
"5319","NICORVO",6,0,0,6,"2012","103"
"5320","NIELLA BELBO",48,108,0,156,"2012","150"
"5321","NIELLA TANARO",159,0,0,159,"2012","151"
"5322","NIZZA MONFERRATO",96,0,0,96,"2012","080"
"5323","NOALE",463,62,19,544,"2012","026"
"5324","NOASCA",14,19,32,65,"2012","165"
"5325","NOCETO",31,2851,10,2892,"2012","025"
"5326","NOGARA",2520,578,0,3098,"2012","053"
"5327","NOGAROLE ROCCA",825,254,0,1079,"2012","054"
"5328","NOGAROLE VICENTINO",32,31,0,63,"2012","072"
"5329","NOLE",152,147,0,299,"2012","166"
"5330","NONANTOLA",3,226,0,229,"2012","027"
"5331","NONE",965,978,175,2118,"2012","168"
"5332","NOSATE",16,436,0,452,"2012","155"
"5333","NOVAFELTRIA",1169,191,0,1360,"2012","023"
"5334","NOVALESA",28,8,0,36,"2012","169"
"5335","NOVARA",47,283,0,330,"2012","106"
"5336","NOVATE MEZZOLA",14,55,0,69,"2012","046"
"5337","NOVATE MILANESE",3,0,0,3,"2012",NA
"5338","NOVE",30,255,25,310,"2012","073"
"5339","NOVEDRATE",1276,0,0,1276,"2012","163"
"5340","NOVELLARA",3544,2179,4,5727,"2012","028"
"5341","NOVELLO",914,0,9,923,"2012","152"
"5342","NOVENTA DI PIAVE",9,26,0,35,"2012","027"
"5343","NOVENTA PADOVANA",3,0,0,3,"2012","058"
"5344","NOVENTA VICENTINA",3797,0,0,3797,"2012","074"
"5345","NOVI DI MODENA",981,766,0,1747,"2012","028"
"5346","NOVI LIGURE",500,0,0,500,"2012","114"
"5347","NOVIGLIO",12,450,0,462,"2012","158"
"5348","NUVOLENTO",10,833,0,843,"2012","119"
"5349","NUVOLERA",1293,339,0,1632,"2012","120"
"5350","OCCHIEPPO INFERIORE",6,126,0,132,"2012","040"
"5351","OCCHIEPPO SUPERIORE",39,47,30,116,"2012","041"
"5352","OCCHIOBELLO",9,136,0,145,"2012","033"
"5353","OCCIMIANO",48,0,0,48,"2012","115"
"5354","ODALENGO GRANDE",79,0,0,79,"2012","116"
"5355","ODERZO",223,341,0,564,"2012","051"
"5356","ODOLO",3,0,0,3,"2012","121"
"5357","OFFANENGO",283,440,0,723,"2012","062"
"5358","OFFLAGA",678,3071,0,3749,"2012","122"
"5359","OGGEBBIO",6,0,0,6,"2012","049"
"5360","OGGIONA CON SANTO STEFANO",5,35,0,40,"2012","107"
"5361","OGGIONO",79,75,2,156,"2012","057"
"5362","OGLIANICO",155,299,0,454,"2012","170"
"5363","OLCENENGO",4,0,0,4,"2012","088"
"5364","OLDENICO",2,0,0,2,"2012","089"
"5365","OLEGGIO",230,782,0,1012,"2012","108"
"5366","OLEGGIO CASTELLO",34,0,0,34,"2012","109"
"5367","OLGIATE COMASCO",60,0,21,81,"2012","165"
"5368","OLGIATE MOLGORA",22,102,0,124,"2012","058"
"5369","OLGIATE OLONA",3,0,0,3,"2012","108"
"5370","OLGINATE",14,0,0,14,"2012","059"
"5371","OLIVETO LARIO",16,0,0,16,"2012","060"
"5372","OLMENETA",19,329,92,440,"2012","063"
"5373","OLMO AL BREMBO",6,4,0,10,"2012","145"
"5374","OLMO GENTILE",64,0,0,64,"2012","081"
"5375","OLTRE IL COLLE",44,72,0,116,"2012","146"
"5376","OLTRESSENDA ALTA",26,12,0,38,"2012","147"
"5377","OLTRONA DI SAN MAMETTE",16,0,0,16,"2012","169"
"5378","OME",25,20,0,45,"2012","123"
"5379","OMEGNA",36,0,0,36,"2012","050"
"5380","ONCINO",58,0,0,58,"2012","154"
"5381","ONETA",6,42,0,48,"2012","148"
"5382","ONO SAN PIETRO",0,20,0,20,"2012","124"
"5383","ONORE",11,15,0,26,"2012","149"
"5384","OPERA",0,191,0,191,"2012","159"
"5385","OPPEANO",4713,804,0,5517,"2012","055"
"5386","ORBASSANO",639,0,235,874,"2012","171"
"5387","ORGIANO",555,22,78,655,"2012","075"
"5388","ORIGGIO",56,0,0,56,"2012","109"
"5389","ORINO",2,0,0,2,"2012","110"
"5390","ORIO CANAVESE",68,0,0,68,"2012","172"
"5391","ORIO LITTA",1,124,0,125,"2012","042"
"5392","ORMEA",102,13,0,115,"2012","155"
"5393","ORMELLE",31,219,0,250,"2012","052"
"5394","ORNAVASSO",23,0,0,23,"2012","051"
"5395","ORNICA",5,0,0,5,"2012","151"
"5396","ORSAGO",20,150,0,170,"2012","053"
"5397","ORSARA BORMIDA",14,0,0,14,"2012","119"
"5398","ORSENIGO",6,43,10,59,"2012","170"
"5399","ORTA SAN GIULIO",4,0,0,4,"2012","112"
"5400","ORZINUOVI",853,4080,86,5019,"2012","125"
"5401","ORZIVECCHI",11,610,0,621,"2012","126"
"5402","OSASCO",391,0,65,456,"2012","173"
"5403","OSASIO",181,268,0,449,"2012","174"
"5404","OSIO SOPRA",52,614,0,666,"2012","152"
"5405","OSIO SOTTO",12,0,0,12,"2012","153"
"5406","OSMATE",53,0,0,53,"2012","111"
"5407","OSNAGO",272,58,0,330,"2012","061"
"5408","OSPEDALETTO EUGANEO",411,46,0,457,"2012","059"
"5409","OSPEDALETTO LODIGIANO",0,901,0,901,"2012","043"
"5410","OSPITALE DI CADORE",1,0,0,1,"2012","035"
"5411","OSPITALETTO",106,106,0,212,"2012","127"
"5412","OSSAGO LODIGIANO",93,1573,89,1755,"2012","044"
"5413","OSSIMO",3,21,0,24,"2012","128"
"5414","OSSONA",40,0,0,40,"2012","164"
"5415","OSSUCCIO",0,0,6,6,"2012","172"
"5416","OSTANA",66,0,0,66,"2012","156"
"5417","OSTELLATO",3925,8,0,3933,"2012","017"
"5418","OSTIANO",469,1291,57,1817,"2012","064"
"5419","OSTIGLIA",36,35,65,136,"2012","038"
"5420","OTTIGLIO",111,0,0,111,"2012","120"
"5421","OTTOBIANO",2,48,0,50,"2012","106"
"5422","OTTONE",69,0,0,69,"2012","030"
"5423","OULX",42,0,0,42,"2012","175"
"5424","OVADA",59,0,0,59,"2012","121"
"5425","OVIGLIO",27,0,0,27,"2012","122"
"5426","OZEGNA",115,23,0,138,"2012","176"
"5427","OZZANO DELL'EMILIA",170,249,0,419,"2012","046"
"5428","OZZANO MONFERRATO",59,0,0,59,"2012","123"
"5429","OZZERO",14,311,0,325,"2012","165"
"5430","PADENGHE SUL GARDA",45,0,0,45,"2012","129"
"5431","PADERNO D'ADDA",2,21,0,23,"2012","062"
"5432","PADERNO DEL GRAPPA",49,160,0,209,"2012","054"
"5433","PADERNO DUGNANO",38,0,10,48,"2012","166"
"5434","PADERNO FRANCIACORTA",1,133,75,209,"2012","130"
"5435","PADERNO PONCHIELLI",159,1654,83,1896,"2012","065"
"5436","PADOVA",472,354,116,942,"2012","060"
"5437","PAESANA",754,65,14,833,"2012","157"
"5438","PAESE",2054,664,120,2838,"2012","055"
"5439","PAGAZZANO",5,344,0,349,"2012","154"
"5440","PAGNO",29,0,0,29,"2012","158"
"5441","PAGNONA",6,0,8,14,"2012","063"
"5442","PAISCO LOVENO",1,8,0,9,"2012","131"
"5443","PAITONE",38,18,0,56,"2012","132"
"5444","PALADINA",1,1,0,2,"2012","155"
"5445","PALAGANO",113,648,0,761,"2012","029"
"5446","PALANZANO",15,402,0,417,"2012","026"
"5447","PALAZZAGO",82,123,0,205,"2012","156"
"5448","PALAZZO CANAVESE",2,0,0,2,"2012","177"
"5449","PALAZZO PIGNANO",28,832,0,860,"2012","066"
"5450","PALAZZOLO SULL'OGLIO",1630,1237,5,2872,"2012","133"
"5451","PALAZZOLO VERCELLESE",3,0,0,3,"2012","090"
"5452","PALESTRO",2,15,0,17,"2012","107"
"5453","PALLANZENO",1,5,0,6,"2012","052"
"5454","PALOSCO",444,478,0,922,"2012","157"
"5455","PALU'",1101,0,0,1101,"2012","056"
"5456","PAMPARATO",52,0,0,52,"2012","159"
"5457","PANCALIERI",16,152,0,168,"2012","178"
"5458","PANDINO",65,3761,0,3826,"2012","067"
"5459","PANTIGLIATE",1,0,0,1,"2012","167"
"5460","PAPOZZE",75,78,0,153,"2012","034"
"5461","PARABIAGO",46,50,0,96,"2012","168"
"5462","PARATICO",8,35,0,43,"2012","134"
"5463","PARE'",6,0,0,6,"2012","175"
"5464","PARETO",59,4,0,63,"2012","125"
"5465","PARLASCO",3,0,0,3,"2012","064"
"5466","PARMA",861,8904,0,9765,"2012","027"
"5467","PARODI LIGURE",4,0,40,44,"2012","126"
"5468","PAROLDO",27,0,0,27,"2012","160"
"5469","PARONA",8,0,0,8,"2012","109"
"5470","PARRE",57,65,0,122,"2012","158"
"5471","PARUZZARO",26,26,0,52,"2012","114"
"5472","PARZANICA",2,1,5,8,"2012","159"
"5473","PASPARDO",2,8,0,10,"2012","135"
"5474","PASSERANO MARMORITO",91,0,0,91,"2012","082"
"5475","PASSIRANO",218,201,0,419,"2012","136"
"5476","PASTRENGO",4,137,0,141,"2012","057"
"5477","PASTURO",54,117,29,200,"2012","065"
"5478","PAULLO",0,455,0,455,"2012","169"
"5479","PAVAROLO",65,0,0,65,"2012","180"
"5480","PAVIA",176,221,12,409,"2012","110"
"5481","PAVONE CANAVESE",116,0,0,116,"2012","181"
"5482","PAVONE DEL MELLA",1793,417,14,2224,"2012","137"
"5483","PAVULLO NEL FRIGNANO",1297,3847,0,5144,"2012","030"
"5484","PECETTO DI VALENZA",21,0,0,21,"2012","128"
"5485","PECETTO TORINESE",130,0,0,130,"2012","183"
"5486","PECORARA",324,118,0,442,"2012","031"
"5487","PEDAVENA",11,130,0,141,"2012","036"
"5488","PEDEMONTE",5,4,0,9,"2012","076"
"5489","PEDEROBBA",123,165,0,288,"2012","056"
"5490","PEDRENGO",24,134,0,158,"2012","160"
"5491","PEGLIO",3,1,7,11,"2012","178"
"5492","PEGOGNAGA",2856,1704,898,5458,"2012","039"
"5493","PEIA",15,12,0,27,"2012","161"
"5494","PELLEGRINO PARMENSE",17,675,0,692,"2012","028"
"5495","PELLIO INTELVI",4,10,23,37,"2012","179"
"5496","PENANGO",71,0,0,71,"2012","083"
"5497","PENNABILLI",246,14,0,260,"2012","024"
"5498","PEREGO",4,0,7,11,"2012","066"
"5499","PERLEDO",8,0,0,8,"2012","067"
"5500","PERLETTO",215,0,0,215,"2012","161"
"5501","PERLO",38,0,0,38,"2012","162"
"5502","PERNUMIA",698,151,0,849,"2012","061"
"5503","PEROSA ARGENTINA",54,13,0,67,"2012","184"
"5504","PEROSA CANAVESE",100,156,0,256,"2012","185"
"5505","PERRERO",27,0,0,27,"2012","186"
"5506","PERSICO DOSIMO",2,1810,0,1812,"2012","068"
"5507","PERTENGO",2,0,0,2,"2012","091"
"5508","PERTICA ALTA",14,10,6,30,"2012","139"
"5509","PERTICA BASSA",23,58,1,82,"2012","140"
"5510","PERTUSIO",53,0,0,53,"2012","187"
"5511","PESCANTINA",337,101,0,438,"2012","058"
"5512","PESCAROLO ED UNITI",84,695,0,779,"2012","069"
"5513","PESCHIERA BORROMEO",268,121,0,389,"2012","171"
"5514","PESCHIERA DEL GARDA",6,0,0,6,"2012",NA
"5515","PESSANO CON BORNAGO",54,133,0,187,"2012","172"
"5516","PESSINA CREMONESE",490,2816,0,3306,"2012","070"
"5517","PESSINETTO",3,0,0,3,"2012","188"
"5518","PETTENASCO",6,0,0,6,"2012","116"
"5519","PETTINENGO",5,0,25,30,"2012","042"
"5520","PETTORAZZA GRIMANI",341,201,0,542,"2012","035"
"5521","PEVERAGNO",1094,444,63,1601,"2012","163"
"5522","PEZZAZE",16,28,0,44,"2012","141"
"5523","PEZZOLO VALLE UZZONE",74,0,0,74,"2012","164"
"5524","PIACENZA",988,1291,0,2279,"2012","032"
"5525","PIACENZA D'ADIGE",491,0,0,491,"2012","062"
"5526","PIADENA",2,403,2,407,"2012","071"
"5527","PIAN CAMUNO",1,243,0,244,"2012","142"
"5528","PIANCOGNO",0,40,0,40,"2012","206"
"5529","PIANELLO DEL LARIO",5,1,7,13,"2012","183"
"5530","PIANELLO VAL TIDONE",413,65,0,478,"2012","033"
"5531","PIANENGO",1,159,0,160,"2012","072"
"5532","PIANEZZA",267,342,99,708,"2012","189"
"5533","PIANEZZE",108,82,0,190,"2012","077"
"5534","PIANFEI",831,81,34,946,"2012","165"
"5535","PIANICO",14,88,0,102,"2012","162"
"5536","PIANIGA",54,45,6,105,"2012","028"
"5537","PIANORO",119,120,1,240,"2012","047"
"5538","PIANTEDO",18,312,0,330,"2012","048"
"5539","PIARIO",0,36,0,36,"2012","163"
"5540","PIASCO",195,247,0,442,"2012","166"
"5541","PIATEDA",25,68,0,93,"2012","049"
"5542","PIATTO",27,0,0,27,"2012","043"
"5543","PIAZZA BREMBANA",0,3,0,3,"2012","164"
"5544","PIAZZOLA SUL BRENTA",2145,1117,10,3272,"2012","063"
"5545","PIAZZOLO",11,0,0,11,"2012","166"
"5546","PIEA",73,0,0,73,"2012","084"
"5547","PIEDIMULERA",0,34,2,36,"2012","053"
"5548","PIERANICA",45,0,0,45,"2012","073"
"5549","PIETRA DE' GIORGI",7,0,0,7,"2012","111"
"5550","PIEVE D'ALPAGO",26,56,0,82,"2012","038"
"5551","PIEVE D'OLMI",2,1358,41,1401,"2012","074"
"5552","PIEVE DEL CAIRO",5,64,0,69,"2012","113"
"5553","PIEVE DI CADORE",0,12,0,12,"2012","039"
"5554","PIEVE DI CORIANO",0,0,134,134,"2012","040"
"5555","PIEVE DI SOLIGO",74,134,8,216,"2012","057"
"5556","PIEVE EMANUELE",0,320,91,411,"2012","173"
"5557","PIEVE FISSIRAGA",95,1231,0,1326,"2012","045"
"5558","PIEVE PORTO MORONE",141,0,0,141,"2012","114"
"5559","PIEVE SAN GIACOMO",34,1698,0,1732,"2012","075"
"5560","PIEVE VERGONTE",24,7,23,54,"2012","054"
"5561","PIEVEPELAGO",42,92,0,134,"2012","031"
"5562","PINAROLO PO",2117,0,0,2117,"2012","115"
"5563","PINASCA",79,34,8,121,"2012","190"
"5564","PINCARA",246,0,0,246,"2012","036"
"5565","PINEROLO",1732,157,165,2054,"2012","191"
"5566","PINO D'ASTI",21,0,0,21,"2012","085"
"5567","PINO TORINESE",537,0,45,582,"2012","192"
"5568","PIOBESI D'ALBA",25,0,0,25,"2012",NA
"5569","PIOBESI TORINESE",435,990,76,1501,"2012","193"
"5570","PIODE",0,17,0,17,"2012","097"
"5571","PIOLTELLO",13,0,0,13,"2012","175"
"5572","PIOMBINO DESE",4785,464,0,5249,"2012","064"
"5573","PIOSSASCO",456,440,162,1058,"2012","194"
"5574","PIOVA' MASSAIA",65,0,0,65,"2012","086"
"5575","PIOVE DI SACCO",2661,160,132,2953,"2012","065"
"5576","PIOVENE ROCCHETTE",996,158,0,1154,"2012","078"
"5577","PIOVERA",190,249,0,439,"2012","130"
"5578","PIOZZANO",189,4,0,193,"2012","034"
"5579","PIOZZO",388,0,0,388,"2012","169"
"5580","PISCINA",1628,0,14,1642,"2012","195"
"5581","PISOGNE",7,235,2,244,"2012","143"
"5582","PIUBEGA",2832,594,52,3478,"2012","041"
"5583","PIURO",12,135,0,147,"2012","050"
"5584","PIVERONE",36,121,0,157,"2012","196"
"5585","PIZZIGHETTONE",179,3316,0,3495,"2012","076"
"5586","PLESIO",4,0,3,7,"2012","185"
"5587","POCAPAGLIA",440,74,0,514,"2012","170"
"5588","PODENZANO",124,678,0,802,"2012","035"
"5589","POGGIO BERNI",128,0,0,128,"2012","012"
"5590","POGGIO RENATICO",3,357,0,360,"2012","018"
"5591","POGGIO RUSCO",541,364,120,1025,"2012","042"
"5592","POGGIRIDENTI",0,10,0,10,"2012","051"
"5593","POGLIANO MILANESE",1,0,0,1,"2012","176"
"5594","POGNANO",13,433,0,446,"2012","167"
"5595","POGNO",2,0,0,2,"2012",NA
"5596","POIRINO",3867,542,0,4409,"2012","197"
"5597","POJANA MAGGIORE",1512,52,0,1564,"2012","079"
"5598","POLAVENO",16,0,0,16,"2012","144"
"5599","POLESELLA",14,0,0,14,"2012","037"
"5600","POLESINE PARMENSE",7,319,0,326,"2012","029"
"5601","POLINAGO",86,614,1,701,"2012","032"
"5602","POLLONE",236,34,0,270,"2012","046"
"5603","POLONGHERA",261,170,0,431,"2012","171"
"5604","POLPENAZZE DEL GARDA",21,112,0,133,"2012","145"
"5605","POLVERARA",78,68,0,146,"2012","066"
"5606","POMARETTO",44,0,11,55,"2012","198"
"5607","POMARO MONFERRATO",24,178,0,202,"2012","131"
"5608","POMBIA",6,67,0,73,"2012","121"
"5609","POMPIANO",19,1261,0,1280,"2012","146"
"5610","POMPONESCO",5,301,73,379,"2012","043"
"5611","PONCARALE",458,699,0,1157,"2012","147"
"5612","PONDERANO",46,47,27,120,"2012","047"
"5613","PONNA",0,0,17,17,"2012","187"
"5614","PONSO",81,0,0,81,"2012","067"
"5615","PONT-CANAVESE",30,84,0,114,"2012","199"
"5616","PONTE DELL'OLIO",101,144,0,245,"2012","036"
"5617","PONTE DI LEGNO",3,23,0,26,"2012","148"
"5618","PONTE DI PIAVE",62,70,15,147,"2012","058"
"5619","PONTE IN VALTELLINA",8,27,0,35,"2012","052"
"5620","PONTE LAMBRO",3,24,0,27,"2012","188"
"5621","PONTE NELLE ALPI",34,162,0,196,"2012","040"
"5622","PONTE NIZZA",112,29,0,141,"2012","117"
"5623","PONTE NOSSA",0,23,0,23,"2012","168"
"5624","PONTE SAN NICOLO'",328,40,28,396,"2012","069"
"5625","PONTE SAN PIETRO",6,0,0,6,"2012","170"
"5626","PONTECCHIO POLESINE",893,0,0,893,"2012","038"
"5627","PONTECHIANALE",288,0,0,288,"2012","172"
"5628","PONTECURONE",2,0,0,2,"2012","132"
"5629","PONTELONGO",527,0,0,527,"2012","068"
"5630","PONTENURE",100,220,0,320,"2012","037"
"5631","PONTERANICA",6,0,0,6,"2012","169"
"5632","PONTESTURA",8,0,0,8,"2012","133"
"5633","PONTEVICO",203,2777,77,3057,"2012","149"
"5634","PONTI",85,0,10,95,"2012","134"
"5635","PONTI SUL MINCIO",226,401,44,671,"2012","044"
"5636","PONTIDA",27,0,0,27,"2012","171"
"5637","PONTIROLO NUOVO",445,438,0,883,"2012","172"
"5638","PONTOGLIO",912,1051,0,1963,"2012","150"
"5639","PONZANO MONFERRATO",32,0,0,32,"2012","135"
"5640","PONZANO VENETO",535,152,2,689,"2012","059"
"5641","PONZONE",38,7,0,45,"2012","136"
"5642","PORLEZZA",28,52,23,103,"2012","189"
"5643","PORRETTA TERME",46,0,0,46,"2012","049"
"5644","PORTACOMARO",45,0,0,45,"2012","087"
"5645","PORTALBERA",2,0,0,2,"2012","118"
"5646","PORTE",13,0,0,13,"2012","200"
"5647","PORTICO E SAN BENEDETTO",46,0,0,46,"2012","031"
"5648","PORTO CERESIO",3,0,0,3,"2012","113"
"5649","PORTO MANTOVANO",1288,822,2074,4184,"2012","045"
"5650","PORTO TOLLE",40,0,0,40,"2012","039"
"5651","PORTO VALTRAVAGLIA",2,16,0,18,"2012","114"
"5652","PORTO VIRO",5462,0,0,5462,"2012","052"
"5653","PORTOBUFFOLE'",6,31,0,37,"2012","060"
"5654","PORTOGRUARO",1084,247,8,1339,"2012","029"
"5655","PORTOMAGGIORE",537,307,65,909,"2012","019"
"5656","PORTULA",7,0,0,7,"2012","048"
"5657","POSINA",0,13,0,13,"2012","080"
"5658","POSSAGNO",19,14,0,33,"2012","061"
"5659","POSTALESIO",1,0,4,5,"2012","053"
"5660","POSTUA",7,5,0,12,"2012","102"
"5661","POVE DEL GRAPPA",12,37,0,49,"2012","081"
"5662","POVEGLIANO",214,175,87,476,"2012","062"
"5663","POVEGLIANO VERONESE",2245,575,0,2820,"2012","060"
"5664","POVIGLIO",22,1125,0,1147,"2012","029"
"5665","POZZAGLIO ED UNITI",18,2603,0,2621,"2012","077"
"5666","POZZO D'ADDA",200,0,0,200,"2012","177"
"5667","POZZOL GROPPO",36,0,0,36,"2012","137"
"5668","POZZOLENGO",829,706,3,1538,"2012","151"
"5669","POZZOLEONE",582,1687,18,2287,"2012","082"
"5670","POZZOLO FORMIGARO",13,0,61,74,"2012","138"
"5671","POZZONOVO",1454,0,0,1454,"2012","070"
"5672","POZZUOLO MARTESANA",35,833,0,868,"2012","178"
"5673","PRADALUNGA",17,0,0,17,"2012","173"
"5674","PRADLEVES",2,9,0,11,"2012","173"
"5675","PRAGELATO",14,0,4,18,"2012","201"
"5676","PRALBOINO",1407,831,0,2238,"2012","152"
"5677","PRALI",48,0,0,48,"2012","202"
"5678","PRALORMO",1333,267,0,1600,"2012","203"
"5679","PRALUNGO",72,0,31,103,"2012","049"
"5680","PRAMAGGIORE",63,66,0,129,"2012","030"
"5681","PRAMOLLO",6,0,0,6,"2012","204"
"5682","PRAROSTINO",31,4,0,35,"2012","205"
"5683","PRASCO",29,0,0,29,"2012","139"
"5684","PRASCORSANO",3,0,0,3,"2012","206"
"5685","PRATA CAMPORTACCIO",39,131,0,170,"2012","054"
"5686","PRATO SESIA",0,10,0,10,"2012","122"
"5687","PRAY",48,0,0,48,"2012","050"
"5688","PRAZZO",138,45,11,194,"2012","174"
"5689","PREDAPPIO",144,0,27,171,"2012","032"
"5690","PREDORE",27,0,0,27,"2012","174"
"5691","PREDOSA",239,111,0,350,"2012","140"
"5692","PREGANZIOL",18,206,0,224,"2012","063"
"5693","PREGNANA MILANESE",18,120,0,138,"2012","179"
"5694","PREMANA",14,1,1,16,"2012","069"
"5695","PREMENO",1,0,2,3,"2012","055"
"5696","PREMIA",17,232,0,249,"2012","056"
"5697","PREMILCUORE",333,0,27,360,"2012","033"
"5698","PREMOLO",21,21,0,42,"2012","175"
"5699","PREMOSELLO-CHIOVENDA",22,0,9,31,"2012","057"
"5700","PRESEGLIE",47,3,0,50,"2012","153"
"5701","PRESEZZO",3,0,0,3,"2012",NA
"5702","PRESSANA",3380,118,0,3498,"2012","061"
"5703","PRESTINE",4,60,0,64,"2012","154"
"5704","PREVALLE",67,526,3,596,"2012","155"
"5705","PRIERO",6,0,0,6,"2012","175"
"5706","PRIGNANO SULLA SECCHIA",130,1135,42,1307,"2012","033"
"5707","PRIMALUNA",23,44,1,68,"2012","070"
"5708","PRIOCCA",733,0,0,733,"2012","176"
"5709","PRIOLA",59,0,0,59,"2012","177"
"5710","PROSERPIO",7,3,0,10,"2012","192"
"5711","PROVAGLIO D'ISEO",82,188,9,279,"2012","156"
"5712","PROVAGLIO VAL SABBIA",33,0,2,35,"2012","157"
"5713","PRUNETTO",76,0,0,76,"2012","178"
"5714","PUEGNAGO SUL GARDA",12,78,0,90,"2012","158"
"5715","PUMENENGO",1348,414,174,1936,"2012","177"
"5716","PUOS D'ALPAGO",5,103,0,108,"2012","041"
"5717","PUSIANO",0,0,2,2,"2012","193"
"5718","QUAGLIUZZO",13,0,0,13,"2012","208"
"5719","QUAREGNA",5,0,0,5,"2012","051"
"5720","QUARGNENTO",949,0,0,949,"2012","141"
"5721","QUARNA SOTTO",6,0,0,6,"2012","059"
"5722","QUARONA",13,0,0,13,"2012","107"
"5723","QUARTO D'ALTINO",79,86,0,165,"2012","031"
"5724","QUASSOLO",34,37,0,71,"2012","209"
"5725","QUATTORDIO",713,0,0,713,"2012","142"
"5726","QUATTRO CASTELLA",29,1316,0,1345,"2012","030"
"5727","QUERO",48,55,0,103,"2012","042"
"5728","QUINCINETTO",27,39,0,66,"2012","210"
"5729","QUINGENTOLE",643,54,105,802,"2012","046"
"5730","QUINTANO",0,307,3,310,"2012","078"
"5731","QUINTO DI TREVISO",157,207,19,383,"2012","064"
"5732","QUINTO VERCELLESE",47,0,0,47,"2012","108"
"5733","QUINTO VICENTINO",129,595,64,788,"2012","083"
"5734","QUINZANO D'OGLIO",343,2831,0,3174,"2012","159"
"5735","QUISTELLO",163,1602,585,2350,"2012","047"
"5736","QUITTENGO",3,0,0,3,"2012","052"
"5737","RACCONIGI",1822,1975,91,3888,"2012","179"
"5738","RAMISETO",32,276,0,308,"2012","031"
"5739","RAMPONIO VERNA",5,18,3,26,"2012","194"
"5740","RANCIO VALCUVIA",6,7,0,13,"2012","115"
"5741","RANCO",0,0,43,43,"2012","116"
"5742","RANICA",15,17,0,32,"2012","178"
"5743","RANZANICO",7,23,0,30,"2012","179"
"5744","RASSA",0,32,0,32,"2012","110"
"5745","RAVENNA",1429,1247,1,2677,"2012","014"
"5746","RE",10,0,0,10,"2012","060"
"5747","REANO",24,0,0,24,"2012","211"
"5748","RECOARO TERME",61,95,0,156,"2012","084"
"5749","REDAVALLE",134,0,0,134,"2012","120"
"5750","REDONDESCO",240,262,439,941,"2012","048"
"5751","REFRANCORE",59,0,0,59,"2012","089"
"5752","REFRONTOLO",28,32,0,60,"2012","065"
"5753","REGGIO NELL'EMILIA",62,11243,0,11305,"2012","033"
"5754","REGGIOLO",1106,2356,0,3462,"2012","032"
"5755","REMEDELLO",6981,2156,79,9216,"2012","160"
"5756","RESANA",2265,54,20,2339,"2012","066"
"5757","RESCALDINA",2,0,0,2,"2012",NA
"5758","REVELLO",5737,1754,0,7491,"2012","180"
"5759","REVERE",0,122,2,124,"2012","049"
"5760","REVIGLIASCO D'ASTI",288,0,0,288,"2012","090"
"5761","REVINE LAGO",9,36,0,45,"2012","067"
"5762","REZZAGO",2,0,0,2,"2012",NA
"5763","REZZATO",6,493,0,499,"2012","161"
"5764","RHO",6,316,32,354,"2012","182"
"5765","RIBORDONE",6,0,0,6,"2012","212"
"5766","RICCIONE",2,0,0,2,"2012","013"
"5767","RICENGO",61,2019,0,2080,"2012","079"
"5768","RIESE PIO X",7873,408,47,8328,"2012","068"
"5769","RIFREDDO",1095,102,0,1197,"2012","181"
"5770","RIMA SAN GIUSEPPE",5,0,0,5,"2012","111"
"5771","RIMASCO",0,13,0,13,"2012","112"
"5772","RIMELLA",2,21,0,23,"2012","113"
"5773","RIMINI",118,81,0,199,"2012","014"
"5774","RIO SALICETO",781,462,0,1243,"2012","034"
"5775","RIOLO TERME",311,0,0,311,"2012","015"
"5776","RIOLUNATO",60,16,0,76,"2012","035"
"5777","RIPALTA ARPINA",6,357,0,363,"2012","080"
"5778","RIPALTA CREMASCA",3,294,0,297,"2012","081"
"5779","RIPALTA GUERINA",0,390,0,390,"2012","082"
"5780","RIVA DI SOLTO",9,0,0,9,"2012","180"
"5781","RIVA PRESSO CHIERI",3525,111,0,3636,"2012","215"
"5782","RIVA VALDOBBIA",3,29,4,36,"2012","114"
"5783","RIVALBA",102,0,0,102,"2012","213"
"5784","RIVALTA DI TORINO",151,4,0,155,"2012","214"
"5785","RIVAMONTE AGORDINO",2,31,0,33,"2012","043"
"5786","RIVANAZZANO",150,0,0,150,"2012","122"
"5787","RIVARA",89,127,0,216,"2012","216"
"5788","RIVAROLO CANAVESE",885,949,0,1834,"2012","217"
"5789","RIVAROLO DEL RE ED UNITI",3656,308,0,3964,"2012","083"
"5790","RIVAROLO MANTOVANO",68,1043,37,1148,"2012","050"
"5791","RIVAROSSA",8,154,0,162,"2012","218"
"5792","RIVERGARO",90,530,0,620,"2012","038"
"5793","RIVOLI",1654,0,85,1739,"2012","219"
"5794","RIVOLI VERONESE",137,17,0,154,"2012","062"
"5795","RIVOLTA D'ADDA",1968,2802,2,4772,"2012","084"
"5796","RO",14,51,0,65,"2012","020"
"5797","ROANA",61,484,0,545,"2012","085"
"5798","ROASCIO",26,0,0,26,"2012","184"
"5799","ROASIO",20,0,0,20,"2012","116"
"5800","ROATTO",104,0,0,104,"2012","091"
"5801","ROBASSOMERO",36,68,0,104,"2012","220"
"5802","ROBBIO",9,216,0,225,"2012","123"
"5803","ROBECCHETTO CON INDUNO",264,156,0,420,"2012","183"
"5804","ROBECCO D'OGLIO",10,2885,0,2895,"2012","085"
"5805","ROBECCO PAVESE",11,0,0,11,"2012","124"
"5806","ROBECCO SUL NAVIGLIO",102,643,2,747,"2012","184"
"5807","ROBELLA",403,0,0,403,"2012","092"
"5808","ROBILANTE",118,0,0,118,"2012","185"
"5809","ROBURENT",21,0,0,21,"2012","186"
"5810","ROCCA CANAVESE",56,0,0,56,"2012","221"
"5811","ROCCA CIGLIE'",45,0,0,45,"2012","188"
"5812","ROCCA D'ARAZZO",448,0,0,448,"2012","093"
"5813","ROCCA DE' BALDI",2681,1286,249,4216,"2012","189"
"5814","ROCCA DE' GIORGI",5,0,0,5,"2012","125"
"5815","ROCCA GRIMALDA",12,0,0,12,"2012","147"
"5816","ROCCA PIETORE",0,1,0,1,"2012","044"
"5817","ROCCA SAN CASCIANO",111,0,0,111,"2012","036"
"5818","ROCCA SUSELLA",1,0,0,1,"2012",NA
"5819","ROCCABIANCA",0,1460,0,1460,"2012","030"
"5820","ROCCABRUNA",271,0,41,312,"2012","187"
"5821","ROCCAFORTE LIGURE",29,0,0,29,"2012","146"
"5822","ROCCAFORTE MONDOVI'",348,13,0,361,"2012","190"
"5823","ROCCAFRANCA",1532,1303,0,2835,"2012","162"
"5824","ROCCASPARVERA",616,0,0,616,"2012","191"
"5825","ROCCAVERANO",222,0,0,222,"2012","094"
"5826","ROCCAVIONE",33,0,0,33,"2012","192"
"5827","ROCCHETTA LIGURE",39,0,0,39,"2012","148"
"5828","ROCCHETTA PALAFEA",4,0,0,4,"2012","095"
"5829","ROCCHETTA TANARO",283,0,0,283,"2012","096"
"5830","RODANO",2,159,0,161,"2012","185"
"5831","RODDI",78,16,0,94,"2012","194"
"5832","RODDINO",96,0,0,96,"2012","195"
"5833","RODELLO",8,0,66,74,"2012","196"
"5834","RODENGO-SAIANO",152,209,46,407,"2012","163"
"5835","RODERO",7,5,0,12,"2012",NA
"5836","RODIGO",1012,1085,830,2927,"2012","051"
"5837","ROE' VOLCIANO",12,0,0,12,"2012","164"
"5838","ROGENO",136,224,0,360,"2012","072"
"5839","ROGNANO",10,0,0,10,"2012","127"
"5840","ROGNO",16,116,0,132,"2012","182"
"5841","ROGOLO",2,23,0,25,"2012","056"
"5842","ROLETTO",228,90,0,318,"2012","222"
"5843","ROLO",0,214,0,214,"2012","035"
"5844","ROMAGNANO SESIA",35,0,0,35,"2012","130"
"5845","ROMAGNESE",139,0,0,139,"2012","128"
"5846","ROMANENGO",1,1725,0,1726,"2012","086"
"5847","ROMANO CANAVESE",40,0,0,40,"2012","223"
"5848","ROMANO D'EZZELINO",228,472,0,700,"2012","086"
"5849","ROMANO DI LOMBARDIA",216,2781,0,2997,"2012","183"
"5850","ROMENTINO",14,0,0,14,"2012","131"
"5851","RONAGO",2,53,0,55,"2012","199"
"5852","RONCA'",8,6,0,14,"2012","063"
"5853","RONCADE",2347,160,0,2507,"2012","069"
"5854","RONCADELLE",339,588,0,927,"2012","165"
"5855","RONCARO",2,0,0,2,"2012","129"
"5856","RONCO ALL'ADIGE",6758,15,0,6773,"2012","064"
"5857","RONCO BIELLESE",5,55,0,60,"2012","053"
"5858","RONCO CANAVESE",51,0,0,51,"2012","224"
"5859","RONCOFERRARO",2754,431,614,3799,"2012","052"
"5860","RONCOFREDDO",57,73,0,130,"2012","037"
"5861","RONCOLA",43,30,0,73,"2012","185"
"5862","RONDISSONE",11,0,0,11,"2012","225"
"5863","ROPPOLO",9,0,0,9,"2012","054"
"5864","RORA'",30,0,0,30,"2012","226"
"5865","ROSA'",170,920,0,1090,"2012","087"
"5866","ROSASCO",2,0,0,2,"2012","130"
"5867","ROSATE",3076,481,0,3557,"2012","188"
"5868","ROSIGNANO MONFERRATO",122,0,0,122,"2012","149"
"5869","ROSOLINA",576,0,0,576,"2012","040"
"5870","ROSSA",3,16,0,19,"2012","121"
"5871","ROSSANA",57,104,0,161,"2012","197"
"5872","ROSSANO VENETO",215,191,0,406,"2012","088"
"5873","ROSTA",10,0,89,99,"2012","228"
"5874","ROTA D'IMAGNA",23,29,1,53,"2012","186"
"5875","ROTTOFRENO",293,610,0,903,"2012","039"
"5876","ROTZO",96,0,0,96,"2012","089"
"5877","ROURE",10,0,0,10,"2012","227"
"5878","ROVAGNATE",22,0,7,29,"2012","073"
"5879","ROVASENDA",6,0,0,6,"2012","122"
"5880","ROVATO",1800,1831,0,3631,"2012","166"
"5881","ROVELLASCA",28,64,0,92,"2012","201"
"5882","ROVELLO PORRO",1,0,0,1,"2012",NA
"5883","ROVERBELLA",11892,540,394,12826,"2012","053"
"5884","ROVERCHIARA",5049,53,0,5102,"2012","065"
"5885","ROVERE' VERONESE",176,1209,0,1385,"2012","067"
"5886","ROVEREDO DI GUA'",1619,77,3,1699,"2012","066"
"5887","ROVESCALA",11,0,0,11,"2012","131"
"5888","ROVETTA",5,133,0,138,"2012","187"
"5889","ROVIGO",1190,0,0,1190,"2012","041"
"5890","ROVOLON",196,135,66,397,"2012","071"
"5891","ROZZANO",0,3,0,3,"2012","189"
"5892","RUBANO",47,64,45,156,"2012","072"
"5893","RUBIANA",9,0,0,9,"2012","229"
"5894","RUBIERA",0,638,0,638,"2012","036"
"5895","RUDIANO",451,1063,19,1533,"2012","167"
"5896","RUEGLIO",119,105,0,224,"2012","230"
"5897","RUFFIA",308,298,0,606,"2012","198"
"5898","RUINO",120,0,0,120,"2012","132"
"5899","RUSSI",6,70,0,76,"2012","016"
"5900","SABBIO CHIESE",26,30,0,56,"2012","168"
"5901","SABBIONETA",41,145,0,186,"2012","054"
"5902","SACCOLONGO",89,413,67,569,"2012","073"
"5903","SAGLIANO MICCA",43,0,0,43,"2012","056"
"5904","SALA BAGANZA",15,108,0,123,"2012","031"
"5905","SALA BIELLESE",9,0,0,9,"2012","057"
"5906","SALA BOLOGNESE",280,91,0,371,"2012","050"
"5907","SALA MONFERRATO",3,0,0,3,"2012","150"
"5908","SALARA",3,0,0,3,"2012","042"
"5909","SALASSA",1,0,0,1,"2012","231"
"5910","SALBERTRAND",26,0,0,26,"2012","232"
"5911","SALCEDO",298,62,3,363,"2012","090"
"5912","SALE",63,0,0,63,"2012","151"
"5913","SALE DELLE LANGHE",19,0,0,19,"2012","199"
"5914","SALE MARASINO",60,29,0,89,"2012","169"
"5915","SALE SAN GIOVANNI",44,0,0,44,"2012","200"
"5916","SALERANO SUL LAMBRO",4,236,0,240,"2012","046"
"5917","SALETTO",5,57,0,62,"2012","074"
"5918","SALGAREDA",1970,311,20,2301,"2012","070"
"5919","SALICETO",94,0,0,94,"2012","201"
"5920","SALIZZOLE",2738,576,0,3314,"2012","068"
"5921","SALMOUR",208,0,0,208,"2012","202"
"5922","SALO'",2,45,0,47,"2012","170"
"5923","SALSOMAGGIORE TERME",30,1104,19,1153,"2012","032"
"5924","SALTRIO",32,0,0,32,"2012","117"
"5925","SALUDECIO",98,59,0,157,"2012","015"
"5926","SALUGGIA",527,179,0,706,"2012","128"
"5927","SALUSSOLA",434,87,0,521,"2012","058"
"5928","SALUZZO",2652,3618,0,6270,"2012","203"
"5929","SALVIROLA",585,118,0,703,"2012","087"
"5930","SALZANO",211,20,2,233,"2012","032"
"5931","SAMARATE",30,0,0,30,"2012","118"
"5932","SAMBUCO",13,0,0,13,"2012","204"
"5933","SAMOLACO",155,698,5,858,"2012","057"
"5934","SAMONE",16,0,0,16,"2012","235"
"5935","SAMPEYRE",273,37,0,310,"2012","205"
"5936","SAN BARTOLOMEO VAL CAVARGNA",6,0,7,13,"2012","204"
"5937","SAN BASSANO",42,1602,0,1644,"2012","088"
"5938","SAN BELLINO",2010,0,0,2010,"2012","043"
"5939","SAN BENEDETTO BELBO",29,59,0,88,"2012","206"
"5940","SAN BENEDETTO PO",487,1477,1406,3370,"2012","055"
"5941","SAN BENEDETTO VAL DI SAMBRO",234,135,0,369,"2012","051"
"5942","SAN BENIGNO CANAVESE",295,48,0,343,"2012","236"
"5943","SAN BERNARDINO VERBANO",5,0,0,5,"2012","061"
"5944","SAN BIAGIO DI CALLALTA",265,85,0,350,"2012","071"
"5945","SAN BONIFACIO",2666,0,0,2666,"2012","069"
"5946","SAN CARLO CANAVESE",257,275,0,532,"2012","237"
"5947","SAN CESARIO SUL PANARO",35,948,0,983,"2012","036"
"5948","SAN CIPRIANO PO",115,0,0,115,"2012","133"
"5949","SAN CLEMENTE",35,0,0,35,"2012","016"
"5950","SAN COLOMBANO AL LAMBRO",18,325,120,463,"2012","191"
"5951","SAN COLOMBANO BELMONTE",6,17,0,23,"2012","238"
"5952","SAN CRISTOFORO",19,0,0,19,"2012","152"
"5953","SAN DAMIANO D'ASTI",4531,0,0,4531,"2012","097"
"5954","SAN DAMIANO MACRA",40,0,0,40,"2012","207"
"5955","SAN DANIELE PO",37,1299,0,1336,"2012","089"
"5956","SAN DIDERO",0,9,0,9,"2012","239"
"5957","SAN DONA' DI PIAVE",358,460,13,831,"2012","033"
"5958","SAN DONATO MILANESE",2,0,0,2,"2012","192"
"5959","SAN FEDELE INTELVI",23,24,15,62,"2012","205"
"5960","SAN FELICE DEL BENACO",4,0,0,4,"2012","171"
"5961","SAN FELICE SUL PANARO",0,604,4,608,"2012","037"
"5962","SAN FERMO DELLA BATTAGLIA",5,0,16,21,"2012","206"
"5963","SAN FIOR",46,64,0,110,"2012","072"
"5964","SAN FIORANO",0,148,0,148,"2012","047"
"5965","SAN FRANCESCO AL CAMPO",501,366,0,867,"2012","240"
"5966","SAN GENESIO ED UNITI",4,384,0,388,"2012","135"
"5967","SAN GERMANO CHISONE",59,24,0,83,"2012","242"
"5968","SAN GERMANO DEI BERICI",375,242,0,617,"2012","092"
"5969","SAN GERMANO VERCELLESE",17,0,0,17,"2012","131"
"5970","SAN GERVASIO BRESCIANO",5,256,0,261,"2012","172"
"5971","SAN GIACOMO DELLE SEGNATE",153,155,236,544,"2012","056"
"5972","SAN GIACOMO FILIPPO",3,0,0,3,"2012","058"
"5973","SAN GIACOMO VERCELLESE",1163,0,0,1163,"2012","035"
"5974","SAN GILLIO",151,50,0,201,"2012","243"
"5975","SAN GIORGIO CANAVESE",386,63,0,449,"2012","244"
"5976","SAN GIORGIO DELLE PERTICHE",255,131,2,388,"2012","075"
"5977","SAN GIORGIO DI LOMELLINA",3,0,0,3,"2012","136"
"5978","SAN GIORGIO DI MANTOVA",423,125,65,613,"2012","057"
"5979","SAN GIORGIO DI PIANO",20,0,0,20,"2012","052"
"5980","SAN GIORGIO IN BOSCO",413,1080,0,1493,"2012","076"
"5981","SAN GIORGIO MONFERRATO",11,0,0,11,"2012","153"
"5982","SAN GIORGIO PIACENTINO",235,624,0,859,"2012","040"
"5983","SAN GIORGIO SCARAMPI",104,0,0,104,"2012","098"
"5984","SAN GIORIO DI SUSA",9,23,0,32,"2012","245"
"5985","SAN GIOVANNI BIANCO",45,47,0,92,"2012","188"
"5986","SAN GIOVANNI DEL DOSSO",0,306,73,379,"2012","058"
"5987","SAN GIOVANNI ILARIONE",864,17,3,884,"2012","070"
"5988","SAN GIOVANNI IN CROCE",0,407,3,410,"2012","090"
"5989","SAN GIOVANNI IN MARIGNANO",14,0,0,14,"2012","017"
"5990","SAN GIOVANNI IN PERSICETO",196,776,0,972,"2012","053"
"5991","SAN GIOVANNI LUPATOTO",527,21,0,548,"2012","071"
"5992","SAN GIULIANO MILANESE",9,484,0,493,"2012","195"
"5993","SAN GIUSTO CANAVESE",97,33,0,130,"2012","246"
"5994","SAN GREGORIO NELLE ALPI",18,68,0,86,"2012","045"
"5995","SAN LAZZARO DI SAVENA",12,12,0,24,"2012","054"
"5996","SAN LEO",247,271,0,518,"2012","025"
"5997","SAN MARTINO ALFIERI",11,0,0,11,"2012","099"
"5998","SAN MARTINO BUON ALBERGO",407,888,0,1295,"2012","073"
"5999","SAN MARTINO CANAVESE",36,0,0,36,"2012","247"
"6000","SAN MARTINO DALL'ARGINE",4,705,223,932,"2012","059"
"6001","SAN MARTINO DEL LAGO",14,0,0,14,"2012","091"
"6002","SAN MARTINO DI LUPARI",2048,323,46,2417,"2012","077"
"6003","SAN MARTINO DI VENEZZE",2,0,0,2,"2012","044"
"6004","SAN MARTINO IN RIO",0,1074,0,1074,"2012","037"
"6005","SAN MARTINO IN STRADA",280,665,0,945,"2012","048"
"6006","SAN MARTINO SICCOMARIO",0,2,0,2,"2012","137"
"6007","SAN MARZANO OLIVETO",28,0,0,28,"2012","100"
"6008","SAN MAURIZIO CANAVESE",149,503,23,675,"2012","248"
"6009","SAN MAURIZIO D'OPAGLIO",11,0,0,11,"2012","133"
"6010","SAN MAURO DI SALINE",116,253,27,396,"2012","074"
"6011","SAN MAURO PASCOLI",6,0,0,6,"2012","041"
"6012","SAN MAURO TORINESE",29,0,0,29,"2012","249"
"6013","SAN MICHELE AL TAGLIAMENTO",2494,41,0,2535,"2012","034"
"6014","SAN MICHELE MONDOVI'",139,0,0,139,"2012","210"
"6015","SAN NAZARIO",15,0,0,15,"2012","093"
"6016","SAN NAZZARO SESIA",91,0,0,91,"2012","134"
"6017","SAN NAZZARO VAL CAVARGNA",9,0,6,15,"2012","207"
"6018","SAN PAOLO",406,1909,26,2341,"2012","138"
"6019","SAN PAOLO CERVO",2,0,0,2,"2012","060"
"6020","SAN PAOLO D'ARGON",29,23,0,52,"2012","189"
"6021","SAN PAOLO SOLBRITO",14,0,0,14,"2012","101"
"6022","SAN PELLEGRINO TERME",36,38,0,74,"2012","190"
"6023","SAN PIETRO DI CADORE",11,30,0,41,"2012","047"
"6024","SAN PIETRO DI FELETTO",32,16,0,48,"2012","073"
"6025","SAN PIETRO DI MORUBIO",1,0,0,1,"2012","075"
"6026","SAN PIETRO IN CARIANO",2,0,1,3,"2012","076"
"6027","SAN PIETRO IN CASALE",38,127,0,165,"2012","055"
"6028","SAN PIETRO IN CERRO",23,733,0,756,"2012","041"
"6029","SAN PIETRO IN GU",645,3278,0,3923,"2012","078"
"6030","SAN PIETRO MOSEZZO",14,0,0,14,"2012","135"
"6031","SAN PIETRO MUSSOLINO",13,0,0,13,"2012","094"
"6032","SAN PIETRO VAL LEMINA",1,0,0,1,"2012","250"
"6033","SAN PIETRO VIMINARIO",851,124,0,975,"2012","079"
"6034","SAN POLO D'ENZA",14,761,0,775,"2012","038"
"6035","SAN POLO DI PIAVE",928,88,1,1017,"2012","074"
"6036","SAN PONSO",1,48,0,49,"2012","251"
"6037","SAN POSSIDONIO",560,297,0,857,"2012","038"
"6038","SAN PROSPERO",2,466,0,468,"2012","039"
"6039","SAN RAFFAELE CIMENA",41,0,0,41,"2012","252"
"6040","SAN ROCCO AL PORTO",371,271,0,642,"2012","049"
"6041","SAN SALVATORE MONFERRATO",196,0,0,196,"2012","154"
"6042","SAN SEBASTIANO CURONE",9,0,0,9,"2012","155"
"6043","SAN SEBASTIANO DA PO",313,0,0,313,"2012","253"
"6044","SAN SECONDO DI PINEROLO",374,75,88,537,"2012","254"
"6045","SAN SECONDO PARMENSE",9,1605,0,1614,"2012","033"
"6046","SAN SIRO",0,0,5,5,"2012","248"
"6047","SAN VENDEMIANO",89,183,2,274,"2012","076"
"6048","SAN VITO DI LEGUZZANO",425,114,0,539,"2012","096"
"6049","SAN VITTORE OLONA",25,34,0,59,"2012","201"
"6050","SAN ZENO DI MONTAGNA",126,238,72,436,"2012","079"
"6051","SAN ZENO NAVIGLIO",6,517,0,523,"2012","173"
"6052","SAN ZENONE AL LAMBRO",0,744,0,744,"2012","202"
"6053","SAN ZENONE DEGLI EZZELINI",1821,555,6,2382,"2012","077"
"6054","SANDIGLIANO",37,61,0,98,"2012","059"
"6055","SANDRIGO",1743,1327,0,3070,"2012","091"
"6056","SANFRE'",704,74,0,778,"2012","208"
"6057","SANFRONT",2162,231,0,2393,"2012","209"
"6058","SANGANO",110,0,31,141,"2012","241"
"6059","SANGIANO",1,37,0,38,"2012","141"
"6060","SANGUINETTO",6,128,0,134,"2012","072"
"6061","SANNAZZARO DE' BURGONDI",16,67,0,83,"2012","138"
"6062","SANT'AGATA BOLOGNESE",24,574,0,598,"2012","056"
"6063","SANT'AGATA FELTRIA",200,37,7,244,"2012","026"
"6064","SANT'AGATA FOSSILI",65,0,0,65,"2012","156"
"6065","SANT'AGATA SUL SANTERNO",24,0,0,24,"2012","017"
"6066","SANT'ALBANO STURA",4294,568,285,5147,"2012","211"
"6067","SANT'ALESSIO CON VIALONE",3,0,0,3,"2012","141"
"6068","SANT'AMBROGIO DI TORINO",58,7,12,77,"2012","255"
"6069","SANT'AMBROGIO DI VALPOLICELLA",5,64,0,69,"2012","077"
"6070","SANT'ANGELO DI PIOVE DI SACCO",271,49,0,320,"2012","082"
"6071","SANT'ANGELO LODIGIANO",57,383,0,440,"2012","050"
"6072","SANT'ANGELO LOMELLINA",17,207,0,224,"2012","144"
"6073","SANT'ANNA D'ALFAEDO",268,1185,26,1479,"2012","078"
"6074","SANT'ANTONINO DI SUSA",17,46,20,83,"2012","256"
"6075","SANT'ELENA",56,0,0,56,"2012","083"
"6076","SANT'ILARIO D'ENZA",2,687,0,689,"2012","039"
"6077","SANT'OMOBONO TERME",39,61,0,100,"2012","192"
"6078","SANT'URBANO",823,0,1,824,"2012","084"
"6079","SANTA BRIGIDA",9,33,0,42,"2012","191"
"6080","SANTA CRISTINA E BISSONE",18,275,0,293,"2012","139"
"6081","SANTA GIULETTA",8,0,0,8,"2012","140"
"6082","SANTA GIUSTINA",1562,117,0,1679,"2012","048"
"6083","SANTA GIUSTINA IN COLLE",836,407,2,1245,"2012","080"
"6084","SANTA LUCIA DI PIAVE",79,80,0,159,"2012","075"
"6085","SANTA MARGHERITA D'ADIGE",684,30,0,714,"2012","081"
"6086","SANTA MARGHERITA DI STAFFORA",88,0,0,88,"2012","142"
"6087","SANTA MARIA DELLA VERSA",2,0,0,2,"2012","143"
"6088","SANTA MARIA DI SALA",91,152,11,254,"2012","035"
"6089","SANTA MARIA HOE'",6,0,0,6,"2012","074"
"6090","SANTA MARIA MAGGIORE",20,0,15,35,"2012","062"
"6091","SANTA SOFIA",227,0,3,230,"2012","043"
"6092","SANTA VITTORIA D'ALBA",68,0,0,68,"2012","212"
"6093","SANTARCANGELO DI ROMAGNA",25,0,0,25,"2012","018"
"6094","SANTENA",546,0,0,546,"2012","257"
"6095","SANTHIA'",234,100,0,334,"2012","133"
"6096","SANTO STEFANO BELBO",15,0,0,15,"2012","213"
"6097","SANTO STEFANO DI CADORE",0,24,0,24,"2012","050"
"6098","SANTO STEFANO LODIGIANO",10,246,0,256,"2012","051"
"6099","SANTO STEFANO ROERO",115,0,0,115,"2012","214"
"6100","SANTO STEFANO TICINO",0,68,0,68,"2012","200"
"6101","SANTO STINO DI LIVENZA",3041,93,0,3134,"2012","036"
"6102","SANTORSO",186,196,0,382,"2012","095"
"6103","SAONARA",214,6,2,222,"2012","085"
"6104","SAPPADA",3,58,0,61,"2012","052"
"6105","SARCEDO",1576,371,0,1947,"2012","097"
"6106","SARDIGLIANO",14,0,0,14,"2012","157"
"6107","SAREGO",393,32,0,425,"2012","098"
"6108","SAREZZANO",1,0,0,1,"2012",NA
"6109","SAREZZO",17,29,0,46,"2012","174"
"6110","SARMATO",16,230,0,246,"2012","042"
"6111","SARMEDE",90,75,0,165,"2012","078"
"6112","SARNICO",10,0,0,10,"2012","193"
"6113","SARONNO",1,0,3,4,"2012","119"
"6114","SARSINA",135,17,0,152,"2012","044"
"6115","SARTIRANA LOMELLINA",2,0,0,2,"2012","146"
"6116","SASSO MARCONI",26,23,0,49,"2012","057"
"6117","SASSUOLO",48,502,0,550,"2012","040"
"6118","SAUZE D'OULX",12,0,0,12,"2012","259"
"6119","SAUZE DI CESANA",10,0,0,10,"2012","258"
"6120","SAVIGLIANO",9752,4421,271,14444,"2012","215"
"6121","SAVIGNANO SUL PANARO",81,91,0,172,"2012","041"
"6122","SAVIGNANO SUL RUBICONE",76,0,0,76,"2012","045"
"6123","SAVIGNO",34,426,0,460,"2012","058"
"6124","SAVIORE DELL'ADAMELLO",3,35,2,40,"2012","175"
"6125","SCAGNELLO",138,0,0,138,"2012","216"
"6126","SCALDASOLE",0,82,0,82,"2012","147"
"6127","SCALENGHE",1160,1861,443,3464,"2012","260"
"6128","SCANDIANO",46,1599,3,1648,"2012","040"
"6129","SCANDOLARA RAVARA",0,693,0,693,"2012","092"
"6130","SCANDOLARA RIPA D'OGLIO",12,800,92,904,"2012","093"
"6131","SCANZOROSCIATE",55,12,0,67,"2012","194"
"6132","SCARMAGNO",26,0,0,26,"2012","261"
"6133","SCARNAFIGI",1257,1755,0,3012,"2012","217"
"6134","SCHIAVON",1936,1651,5,3592,"2012","099"
"6135","SCHIGNANO",0,0,15,15,"2012","211"
"6136","SCHILPARIO",0,44,0,44,"2012","195"
"6137","SCHIO",319,290,18,627,"2012","100"
"6138","SCHIVENOGLIA",0,31,0,31,"2012","060"
"6139","SCIOLZE",118,0,0,118,"2012","262"
"6140","SCOPA",1,10,0,11,"2012","134"
"6141","SCOPELLO",2,5,0,7,"2012","135"
"6142","SCORZE'",3173,92,1,3266,"2012","037"
"6143","SECUGNAGO",16,1157,0,1173,"2012","052"
"6144","SEDICO",1492,106,0,1598,"2012","053"
"6145","SEDRIANO",13,585,0,598,"2012","204"
"6146","SEDRINA",14,12,0,26,"2012","196"
"6147","SEGRATE",3,0,0,3,"2012","205"
"6148","SEGUSINO",6,90,0,96,"2012","079"
"6149","SELLERO",5,23,0,28,"2012","176"
"6150","SELVA DI CADORE",0,9,0,9,"2012","054"
"6151","SELVA DI PROGNO",125,720,0,845,"2012","080"
"6152","SELVAZZANO DENTRO",23,0,88,111,"2012","086"
"6153","SELVINO",4,0,0,4,"2012","197"
"6154","SEMIANA",3,0,0,3,"2012","148"
"6155","SENIGA",1275,1589,0,2864,"2012","177"
"6156","SENNA COMASCO",37,197,18,252,"2012","212"
"6157","SENNA LODIGIANA",9,807,4,820,"2012","053"
"6158","SEREN DEL GRAPPA",71,52,173,296,"2012","055"
"6159","SERGNANO",10,1631,0,1641,"2012","094"
"6160","SERIATE",735,73,0,808,"2012","198"
"6161","SERINA",25,72,0,97,"2012","199"
"6162","SERLE",46,35,0,81,"2012","178"
"6163","SERMIDE",0,223,151,374,"2012","061"
"6164","SERNAGLIA DELLA BATTAGLIA",313,28,0,341,"2012","080"
"6165","SERNIO",0,0,4,4,"2012","059"
"6166","SEROLE",87,0,0,87,"2012","104"
"6167","SERRALUNGA D'ALBA",23,0,0,23,"2012","218"
"6168","SERRALUNGA DI CREA",14,0,0,14,"2012","159"
"6169","SERRAMAZZONI",49,1744,0,1793,"2012","042"
"6170","SERRAVALLE A PO",38,33,193,264,"2012","062"
"6171","SERRAVALLE LANGHE",168,0,0,168,"2012","219"
"6172","SERRAVALLE SCRIVIA",8,0,1,9,"2012","160"
"6173","SERRAVALLE SESIA",6,0,0,6,"2012","137"
"6174","SESTO CALENDE",32,0,0,32,"2012","120"
"6175","SESTO ED UNITI",1,1189,333,1523,"2012","095"
"6176","SESTOLA",90,376,0,466,"2012","043"
"6177","SETTALA",40,208,0,248,"2012","210"
"6178","SETTIME",255,0,0,255,"2012","106"
"6179","SETTIMO MILANESE",64,323,4,391,"2012","211"
"6180","SETTIMO ROTTARO",6,43,0,49,"2012","264"
"6181","SETTIMO TORINESE",495,302,77,874,"2012","265"
"6182","SETTIMO VITTONE",185,190,0,375,"2012","266"
"6183","SEZZADIO",38,0,0,38,"2012","161"
"6184","SILEA",13,92,3,108,"2012","081"
"6185","SILLAVENGO",23,92,0,115,"2012","138"
"6186","SILVANO D'ORBA",7,0,0,7,"2012","162"
"6187","SINIO",19,1,0,20,"2012","220"
"6188","SIRONE",8,69,1,78,"2012","075"
"6189","SIRTORI",8,0,0,8,"2012","076"
"6190","SISSA",6,420,0,426,"2012","034"
"6191","SIZIANO",67,88,0,155,"2012","150"
"6192","SIZZANO",202,26,148,376,"2012","139"
"6193","SOAVE",159,0,0,159,"2012","081"
"6194","SOGLIANO AL RUBICONE",244,34,0,278,"2012","046"
"6195","SOGLIO",1,0,0,1,"2012","107"
"6196","SOIANO DEL LAGO",16,0,0,16,"2012","180"
"6197","SOLAGNA",0,26,0,26,"2012","101"
"6198","SOLARO",0,6,0,6,"2012","213"
"6199","SOLAROLO",3,0,0,3,"2012","018"
"6200","SOLAROLO RAINERIO",12,271,0,283,"2012","096"
"6201","SOLBIATE",6,84,3,93,"2012","215"
"6202","SOLERO",310,0,0,310,"2012","163"
"6203","SOLESINO",10,0,0,10,"2012","087"
"6204","SOLFERINO",595,287,91,973,"2012","063"
"6205","SOLIERA",32,613,0,645,"2012","044"
"6206","SOLIGNANO",17,385,0,402,"2012","035"
"6207","SOLONGHELLO",90,0,0,90,"2012","164"
"6208","SOLTO COLLINA",19,16,0,35,"2012","200"
"6209","SOMAGLIA",19,1183,0,1202,"2012","054"
"6210","SOMANO",48,0,0,48,"2012","221"
"6211","SOMMA LOMBARDO",29,11,0,40,"2012","123"
"6212","SOMMACAMPAGNA",1837,402,114,2353,"2012","082"
"6213","SOMMARIVA DEL BOSCO",1544,735,0,2279,"2012","222"
"6214","SOMMARIVA PERNO",42,0,0,42,"2012","223"
"6215","SOMMO",50,0,0,50,"2012","151"
"6216","SONA",2819,606,87,3512,"2012","083"
"6217","SONCINO",370,4892,52,5314,"2012","097"
"6218","SONDALO",34,117,4,155,"2012","060"
"6219","SONDRIO",18,31,0,49,"2012","061"
"6220","SONGAVAZZO",2,0,0,2,"2012","201"
"6221","SONICO",3,152,11,166,"2012","181"
"6222","SORAGNA",12,1726,0,1738,"2012","036"
"6223","SORBOLO",0,1447,0,1447,"2012","037"
"6224","SORDEVOLO",142,23,4,169,"2012","063"
"6225","SORDIO",0,280,0,280,"2012","055"
"6226","SORESINA",34,1688,139,1861,"2012","098"
"6227","SORGA'",1730,65,0,1795,"2012","084"
"6228","SORICO",13,14,46,73,"2012","216"
"6229","SORISO",3,0,0,3,"2012","140"
"6230","SORISOLE",49,54,0,103,"2012","202"
"6231","SORMANO",19,0,2,21,"2012","217"
"6232","SOSPIRO",26,490,0,516,"2012","099"
"6233","SOSPIROLO",13,114,0,127,"2012","056"
"6234","SOSSANO",68,519,0,587,"2012","102"
"6235","SOSTEGNO",1,0,0,1,"2012","064"
"6236","SOTTO IL MONTE GIOVANNI XXIII",62,74,0,136,"2012","203"
"6237","SOVERE",89,86,0,175,"2012","204"
"6238","SOVERZENE",1,0,0,1,"2012","057"
"6239","SOVIZZO",975,29,0,1004,"2012","103"
"6240","SOVRAMONTE",15,100,22,137,"2012","058"
"6241","SOZZAGO",13,0,0,13,"2012","141"
"6242","SPARONE",44,75,0,119,"2012","267"
"6243","SPESSA",11,0,0,11,"2012","152"
"6244","SPIGNO MONFERRATO",143,26,42,211,"2012","165"
"6245","SPILAMBERTO",2229,1295,0,3524,"2012","045"
"6246","SPINADESCO",25,0,0,25,"2012","100"
"6247","SPINEA",36,174,0,210,"2012","038"
"6248","SPINEDA",9,695,0,704,"2012","101"
"6249","SPINETO SCRIVIA",148,0,0,148,"2012","166"
"6250","SPINO D'ADDA",642,1925,0,2567,"2012","102"
"6251","SPINONE AL LAGO",13,0,0,13,"2012","205"
"6252","SPIRANO",11,1127,2,1140,"2012","206"
"6253","SPRESIANO",109,247,3,359,"2012","082"
"6254","STAGNO LOMBARDO",9,5695,110,5814,"2012","103"
"6255","STANGHELLA",412,0,0,412,"2012","088"
"6256","STAZZANO",19,0,5,24,"2012","167"
"6257","STAZZONA",12,9,13,34,"2012","218"
"6258","STEZZANO",153,447,0,600,"2012","207"
"6259","STIENTA",139,0,7,146,"2012","045"
"6260","STRA",0,0,5,5,"2012","039"
"6261","STRADELLA",35,43,0,78,"2012","153"
"6262","STRAMBINO",155,0,0,155,"2012","269"
"6263","STRESA",29,0,0,29,"2012","064"
"6264","STREVI",58,0,0,58,"2012","168"
"6265","STRONA",1,0,0,1,"2012","065"
"6266","STROPPO",7,0,0,7,"2012","224"
"6267","STROZZA",2,0,0,2,"2012","208"
"6268","SUARDI",6,0,0,6,"2012","154"
"6269","SUEGLIO",2,0,0,2,"2012","077"
"6270","SUELLO",6,0,6,12,"2012","078"
"6271","SUISIO",1,45,0,46,"2012","209"
"6272","SULZANO",34,190,0,224,"2012","182"
"6273","SUMIRAGO",33,80,0,113,"2012","124"
"6274","SUNO",55,398,0,453,"2012","143"
"6275","SUSA",87,20,0,107,"2012","270"
"6276","SUSEGANA",879,86,0,965,"2012","083"
"6277","SUSTINENTE",412,339,349,1100,"2012","064"
"6278","SUZZARA",2301,1650,817,4768,"2012","065"
"6279","TACENO",15,4,0,19,"2012","079"
"6280","TAGLIO DI PO",7178,0,0,7178,"2012","046"
"6281","TAGLIOLO MONFERRATO",63,0,0,63,"2012","169"
"6282","TAIBON AGORDINO",1,21,0,22,"2012","059"
"6283","TAINO",23,135,0,158,"2012","125"
"6284","TALAMELLO",2,0,0,2,"2012","027"
"6285","TALAMONA",16,145,0,161,"2012","063"
"6286","TALEGGIO",57,34,0,91,"2012","210"
"6287","TAMBRE",25,148,0,173,"2012","060"
"6288","TARANTASCA",2628,297,282,3207,"2012","225"
"6289","TARTANO",2,17,0,19,"2012","064"
"6290","TARZO",48,17,0,65,"2012","084"
"6291","TASSAROLO",4,0,0,4,"2012","170"
"6292","TAVAGNASCO",92,9,14,115,"2012","271"
"6293","TAVAZZANO CON VILLAVESCO",181,802,0,983,"2012","056"
"6294","TAVERNOLA BERGAMASCA",11,15,0,26,"2012","211"
"6295","TAVERNOLE SUL MELLA",29,49,0,78,"2012","183"
"6296","TAVIGLIANO",23,0,0,23,"2012","066"
"6297","TEGLIO",30,250,22,302,"2012","065"
"6298","TELGATE",1903,278,0,2181,"2012","212"
"6299","TEMU'",4,13,0,17,"2012","184"
"6300","TEOLO",24,40,27,91,"2012","089"
"6301","TERDOBBIATE",13,125,0,138,"2012","144"
"6302","TERENZO",79,540,0,619,"2012","038"
"6303","TERNO D'ISOLA",6,40,0,46,"2012","213"
"6304","TERRANOVA DEI PASSERINI",50,655,0,705,"2012","057"
"6305","TERRASSA PADOVANA",1580,0,0,1580,"2012","090"
"6306","TERRAZZO",3,26,0,29,"2012","085"
"6307","TERRUGGIA",23,0,12,35,"2012","171"
"6308","TERZO",73,0,4,77,"2012","172"
"6309","TEZZE SUL BRENTA",97,338,0,435,"2012","104"
"6310","THIENE",305,443,3,751,"2012","105"
"6311","TICENGO",14,404,0,418,"2012","104"
"6312","TIGLIOLE",984,0,0,984,"2012","108"
"6313","TIGNALE",7,0,0,7,"2012","185"
"6314","TIRANO",25,12,0,37,"2012","066"
"6315","TIZZANO VAL PARMA",1,1018,0,1019,"2012","039"
"6316","TOANO",24,1685,0,1709,"2012","041"
"6317","TOCENO",10,12,11,33,"2012","065"
"6318","TOLLEGNO",10,9,0,19,"2012","068"
"6319","TOMBOLO",1214,66,0,1280,"2012","091"
"6320","TONCO",524,0,0,524,"2012","109"
"6321","TONENGO",101,0,0,101,"2012","110"
"6322","TONEZZA DEL CIMONE",1,0,0,1,"2012","106"
"6323","TORBOLE CASAGLIA",35,1031,0,1066,"2012","186"
"6324","TORINO",219,0,0,219,"2012","272"
"6325","TORLINO VIMERCATI",0,423,0,423,"2012","105"
"6326","TORNATA",5,149,0,154,"2012","106"
"6327","TORNO",4,0,0,4,"2012","223"
"6328","TORNOLO",81,5,0,86,"2012","040"
"6329","TORRAZZA COSTE",17,0,0,17,"2012","155"
"6330","TORRAZZA PIEMONTE",120,0,68,188,"2012","273"
"6331","TORRAZZO",9,0,0,9,"2012","069"
"6332","TORRE BERETTI E CASTELLARO",17,331,0,348,"2012","156"
"6333","TORRE BOLDONE",17,0,0,17,"2012","214"
"6334","TORRE BORMIDA",0,7,0,7,"2012","226"
"6335","TORRE D'ARESE",5,0,0,5,"2012","157"
"6336","TORRE D'ISOLA",0,437,0,437,"2012","159"
"6337","TORRE DE' BUSI",6,0,2,8,"2012","080"
"6338","TORRE DE' NEGRI",14,56,39,109,"2012","158"
"6339","TORRE DE' PICENARDI",8,1006,0,1014,"2012","107"
"6340","TORRE DE' ROVERI",4,0,0,4,"2012","216"
"6341","TORRE DI MOSTO",14,474,0,488,"2012","041"
"6342","TORRE DI SANTA MARIA",16,2,0,18,"2012","067"
"6343","TORRE MONDOVI'",5,0,0,5,"2012","227"
"6344","TORRE PALLAVICINA",277,412,0,689,"2012","217"
"6345","TORRE PELLICE",86,0,0,86,"2012","275"
"6346","TORRE SAN GIORGIO",69,43,0,112,"2012","228"
"6347","TORREBELVICINO",935,16,0,951,"2012","107"
"6348","TORREGLIA",7,0,0,7,"2012","092"
"6349","TORRESINA",4,0,0,4,"2012","229"
"6350","TORREVECCHIA PIA",79,13,3,95,"2012","160"
"6351","TORRI DI QUARTESOLO",104,158,49,311,"2012","108"
"6352","TORRIANA",110,0,0,110,"2012","019"
"6353","TORRILE",0,2133,0,2133,"2012","041"
"6354","TORTONA",2517,238,0,2755,"2012","174"
"6355","TOSCOLANO-MADERNO",20,0,0,20,"2012","187"
"6356","TOVO DI SANT'AGATA",0,55,1,56,"2012","068"
"6357","TRADATE",32,0,21,53,"2012","127"
"6358","TRANA",58,261,19,338,"2012","276"
"6359","TRAONA",47,108,91,246,"2012","069"
"6360","TRAREGO VIGGIONA",2,0,0,2,"2012","066"
"6361","TRASQUERA",16,0,5,21,"2012","067"
"6362","TRAUSELLA",16,19,0,35,"2012","277"
"6363","TRAVACO' SICCOMARIO",3,0,0,3,"2012","162"
"6364","TRAVAGLIATO",1337,484,0,1821,"2012","188"
"6365","TRAVEDONA-MONATE",15,24,0,39,"2012","128"
"6366","TRAVERSELLA",60,58,0,118,"2012","278"
"6367","TRAVERSETOLO",47,1049,0,1096,"2012","042"
"6368","TRAVES",1,0,0,1,"2012","279"
"6369","TRAVO",84,44,0,128,"2012","043"
"6370","TREBASELEGHE",5076,153,0,5229,"2012","093"
"6371","TRECASALI",0,468,0,468,"2012","043"
"6372","TRECATE",9,197,0,206,"2012","149"
"6373","TRECENTA",2102,187,11,2300,"2012","047"
"6374","TREDOZIO",112,0,0,112,"2012","049"
"6375","TREGNAGO",643,134,0,777,"2012","087"
"6376","TREISO",2,0,0,2,"2012","230"
"6377","TREMENICO",0,0,2,2,"2012","081"
"6378","TREMEZZO",6,19,34,59,"2012","225"
"6379","TREMOSINE",30,454,8,492,"2012","189"
"6380","TRENZANO",981,1404,0,2385,"2012","190"
"6381","TRESCORE BALNEARIO",43,54,36,133,"2012","218"
"6382","TRESCORE CREMASCO",108,385,0,493,"2012","109"
"6383","TRESIGALLO",8,0,0,8,"2012","024"
"6384","TRESIVIO",5,27,0,32,"2012","070"
"6385","TREVENZUOLO",708,784,27,1519,"2012","088"
"6386","TREVIGLIO",871,1349,0,2220,"2012","219"
"6387","TREVIGNANO",2215,166,0,2381,"2012","085"
"6388","TREVILLE",3,0,0,3,"2012","175"
"6389","TREVIOLO",50,212,0,262,"2012","220"
"6390","TREVISO",762,167,0,929,"2012","086"
"6391","TREVISO BRESCIANO",7,53,0,60,"2012","191"
"6392","TREZZANO SUL NAVIGLIO",0,318,0,318,"2012","220"
"6393","TREZZO SULL'ADDA",0,329,0,329,"2012","221"
"6394","TREZZO TINELLA",32,0,0,32,"2012","231"
"6395","TREZZONE",2,0,0,2,"2012","226"
"6396","TRIBANO",3,0,0,3,"2012","094"
"6397","TRIBIANO",0,51,0,51,"2012","222"
"6398","TRICHIANA",80,345,0,425,"2012","061"
"6399","TRIGOLO",5,1570,0,1575,"2012","110"
"6400","TRINITA'",2448,251,373,3072,"2012","232"
"6401","TRINO",3,139,0,142,"2012","148"
"6402","TRISOBBIO",138,0,0,138,"2012","176"
"6403","TRISSINO",60,379,0,439,"2012","110"
"6404","TRIVERO",7,37,0,44,"2012","070"
"6405","TROFARELLO",815,62,0,877,"2012","280"
"6406","TROMELLO",63,57,199,319,"2012","164"
"6407","TRONTANO",6,9,18,33,"2012","068"
"6408","TRONZANO VERCELLESE",150,42,0,192,"2012","150"
"6409","TROVO",19,12,0,31,"2012","165"
"6410","TRUCCAZZANO",86,1472,0,1558,"2012","224"
"6411","TURANO LODIGIANO",55,1873,0,1928,"2012","058"
"6412","TURATE",204,0,2,206,"2012","227"
"6413","TURBIGO",2,72,0,74,"2012","226"
"6414","UBIALE CLANEZZO",2,0,0,2,"2012","221"
"6415","UBOLDO",13,0,0,13,"2012","130"
"6416","UGGIATE-TREVANO",9,70,31,110,"2012","228"
"6417","URAGO D'OGLIO",221,858,0,1079,"2012","192"
"6418","URBANA",572,0,0,572,"2012","095"
"6419","URGNANO",196,165,0,361,"2012","222"
"6420","USSEAUX",42,76,0,118,"2012","281"
"6421","USSEGLIO",23,14,0,37,"2012","282"
"6422","VAIANO CREMASCO",40,237,0,277,"2012","111"
"6423","VAIE",2,34,58,94,"2012","283"
"6424","VAILATE",9,419,0,428,"2012","112"
"6425","VAL DELLA TORRE",375,0,0,375,"2012","284"
"6426","VAL DI NIZZA",2,6,0,8,"2012","166"
"6427","VAL MASINO",6,0,0,6,"2012","074"
"6428","VAL REZZO",3,7,5,15,"2012","233"
"6429","VALBONDIONE",2,21,0,23,"2012","223"
"6430","VALBREMBO",31,2,0,33,"2012","224"
"6431","VALBRONA",7,0,1,8,"2012","229"
"6432","VALDAGNO",32,218,0,250,"2012","111"
"6433","VALDASTICO",637,20,0,657,"2012","112"
"6434","VALDENGO",32,50,0,82,"2012","071"
"6435","VALDIDENTRO",20,129,10,159,"2012","071"
"6436","VALDIERI",2,0,0,2,"2012","233"
"6437","VALDISOTTO",16,150,4,170,"2012","072"
"6438","VALDOBBIADENE",105,419,0,524,"2012","087"
"6439","VALDUGGIA",12,0,0,12,"2012","152"
"6440","VALEGGIO",58,0,0,58,"2012","167"
"6441","VALEGGIO SUL MINCIO",2297,1988,8,4293,"2012","089"
"6442","VALENZA",65,0,2,67,"2012","177"
"6443","VALERA FRATTA",141,228,0,369,"2012","059"
"6444","VALFENERA",1010,90,153,1253,"2012","112"
"6445","VALFURVA",10,118,12,140,"2012","073"
"6446","VALGANNA",23,0,3,26,"2012","131"
"6447","VALGOGLIO",25,60,0,85,"2012","225"
"6448","VALGRANA",312,0,0,312,"2012","234"
"6449","VALGREGHENTINO",4,0,0,4,"2012","082"
"6450","VALLADA AGORDINA",0,2,0,2,"2012","062"
"6451","VALLE DI CADORE",1,0,0,1,"2012","063"
"6452","VALLE LOMELLINA",6,706,0,712,"2012","168"
"6453","VALLE MOSSO",1,0,0,1,"2012","073"
"6454","VALLE SALIMBENE",0,92,0,92,"2012","169"
"6455","VALLE SAN NICOLAO",7,0,0,7,"2012","074"
"6456","VALLEVE",0,12,0,12,"2012","226"
"6457","VALLI DEL PASUBIO",3,6,0,9,"2012","113"
"6458","VALLIO TERME",9,0,0,9,"2012","193"
"6459","VALLO TORINESE",15,0,0,15,"2012","286"
"6460","VALMADRERA",27,0,1,28,"2012","083"
"6461","VALMOREA",3,28,0,31,"2012","232"
"6462","VALMOZZOLA",44,5,0,49,"2012","044"
"6463","VALPERGA",135,268,0,403,"2012","287"
"6464","VALPRATO SOANA",28,0,0,28,"2012","288"
"6465","VALSECCA",42,0,0,42,"2012","228"
"6466","VALSOLDA",9,7,5,21,"2012","234"
"6467","VALSTAGNA",3,0,0,3,"2012","114"
"6468","VALSTRONA",33,0,0,33,"2012","069"
"6469","VALTORTA",17,26,0,43,"2012","229"
"6470","VALVERDE",20,0,0,20,"2012","170"
"6471","VALVESTINO",7,6,0,13,"2012","194"
"6472","VANZAGHELLO",2,0,0,2,"2012","249"
"6473","VANZAGO",24,0,25,49,"2012","229"
"6474","VANZONE CON SAN CARLO",1,0,0,1,"2012",NA
"6475","VAPRIO D'ADDA",23,351,0,374,"2012","230"
"6476","VARALLO",31,36,4,71,"2012","156"
"6477","VARALLO POMBIA",7,0,0,7,"2012","154"
"6478","VARANO BORGHI",3,0,0,3,"2012","132"
"6479","VARANO DE' MELEGARI",4,328,0,332,"2012","045"
"6480","VARESE",118,92,0,210,"2012","133"
"6481","VARISELLA",11,44,0,55,"2012","289"
"6482","VARSI",24,378,0,402,"2012","046"
"6483","VARZI",80,8,0,88,"2012","171"
"6484","VARZO",10,23,9,42,"2012","071"
"6485","VAS",0,12,0,12,"2012","064"
"6486","VAUDA CANAVESE",46,0,0,46,"2012","290"
"6487","VAZZOLA",663,344,2,1009,"2012","088"
"6488","VEDANO OLONA",109,105,0,214,"2012","134"
"6489","VEDDASCA",0,0,11,11,"2012","135"
"6490","VEDELAGO",19805,348,115,20268,"2012","089"
"6491","VEDESETA",14,120,0,134,"2012","230"
"6492","VEGGIANO",95,137,47,279,"2012","096"
"6493","VEGLIO",23,0,0,23,"2012","075"
"6494","VELESO",3,0,17,20,"2012","236"
"6495","VELEZZO LOMELLINA",6,0,0,6,"2012","172"
"6496","VELLEZZO BELLINI",34,335,0,369,"2012","173"
"6497","VELO D'ASTICO",503,27,0,530,"2012","115"
"6498","VELO VERONESE",529,1715,0,2244,"2012","090"
"6499","VENARIA REALE",53,20,251,324,"2012","292"
"6500","VENASCA",55,8,0,63,"2012","237"
"6501","VENAUS",19,32,16,67,"2012","291"
"6502","VENDROGNO",32,0,0,32,"2012","085"
"6503","VENEGONO INFERIORE",1,110,4,115,"2012","136"
"6504","VENEGONO SUPERIORE",0,5,11,16,"2012","137"
"6505","VENEZIA",1479,71,72,1622,"2012","042"
"6506","VENIANO",41,97,0,138,"2012","238"
"6507","VERBANIA",47,0,1,48,"2012","072"
"6508","VERCANA",5,11,2,18,"2012","239"
"6509","VERCEIA",15,8,0,23,"2012","075"
"6510","VERCELLI",26,219,0,245,"2012","158"
"6511","VERDELLINO",1,67,0,68,"2012","232"
"6512","VERDELLO",239,137,0,376,"2012","233"
"6513","VERDERIO INFERIORE",3,0,0,3,"2012","087"
"6514","VERDERIO SUPERIORE",0,0,39,39,"2012","088"
"6515","VERDUNO",109,0,0,109,"2012","238"
"6516","VERGATO",48,0,18,66,"2012","059"
"6517","VERGHERETO",438,0,35,473,"2012","050"
"6518","VERGIATE",64,0,0,64,"2012","138"
"6519","VERMEZZO",0,470,0,470,"2012","235"
"6520","VERNANTE",249,49,0,298,"2012","239"
"6521","VERNASCA",69,76,0,145,"2012","044"
"6522","VERNATE",1,62,0,63,"2012","236"
"6523","VEROLANUOVA",1652,2057,186,3895,"2012","195"
"6524","VEROLAVECCHIA",124,3827,190,4141,"2012","196"
"6525","VEROLENGO",225,131,0,356,"2012","293"
"6526","VERONA",3249,1041,5,4295,"2012","091"
"6527","VERONELLA",5809,284,0,6093,"2012","092"
"6528","VERRONE",55,0,0,55,"2012","076"
"6529","VERRUA SAVOIA",606,0,0,606,"2012","294"
"6530","VERTEMATE CON MINOPRIO",6,0,0,6,"2012","242"
"6531","VERTOVA",21,38,0,59,"2012","234"
"6532","VERUCCHIO",119,24,0,143,"2012","020"
"6533","VERVIO",7,1,0,8,"2012","076"
"6534","VERZUOLO",84,16,0,100,"2012","240"
"6535","VESCOVANA",7,0,0,7,"2012","097"
"6536","VESCOVATO",2632,883,562,4077,"2012","113"
"6537","VESIME",490,0,0,490,"2012","113"
"6538","VESPOLATE",33,121,0,154,"2012","158"
"6539","VESTENANOVA",534,110,0,644,"2012","093"
"6540","VESTIGNE'",7,48,0,55,"2012","295"
"6541","VESTONE",10,0,0,10,"2012","197"
"6542","VESTRENO",0,2,0,2,"2012","089"
"6543","VETTO",17,385,23,425,"2012","042"
"6544","VEZZA D'ALBA",4,0,0,4,"2012","241"
"6545","VEZZA D'OGLIO",1,160,30,191,"2012","198"
"6546","VEZZANO SUL CROSTOLO",23,175,0,198,"2012","043"
"6547","VIADANA",504,1089,294,1887,"2012","066"
"6548","VIADANICA",22,33,0,55,"2012","235"
"6549","VIALE",271,0,0,271,"2012","114"
"6550","VIALFRE'",12,0,0,12,"2012","296"
"6551","VIANO",1,776,9,786,"2012","044"
"6552","VIARIGI",54,0,0,54,"2012","115"
"6553","VICENZA",366,1036,35,1437,"2012","116"
"6554","VICO CANAVESE",141,128,0,269,"2012","297"
"6555","VICOFORTE",512,0,0,512,"2012","242"
"6556","VICOLUNGO",1,0,0,1,"2012","159"
"6557","VIDIGULFO",23,375,0,398,"2012","176"
"6558","VIDOR",29,289,0,318,"2012","090"
"6559","VIGANELLA",2,0,0,2,"2012",NA
"6560","VIGANO SAN MARTINO",13,0,0,13,"2012","236"
"6561","VIGANO'",2,0,0,2,"2012",NA
"6562","VIGARANO MAINARDA",3,0,0,3,"2012","022"
"6563","VIGASIO",1027,447,0,1474,"2012","094"
"6564","VIGEVANO",73,42,69,184,"2012","177"
"6565","VIGGIU'",35,61,0,96,"2012","139"
"6566","VIGHIZZOLO D'ESTE",26,25,0,51,"2012","098"
"6567","VIGLIANO BIELLESE",0,46,0,46,"2012","077"
"6568","VIGLIANO D'ASTI",57,0,0,57,"2012","116"
"6569","VIGNALE MONFERRATO",207,0,0,207,"2012","179"
"6570","VIGNATE",12,482,0,494,"2012","237"
"6571","VIGNOLA",3,122,0,125,"2012","046"
"6572","VIGNOLE BORBERA",27,0,0,27,"2012","180"
"6573","VIGNOLO",466,0,0,466,"2012","243"
"6574","VIGNONE",5,0,0,5,"2012","074"
"6575","VIGO DI CADORE",6,0,2,8,"2012","065"
"6576","VIGODARZERE",359,110,0,469,"2012","099"
"6577","VIGOLO",24,135,0,159,"2012","237"
"6578","VIGOLZONE",103,422,0,525,"2012","045"
"6579","VIGONE",1901,970,275,3146,"2012","299"
"6580","VIGONOVO",5,0,17,22,"2012","043"
"6581","VIGONZA",368,408,0,776,"2012","100"
"6582","VILLA BARTOLOMEA",28,1,0,29,"2012","095"
"6583","VILLA CARCINA",3,0,0,3,"2012","199"
"6584","VILLA CORTESE",131,0,0,131,"2012","248"
"6585","VILLA D'ADDA",10,0,0,10,"2012","238"
"6586","VILLA D'ALME'",62,23,0,85,"2012","239"
"6587","VILLA D'OGNA",4,75,0,79,"2012","241"
"6588","VILLA DEL BOSCO",2,0,0,2,"2012","078"
"6589","VILLA DEL CONTE",540,640,0,1180,"2012","101"
"6590","VILLA DI CHIAVENNA",2,2,0,4,"2012","077"
"6591","VILLA DI SERIO",17,0,0,17,"2012","240"
"6592","VILLA DI TIRANO",9,129,47,185,"2012","078"
"6593","VILLA ESTENSE",263,0,0,263,"2012","102"
"6594","VILLA GUARDIA",145,0,0,145,"2012","245"
"6595","VILLA MINOZZO",57,622,12,691,"2012","045"
"6596","VILLA POMA",0,632,94,726,"2012","067"
"6597","VILLA SAN SECONDO",11,0,0,11,"2012","119"
"6598","VILLACHIARA",308,2032,602,2942,"2012","200"
"6599","VILLADEATI",35,0,0,35,"2012","182"
"6600","VILLADOSE",841,0,106,947,"2012","048"
"6601","VILLADOSSOLA",10,0,0,10,"2012","075"
"6602","VILLAFALLETTO",1698,645,383,2726,"2012","244"
"6603","VILLAFRANCA D'ASTI",287,0,0,287,"2012","117"
"6604","VILLAFRANCA DI VERONA",7620,2869,157,10646,"2012","096"
"6605","VILLAFRANCA PADOVANA",538,1685,0,2223,"2012","103"
"6606","VILLAFRANCA PIEMONTE",2525,1763,575,4863,"2012","300"
"6607","VILLAGA",81,220,128,429,"2012","117"
"6608","VILLALVERNIA",1,0,0,1,"2012",NA
"6609","VILLAMARZANA",39,95,0,134,"2012","049"
"6610","VILLAMIROGLIO",75,0,0,75,"2012","184"
"6611","VILLANOVA BIELLESE",289,0,0,289,"2012","079"
"6612","VILLANOVA CANAVESE",50,26,0,76,"2012","301"
"6613","VILLANOVA D'ARDENGHI",4,0,21,25,"2012","179"
"6614","VILLANOVA D'ASTI",3790,105,0,3895,"2012","118"
"6615","VILLANOVA DEL GHEBBO",56,0,0,56,"2012","050"
"6616","VILLANOVA DEL SILLARO",2,1258,5,1265,"2012","060"
"6617","VILLANOVA DI CAMPOSAMPIERO",32,36,4,72,"2012","104"
"6618","VILLANOVA MARCHESANA",0,72,0,72,"2012","051"
"6619","VILLANOVA MONDOVI'",1908,432,119,2459,"2012","245"
"6620","VILLANOVA MONFERRATO",3,73,0,76,"2012","185"
"6621","VILLANOVA SOLARO",277,524,0,801,"2012","246"
"6622","VILLANOVA SULL'ARDA",180,1190,0,1370,"2012","046"
"6623","VILLANTERIO",3,0,0,3,"2012","180"
"6624","VILLANUOVA SUL CLISI",12,0,0,12,"2012","201"
"6625","VILLAR DORA",26,0,35,61,"2012","303"
"6626","VILLAR FOCCHIARDO",30,53,36,119,"2012","305"
"6627","VILLAR PELLICE",157,31,21,209,"2012","306"
"6628","VILLAR PEROSA",10,0,16,26,"2012","307"
"6629","VILLAR SAN COSTANZO",201,178,183,562,"2012","247"
"6630","VILLARBASSE",236,28,0,264,"2012","302"
"6631","VILLARBOIT",2,0,0,2,"2012","163"
"6632","VILLAREGGIA",119,24,0,143,"2012","304"
"6633","VILLAROMAGNANO",26,0,0,26,"2012","186"
"6634","VILLASTELLONE",486,606,136,1228,"2012","308"
"6635","VILLATA",7,33,0,40,"2012","164"
"6636","VILLAVERLA",47,1070,7,1124,"2012","118"
"6637","VILLETTE",47,0,0,47,"2012","076"
"6638","VILLIMPENTA",497,85,28,610,"2012","068"
"6639","VILLONGO",18,0,0,18,"2012","242"
"6640","VILLORBA",110,27,0,137,"2012","091"
"6641","VILMINORE DI SCALVE",10,175,0,185,"2012","243"
"6642","VINADIO",146,16,0,162,"2012","248"
"6643","VINCHIO",15,0,0,15,"2012","120"
"6644","VINOVO",285,130,0,415,"2012","309"
"6645","VINZAGLIO",16,45,0,61,"2012","164"
"6646","VIOLA",82,0,0,82,"2012","249"
"6647","VIONE",2,54,0,56,"2012","202"
"6648","VIRGILIO",61,1654,552,2267,"2012","069"
"6649","VIRLE PIEMONTE",311,340,137,788,"2012","310"
"6650","VISANO",2164,595,0,2759,"2012","203"
"6651","VISCHE",13,0,0,13,"2012","311"
"6652","VISONE",45,0,0,45,"2012","187"
"6653","VISTARINO",49,15,0,64,"2012","181"
"6654","VISTRORIO",15,0,0,15,"2012","312"
"6655","VITTORIO VENETO",263,178,15,456,"2012","092"
"6656","VITTUONE",2,169,0,171,"2012","243"
"6657","VIU'",69,22,49,140,"2012","313"
"6658","VIVERONE",50,0,0,50,"2012","080"
"6659","VIZZOLO PREDABISSI",23,0,0,23,"2012","244"
"6660","VO'",102,72,0,174,"2012","105"
"6661","VOBARNO",44,81,0,125,"2012","204"
"6662","VOCCA",4,8,0,12,"2012","166"
"6663","VODO CADORE",31,0,0,31,"2012","066"
"6664","VOGHERA",42,0,0,42,"2012","182"
"6665","VOGHIERA",3,0,0,3,"2012","023"
"6666","VOGOGNA",12,0,3,15,"2012","077"
"6667","VOLONGO",77,0,0,77,"2012","114"
"6668","VOLPAGO DEL MONTELLO",1275,535,24,1834,"2012","093"
"6669","VOLPEDO",1,0,0,1,"2012","188"
"6670","VOLPEGLINO",2,0,0,2,"2012","189"
"6671","VOLPIANO",353,154,29,536,"2012","314"
"6672","VOLTA MANTOVANA",2227,1513,686,4426,"2012","070"
"6673","VOLTAGGIO",9,83,0,92,"2012","190"
"6674","VOLTIDO",0,324,0,324,"2012","115"
"6675","VOLVERA",1448,182,0,1630,"2012","315"
"6676","VOTTIGNASCO",2042,43,39,2124,"2012","250"
"6677","ZANDOBBIO",14,24,0,38,"2012","244"
"6678","ZANE'",363,138,0,501,"2012","119"
"6679","ZANICA",1222,1150,0,2372,"2012","245"
"6680","ZAVATTARELLO",110,0,0,110,"2012","184"
"6681","ZECCONE",7,234,0,241,"2012","185"
"6682","ZELBIO",0,0,12,12,"2012","246"
"6683","ZELO BUON PERSICO",0,961,56,1017,"2012","061"
"6684","ZELO SURRIGONE",0,193,0,193,"2012","246"
"6685","ZEME",41,29,0,70,"2012","186"
"6686","ZENEVREDO",7,0,0,7,"2012","187"
"6687","ZENSON DI PIAVE",8,0,0,8,"2012","094"
"6688","ZERBOLO'",4,191,0,195,"2012","189"
"6689","ZERMEGHEDO",0,66,0,66,"2012","120"
"6690","ZERO BRANCO",232,171,0,403,"2012","095"
"6691","ZEVIO",3435,781,0,4216,"2012","097"
"6692","ZIANO PIACENTINO",89,0,0,89,"2012","048"
"6693","ZIBELLO",6,954,0,960,"2012","048"
"6694","ZIBIDO SAN GIACOMO",30,623,0,653,"2012","247"
"6695","ZIMELLA",7483,414,58,7955,"2012","098"
"6696","ZOCCA",101,761,0,862,"2012","047"
"6697","ZOGNO",114,47,2,163,"2012","246"
"6698","ZOLA PREDOSA",12,88,0,100,"2012","060"
"6699","ZOLDO ALTO",16,0,0,16,"2012","068"
"6700","ZONE",4,28,0,32,"2012","205"
"6701","ZOPPE' DI CADORE",0,5,0,5,"2012",NA
"6702","ZOVENCEDO",7,0,0,7,"2012","121"
"6703","ZUBIENA",39,3,12,54,"2012","082"
"6704","ZUGLIANO",273,165,18,456,"2012","122"
"6705","ZUMAGLIA",37,0,0,37,"2012","083"
"6706","ABANO TERME",20,66,33,119,"2013","001"
"6707","ABBADIA CERRETO",0,1114,0,1114,"2013","001"
"6708","ABBADIA LARIANA",8,26,1,35,"2013","001"
"6709","ABBIATEGRASSO",93,1482,2,1577,"2013","002"
"6710","ACCEGLIO",42,31,0,73,"2013","001"
"6711","ACQUAFREDDA",1478,180,0,1658,"2013","001"
"6712","ACQUANEGRA CREMONESE",4,98,645,747,"2013","001"
"6713","ACQUANEGRA SUL CHIESE",1851,666,74,2591,"2013","001"
"6714","ACQUI TERME",279,0,0,279,"2013","001"
"6715","ADRARA SAN MARTINO",38,50,0,88,"2013","001"
"6716","ADRARA SAN ROCCO",11,3,0,14,"2013","002"
"6717","ADRIA",2437,380,0,2817,"2013","001"
"6718","ADRO",536,23,0,559,"2013","002"
"6719","AFFI",0,16,0,16,"2013","001"
"6720","AGAZZANO",192,445,0,637,"2013","001"
"6721","AGLIANO TERME",82,0,0,82,"2013","001"
"6722","AGLIE'",171,32,0,203,"2013","001"
"6723","AGNA",308,0,0,308,"2013","002"
"6724","AGNADELLO",24,1334,20,1378,"2013","002"
"6725","AGNOSINE",24,32,0,56,"2013","003"
"6726","AGORDO",4,23,0,27,"2013","001"
"6727","AGRATE CONTURBIA",46,0,0,46,"2013","001"
"6728","AGUGLIARO",310,68,43,421,"2013","001"
"6729","AICURZIO",7,59,0,66,"2013",NA
"6730","AILOCHE",1,0,0,1,"2013","001"
"6731","AIRASCA",856,303,111,1270,"2013","002"
"6732","AIRUNO",12,0,0,12,"2013","002"
"6733","AISONE",20,20,0,40,"2013","002"
"6734","ALA DI STURA",42,29,0,71,"2013","003"
"6735","ALAGNA VALSESIA",16,9,11,36,"2013","002"
"6736","ALANO DI PIAVE",419,58,0,477,"2013","002"
"6737","ALBA",871,0,0,871,"2013","003"
"6738","ALBAIRATE",31,640,0,671,"2013","005"
"6739","ALBANO SANT'ALESSANDRO",21,0,0,21,"2013","003"
"6740","ALBAREDO D'ADIGE",9786,195,0,9981,"2013","002"
"6741","ALBAREDO PER SAN MARCO",7,36,0,43,"2013","001"
"6742","ALBARETO",86,99,0,185,"2013","001"
"6743","ALBARETTO DELLA TORRE",35,0,0,35,"2013","004"
"6744","ALBAVILLA",3,0,0,3,"2013","003"
"6745","ALBERA LIGURE",22,0,0,22,"2013","002"
"6746","ALBESE CON CASSANO",0,0,2,2,"2013","004"
"6747","ALBETTONE",1853,597,6,2456,"2013","002"
"6748","ALBIANO D'IVREA",139,39,0,178,"2013","004"
"6749","ALBIATE",440,0,0,440,"2013",NA
"6750","ALBIGNASEGO",201,82,138,421,"2013","003"
"6751","ALBINEA",5,1348,0,1353,"2013","001"
"6752","ALBINO",68,40,0,108,"2013","004"
"6753","ALBIOLO",26,0,0,26,"2013","005"
"6754","ALBIZZATE",4,0,0,4,"2013","002"
"6755","ALBOSAGGIA",8,123,0,131,"2013","002"
"6756","ALBUGNANO",73,0,0,73,"2013","002"
"6757","ALBUZZANO",19,0,0,19,"2013","004"
"6758","ALESSANDRIA",9993,1808,0,11801,"2013","003"
"6759","ALFIANELLO",15,459,4,478,"2013","004"
"6760","ALFIANO NATTA",36,0,0,36,"2013","004"
"6761","ALFONSINE",51,0,0,51,"2013","001"
"6762","ALGUA",1,4,0,5,"2013","248"
"6763","ALICE BEL COLLE",2,0,0,2,"2013","005"
"6764","ALICE CASTELLO",604,31,0,635,"2013","004"
"6765","ALICE SUPERIORE",37,0,0,37,"2013","005"
"6766","ALLEGHE",7,0,0,7,"2013","003"
"6767","ALLUVIONI CAMBIO'",20,0,0,20,"2013","006"
"6768","ALME'",4,0,3,7,"2013","005"
"6769","ALMENNO SAN BARTOLOMEO",38,0,0,38,"2013","006"
"6770","ALMENNO SAN SALVATORE",8,0,0,8,"2013","007"
"6771","ALMESE",50,14,0,64,"2013","006"
"6772","ALONTE",609,16,0,625,"2013","003"
"6773","ALPETTE",0,28,0,28,"2013","007"
"6774","ALPIGNANO",259,186,82,527,"2013","008"
"6775","ALSENO",492,959,0,1451,"2013","002"
"6776","ALSERIO",8,0,0,8,"2013","006"
"6777","ALTAVILLA MONFERRATO",82,0,0,82,"2013","007"
"6778","ALTAVILLA VICENTINA",141,0,0,141,"2013","004"
"6779","ALTISSIMO",25,55,0,80,"2013","005"
"6780","ALTIVOLE",10954,94,18,11066,"2013","001"
"6781","ALZANO LOMBARDO",18,54,0,72,"2013","008"
"6782","ALZANO SCRIVIA",1,0,0,1,"2013","008"
"6783","ALZATE BRIANZA",7,159,0,166,"2013","007"
"6784","AMBIVERE",6,0,0,6,"2013","009"
"6785","AMENO",11,6,30,47,"2013","002"
"6786","ANDALO VALTELLINO",3,0,0,3,"2013",NA
"6787","ANDEZENO",419,0,0,419,"2013","009"
"6788","ANDORNO MICCA",24,0,31,55,"2013","002"
"6789","ANDRATE",39,0,0,39,"2013","010"
"6790","ANFO",0,26,0,26,"2013","005"
"6791","ANGERA",84,194,0,278,"2013","003"
"6792","ANGOLO TERME",8,87,1,96,"2013","006"
"6793","ANGROGNA",88,0,6,94,"2013","011"
"6794","ANGUILLARA VENETA",11,0,0,11,"2013","004"
"6795","ANNICCO",37,795,177,1009,"2013","003"
"6796","ANNONE DI BRIANZA",24,17,0,41,"2013","003"
"6797","ANNONE VENETO",34,71,0,105,"2013","001"
"6798","ANTEGNATE",943,1141,0,2084,"2013","010"
"6799","ANTIGNANO",73,0,0,73,"2013","003"
"6800","ANTRONA SCHIERANCO",9,0,0,9,"2013","001"
"6801","ANZANO DEL PARCO",0,154,0,154,"2013","009"
"6802","ANZOLA D'OSSOLA",4,152,0,156,"2013","002"
"6803","ANZOLA DELL'EMILIA",131,444,0,575,"2013","001"
"6804","APPIANO GENTILE",58,302,76,436,"2013","010"
"6805","APRICA",0,17,5,22,"2013","004"
"6806","ARAMENGO",219,0,0,219,"2013","004"
"6807","ARCADE",1207,105,0,1312,"2013","002"
"6808","ARCENE",6,338,0,344,"2013","011"
"6809","ARCISATE",42,789,0,831,"2013","004"
"6810","ARCOLE",1026,152,0,1178,"2013","004"
"6811","ARCONATE",59,103,0,162,"2013","007"
"6812","ARCORE",13,20,0,33,"2013",NA
"6813","ARCUGNANO",98,4,0,102,"2013","006"
"6814","ARDENNO",46,49,4,99,"2013","005"
"6815","ARDESIO",57,31,0,88,"2013","012"
"6816","ARENA PO",81,207,67,355,"2013","005"
"6817","ARESE",0,170,0,170,"2013","009"
"6818","ARGEGNO",4,0,0,4,"2013","011"
"6819","ARGELATO",74,56,0,130,"2013","002"
"6820","ARGENTA",1768,31,0,1799,"2013","001"
"6821","ARGUELLO",72,0,0,72,"2013","007"
"6822","ARIANO NEL POLESINE",731,182,0,913,"2013","002"
"6823","ARIGNANO",539,0,0,539,"2013","012"
"6824","ARLUNO",28,211,7,246,"2013","010"
"6825","ARMENO",43,88,4,135,"2013","006"
"6826","AROLA",5,0,14,19,"2013","004"
"6827","ARONA",5,0,0,5,"2013","008"
"6828","AROSIO",3,5,0,8,"2013","012"
"6829","ARQUA' PETRARCA",126,0,0,126,"2013","005"
"6830","ARQUA' POLESINE",875,4,0,879,"2013","003"
"6831","ARQUATA SCRIVIA",8,0,0,8,"2013","009"
"6832","ARRE",3,19,0,22,"2013","006"
"6833","ARSAGO SEPRIO",8,0,0,8,"2013","005"
"6834","ARSIE'",20,8,349,377,"2013","004"
"6835","ARSIERO",10,15,0,25,"2013","007"
"6836","ARTOGNE",3,427,24,454,"2013","007"
"6837","ARZAGO D'ADDA",332,753,0,1085,"2013","013"
"6838","ARZERGRANDE",293,127,7,427,"2013","007"
"6839","ARZIGNANO",231,252,0,483,"2013","008"
"6840","ASIAGO",102,1168,0,1270,"2013","009"
"6841","ASIGLIANO VENETO",63,0,0,63,"2013","010"
"6842","ASIGLIANO VERCELLESE",25,0,0,25,"2013","007"
"6843","ASOLA",8551,1810,1242,11603,"2013","002"
"6844","ASOLO",9233,562,0,9795,"2013","003"
"6845","ASSAGO",0,0,7,7,"2013","011"
"6846","ASSO",19,0,0,19,"2013","013"
"6847","ASTI",2682,17,0,2699,"2013","005"
"6848","AURANO",1,0,0,1,"2013","005"
"6849","AURONZO DI CADORE",18,0,0,18,"2013","005"
"6850","AVERARA",4,0,0,4,"2013","014"
"6851","AVIATICO",1,22,0,23,"2013","015"
"6852","AVIGLIANA",210,46,10,266,"2013","013"
"6853","AVOLASCA",95,0,0,95,"2013","010"
"6854","AZEGLIO",57,109,0,166,"2013","014"
"6855","AZZANELLO",0,345,0,345,"2013","004"
"6856","AZZANO MELLA",297,679,2,978,"2013","008"
"6857","AZZANO SAN PAOLO",20,121,0,141,"2013","016"
"6858","AZZATE",25,26,0,51,"2013","006"
"6859","AZZIO",13,88,0,101,"2013","007"
"6860","AZZONE",5,0,0,5,"2013","017"
"6861","BACENO",9,28,12,49,"2013","006"
"6862","BADIA CALAVENA",746,314,43,1103,"2013","005"
"6863","BADIA PAVESE",46,0,0,46,"2013","006"
"6864","BADIA POLESINE",168,0,20,188,"2013","004"
"6865","BAGNACAVALLO",46,0,0,46,"2013","002"
"6866","BAGNARA DI ROMAGNA",7,0,0,7,"2013","003"
"6867","BAGNARIA",22,0,0,22,"2013","007"
"6868","BAGNASCO",128,0,0,128,"2013","008"
"6869","BAGNATICA",3,181,0,184,"2013","018"
"6870","BAGNO DI ROMAGNA",848,18,0,866,"2013","001"
"6871","BAGNOLI DI SOPRA",810,12,0,822,"2013","008"
"6872","BAGNOLO CREMASCO",5,1614,0,1619,"2013","005"
"6873","BAGNOLO IN PIANO",2,578,0,580,"2013","002"
"6874","BAGNOLO MELLA",358,2685,289,3332,"2013","009"
"6875","BAGNOLO PIEMONTE",985,97,0,1082,"2013","009"
"6876","BAGNOLO SAN VITO",44,2201,1230,3475,"2013","003"
"6877","BAGOLINO",3,324,2,329,"2013","010"
"6878","BAIRO",79,86,0,165,"2013","015"
"6879","BAISO",4,817,19,840,"2013","003"
"6880","BALANGERO",157,103,0,260,"2013","016"
"6881","BALDICHIERI D'ASTI",69,0,0,69,"2013","007"
"6882","BALDISSERO CANAVESE",0,79,0,79,"2013","017"
"6883","BALDISSERO D'ALBA",735,0,0,735,"2013","010"
"6884","BALDISSERO TORINESE",204,0,0,204,"2013","018"
"6885","BALLABIO",19,71,0,90,"2013","004"
"6886","BALME",9,0,0,9,"2013","019"
"6887","BALOCCO",22,34,0,56,"2013","009"
"6888","BANCHETTE",5,0,0,5,"2013","020"
"6889","BANNIO ANZINO",33,0,1,34,"2013","007"
"6890","BAONE",35,0,0,35,"2013","009"
"6891","BARASSO",1,0,0,1,"2013",NA
"6892","BARBANIA",34,186,51,271,"2013","021"
"6893","BARBARANO VICENTINO",283,195,0,478,"2013","011"
"6894","BARBARESCO",34,0,0,34,"2013","011"
"6895","BARBARIGA",756,1205,0,1961,"2013","011"
"6896","BARBATA",14,1033,0,1047,"2013","019"
"6897","BARBIANELLO",151,5,0,156,"2013","008"
"6898","BARBONA",276,3,0,279,"2013","010"
"6899","BARDELLO",24,0,0,24,"2013","009"
"6900","BARDI",40,679,0,719,"2013","002"
"6901","BARDOLINO",26,111,0,137,"2013","006"
"6902","BARDONECCHIA",13,45,0,58,"2013","022"
"6903","BAREGGIO",77,295,0,372,"2013","012"
"6904","BARENGO",10,109,0,119,"2013","012"
"6905","BARGE",4062,1810,228,6100,"2013","012"
"6906","BARGHE",10,16,0,26,"2013","012"
"6907","BARIANO",1,347,0,348,"2013","020"
"6908","BARNI",17,7,0,24,"2013","015"
"6909","BAROLO",42,0,0,42,"2013","013"
"6910","BARONE CANAVESE",3,42,0,45,"2013","023"
"6911","BARZAGO",313,19,0,332,"2013","005"
"6912","BARZANA",1,0,0,1,"2013",NA
"6913","BARZANO'",18,0,0,18,"2013","006"
"6914","BARZIO",11,59,15,85,"2013","007"
"6915","BASALUZZO",109,0,0,109,"2013","012"
"6916","BASCAPE'",84,634,0,718,"2013","009"
"6917","BASIANO",1,0,0,1,"2013","014"
"6918","BASIGLIO",0,59,0,59,"2013","015"
"6919","BASSANO BRESCIANO",2,88,0,90,"2013","013"
"6920","BASSANO DEL GRAPPA",268,166,3,437,"2013","012"
"6921","BASSIGNANA",3,0,0,3,"2013","013"
"6922","BASTIA MONDOVI'",619,0,0,619,"2013","014"
"6923","BASTIGLIA",141,0,0,141,"2013","001"
"6924","BATTAGLIA TERME",9,0,0,9,"2013","011"
"6925","BATTIFOLLO",1,0,0,1,"2013","015"
"6926","BAZZANO",1,185,0,186,"2013","004"
"6927","BEDERO VALCUVIA",20,0,0,20,"2013","010"
"6928","BEDIZZOLE",4050,1329,2,5381,"2013","014"
"6929","BEDONIA",191,140,0,331,"2013","003"
"6930","BEDULITA",16,4,0,20,"2013","022"
"6931","BEINASCO",28,0,0,28,"2013","024"
"6932","BEINETTE",750,269,16,1035,"2013","016"
"6933","BELFIORE",2221,0,0,2221,"2013","007"
"6934","BELGIOIOSO",2,133,0,135,"2013","013"
"6935","BELLAGIO",3,41,19,63,"2013","019"
"6936","BELLANO",5,0,0,5,"2013","008"
"6937","BELLARIA-IGEA MARINA",11,0,0,11,"2013","001"
"6938","BELLINO",93,0,0,93,"2013","017"
"6939","BELLINZAGO LOMBARDO",51,1493,0,1544,"2013","016"
"6940","BELLINZAGO NOVARESE",547,534,0,1081,"2013","016"
"6941","BELLUNO",723,376,23,1122,"2013","006"
"6942","BELVEDERE LANGHE",180,0,62,242,"2013","018"
"6943","BEMA",0,3,0,3,"2013","006"
"6944","BENE LARIO",3,13,49,65,"2013","021"
"6945","BENE VAGIENNA",1686,338,77,2101,"2013","019"
"6946","BENEVELLO",283,0,0,283,"2013","020"
"6947","BENNA",12,25,6,43,"2013","003"
"6948","BENTIVOGLIO",69,219,0,288,"2013","005"
"6949","BERBENNO",13,26,0,39,"2013","023"
"6950","BERBENNO DI VALTELLINA",40,124,3,167,"2013","007"
"6951","BERCETO",46,125,0,171,"2013","004"
"6952","BEREGAZZO CON FIGLIARO",24,0,0,24,"2013","022"
"6953","BEREGUARDO",46,697,0,743,"2013","014"
"6954","BERGAMASCO",96,0,0,96,"2013","015"
"6955","BERGAMO",137,129,0,266,"2013","024"
"6956","BERGOLO",4,0,0,4,"2013","021"
"6957","BERLINGO",2274,281,3,2558,"2013","015"
"6958","BERNAREGGIO",0,12,0,12,"2013",NA
"6959","BERNATE TICINO",232,180,0,412,"2013","019"
"6960","BERNEZZO",312,51,0,363,"2013","022"
"6961","BERRA",1321,80,0,1401,"2013","002"
"6962","BERTINORO",152,11,0,163,"2013","003"
"6963","BERTONICO",53,2465,0,2518,"2013","002"
"6964","BERZANO DI SAN PIETRO",6,0,0,6,"2013","009"
"6965","BERZO DEMO",17,44,3,64,"2013","016"
"6966","BERZO INFERIORE",10,154,3,167,"2013","017"
"6967","BERZO SAN FERMO",918,81,22,1021,"2013","025"
"6968","BESANA IN BRIANZA",969,110,1,1080,"2013",NA
"6969","BESANO",57,10,0,67,"2013","011"
"6970","BESATE",161,0,0,161,"2013","022"
"6971","BESENZONE",104,1393,0,1497,"2013","003"
"6972","BESNATE",6,191,0,197,"2013","012"
"6973","BESOZZO",21,63,0,84,"2013","013"
"6974","BETTOLA",220,135,0,355,"2013","004"
"6975","BEURA-CARDEZZA",6,11,0,17,"2013","011"
"6976","BEVILACQUA",127,58,0,185,"2013","008"
"6977","BIANDRONNO",15,0,0,15,"2013","014"
"6978","BIANZANO",5,20,0,25,"2013","026"
"6979","BIANZE'",122,214,0,336,"2013","011"
"6980","BIANZONE",3,21,0,24,"2013","008"
"6981","BIASSONO",6,0,2,8,"2013",NA
"6982","BIBBIANO",15,2151,0,2166,"2013","004"
"6983","BIBIANA",578,0,9,587,"2013","025"
"6984","BIELLA",100,39,173,312,"2013","004"
"6985","BIENNO",3,73,1,77,"2013","018"
"6986","BIGARELLO",2731,217,600,3548,"2013","004"
"6987","BINAGO",34,98,76,208,"2013","023"
"6988","BIOGLIO",10,0,0,10,"2013","005"
"6989","BIONE",15,8,0,23,"2013","019"
"6990","BISTAGNO",26,0,0,26,"2013","017"
"6991","BISUSCHIO",1,0,0,1,"2013","015"
"6992","BIZZARONE",15,29,0,44,"2013","024"
"6993","BLELLO",19,24,0,43,"2013","027"
"6994","BLESSAGNO",1,0,5,6,"2013","025"
"6995","BOARA PISANI",2,0,0,2,"2013","012"
"6996","BOBBIO",136,44,0,180,"2013","005"
"6997","BOBBIO PELLICE",50,8,119,177,"2013","026"
"6998","BOCA",2,0,0,2,"2013","019"
"6999","BOCCIOLETO",2,0,0,2,"2013","014"
"7000","BOFFALORA D'ADDA",116,337,11,464,"2013","003"
"7001","BOFFALORA SOPRA TICINO",191,173,0,364,"2013","026"
"7002","BOGOGNO",1,0,0,1,"2013",NA
"7003","BOLGARE",62,308,0,370,"2013","028"
"7004","BOLLATE",0,260,0,260,"2013","027"
"7005","BOLLENGO",60,46,0,106,"2013","027"
"7006","BOLOGNA",16,35,0,51,"2013","006"
"7007","BOLTIERE",29,86,0,115,"2013","029"
"7008","BOLZANO NOVARESE",0,24,0,24,"2013","022"
"7009","BOLZANO VICENTINO",192,1405,18,1615,"2013","013"
"7010","BOMPORTO",1247,100,0,1347,"2013","002"
"7011","BONATE SOPRA",225,12,0,237,"2013","030"
"7012","BONATE SOTTO",61,0,0,61,"2013","031"
"7013","BONAVIGO",2963,31,0,2994,"2013","009"
"7014","BONDENO",547,375,0,922,"2013","003"
"7015","BONEMERSE",37,185,0,222,"2013","006"
"7016","BORDOLANO",26,565,0,591,"2013","007"
"7017","BORE",69,13,0,82,"2013","005"
"7018","BORETTO",0,316,0,316,"2013","005"
"7019","BORGARELLO",2,0,0,2,"2013","015"
"7020","BORGARO TORINESE",74,89,25,188,"2013","028"
"7021","BORGHETTO DI BORBERA",152,5,0,157,"2013","018"
"7022","BORGHETTO LODIGIANO",22,1555,25,1602,"2013","004"
"7023","BORGHI",1197,0,0,1197,"2013","004"
"7024","BORGIALLO",3,33,0,36,"2013","029"
"7025","BORGO D'ALE",94,0,118,212,"2013","015"
"7026","BORGO DI TERZO",5,0,0,5,"2013","032"
"7027","BORGO PRIOLO",9,0,0,9,"2013","016"
"7028","BORGO SAN DALMAZZO",343,86,71,500,"2013","025"
"7029","BORGO SAN GIACOMO",1873,3267,8,5148,"2013","020"
"7030","BORGO SAN GIOVANNI",7,791,0,798,"2013","005"
"7031","BORGO SAN SIRO",3,601,0,604,"2013","018"
"7032","BORGO TICINO",43,0,0,43,"2013","025"
"7033","BORGO TOSSIGNANO",8,0,0,8,"2013","007"
"7034","BORGO VAL DI TARO",113,229,0,342,"2013","006"
"7035","BORGO VERCELLI",0,38,0,38,"2013","017"
"7036","BORGOFORTE",33,2505,1187,3725,"2013","005"
"7037","BORGOFRANCO D'IVREA",181,19,0,200,"2013","030"
"7038","BORGOFRANCO SUL PO",4,18,49,71,"2013","006"
"7039","BORGOLAVEZZARO",5,0,0,5,"2013","023"
"7040","BORGOMALE",127,0,0,127,"2013","024"
"7041","BORGOMANERO",117,35,0,152,"2013","024"
"7042","BORGOMASINO",22,0,0,22,"2013","031"
"7043","BORGONE SUSA",23,17,0,40,"2013","032"
"7044","BORGONOVO VAL TIDONE",679,1663,0,2342,"2013","006"
"7045","BORGORATTO ALESSANDRINO",25,0,0,25,"2013","019"
"7046","BORGORATTO MORMOROLO",26,0,0,26,"2013","017"
"7047","BORGORICCO",97,37,0,134,"2013","013"
"7048","BORGOSATOLLO",10,593,21,624,"2013","021"
"7049","BORGOSESIA",47,19,0,66,"2013","016"
"7050","BORMIO",13,331,26,370,"2013","009"
"7051","BORNASCO",133,519,0,652,"2013","019"
"7052","BORNO",5,153,19,177,"2013","022"
"7053","BORRIANA",79,34,28,141,"2013","006"
"7054","BORSO DEL GRAPPA",131,206,11,348,"2013","004"
"7055","BOSARO",4,0,0,4,"2013","007"
"7056","BOSCHI SANT'ANNA",7,27,0,34,"2013","010"
"7057","BOSCO CHIESANUOVA",376,1438,0,1814,"2013","011"
"7058","BOSCO MARENGO",90,26,0,116,"2013","021"
"7059","BOSCONERO",60,40,0,100,"2013","033"
"7060","BOSIA",406,0,0,406,"2013","026"
"7061","BOSIO",38,0,2,40,"2013","022"
"7062","BOSISIO PARINI",3,114,1,118,"2013","009"
"7063","BOSSICO",28,91,0,119,"2013","033"
"7064","BOSSOLASCO",74,86,0,160,"2013","027"
"7065","BOTTANUCO",22,195,435,652,"2013","034"
"7066","BOTTICINO",44,0,0,44,"2013","023"
"7067","BOVEGNO",79,112,5,196,"2013","024"
"7068","BOVES",800,569,292,1661,"2013","028"
"7069","BOVEZZO",1,0,0,1,"2013","025"
"7070","BOVOLENTA",3337,362,0,3699,"2013","014"
"7071","BOVOLONE",3743,386,0,4129,"2013","012"
"7072","BOZZOLO",96,956,12,1064,"2013","007"
"7073","BRA",3863,1198,32,5093,"2013","029"
"7074","BRACCA",5,0,0,5,"2013","035"
"7075","BRALLO DI PREGOLA",8,14,0,22,"2013","021"
"7076","BRANDICO",1,223,0,224,"2013","026"
"7077","BRANDIZZO",16,60,0,76,"2013","034"
"7078","BRANZI",2,34,1,37,"2013","036"
"7079","BRAONE",0,30,0,30,"2013","027"
"7080","BREBBIA",94,0,0,94,"2013","017"
"7081","BREDA DI PIAVE",79,390,5,474,"2013","005"
"7082","BREGANO",8,0,0,8,"2013","018"
"7083","BREGANZE",352,805,149,1306,"2013","014"
"7084","BREGNANO",9,104,0,113,"2013","028"
"7085","BREIA",2,0,0,2,"2013","019"
"7086","BREMBATE",21,0,183,204,"2013","037"
"7087","BREMBATE DI SOPRA",2,189,0,191,"2013","038"
"7088","BREMBILLA",54,43,0,97,"2013","039"
"7089","BREMBIO",76,1600,88,1764,"2013","006"
"7090","BREME",23,0,0,23,"2013","022"
"7091","BRENDOLA",249,123,0,372,"2013","015"
"7092","BRENNA",4,0,0,4,"2013","029"
"7093","BRENO",5,293,9,307,"2013","028"
"7094","BRENTA",10,0,0,10,"2013","019"
"7095","BRENTINO BELLUNO",7,0,0,7,"2013","013"
"7096","BRENZONE",10,0,0,10,"2013","014"
"7097","BRESCELLO",12,41,20,73,"2013","006"
"7098","BRESCIA",157,626,0,783,"2013","029"
"7099","BRESSANA BOTTARONE",4,0,0,4,"2013","023"
"7100","BRESSANVIDO",38,1404,0,1442,"2013","016"
"7101","BREZZO DI BEDERO",10,0,0,10,"2013","020"
"7102","BRIAGLIA",76,0,0,76,"2013","030"
"7103","BRICHERASIO",985,58,30,1073,"2013","035"
"7104","BRIGA NOVARESE",9,66,0,75,"2013","026"
"7105","BRIGNANO GERA D'ADDA",162,1601,0,1763,"2013","040"
"7106","BRIGNANO-FRASCATA",4,0,0,4,"2013","024"
"7107","BRINZIO",6,0,0,6,"2013","021"
"7108","BRIONA",8,1483,0,1491,"2013","027"
"7109","BRIONE",9,0,0,9,"2013","030"
"7110","BRIOSCO",5,0,0,5,"2013",NA
"7111","BRISIGHELLA",319,81,0,400,"2013","004"
"7112","BRISSAGO-VALTRAVAGLIA",2,0,0,2,"2013","022"
"7113","BRIVIO",42,89,0,131,"2013","010"
"7114","BROGLIANO",40,36,0,76,"2013","017"
"7115","BRONDELLO",4,0,0,4,"2013","032"
"7116","BRONI",117,0,0,117,"2013","024"
"7117","BROSSASCO",83,0,0,83,"2013","033"
"7118","BROSSO",35,23,0,58,"2013","036"
"7119","BROVELLO-CARPUGNINO",12,0,8,20,"2013","013"
"7120","BROZOLO",76,0,0,76,"2013","037"
"7121","BRUGHERIO",6,280,0,286,"2013",NA
"7122","BRUGINE",3745,91,62,3898,"2013","015"
"7123","BRUINO",203,0,0,203,"2013","038"
"7124","BRUMANO",8,16,0,24,"2013","041"
"7125","BRUNELLO",20,3,0,23,"2013","023"
"7126","BRUNO",20,0,0,20,"2013","010"
"7127","BRUSAPORTO",43,0,30,73,"2013","042"
"7128","BRUSASCO",89,0,0,89,"2013","039"
"7129","BRUSNENGO",21,0,0,21,"2013","007"
"7130","BRUZOLO",75,11,8,94,"2013","040"
"7131","BUBBIANO",2,29,0,31,"2013","035"
"7132","BUBBIO",77,0,0,77,"2013","011"
"7133","BUCCINASCO",4,453,0,457,"2013","036"
"7134","BUDRIO",316,425,0,741,"2013","008"
"7135","BUGLIO IN MONTE",16,221,37,274,"2013","010"
"7136","BUGUGGIATE",8,0,0,8,"2013","025"
"7137","BULCIAGO",14,0,193,207,"2013","011"
"7138","BULGAROGRASSO",38,292,4,334,"2013","034"
"7139","BURIASCO",1221,716,254,2191,"2013","041"
"7140","BUROLO",9,0,0,9,"2013","042"
"7141","BURONZO",2,10,0,12,"2013","021"
"7142","BUSANA",0,32,0,32,"2013","007"
"7143","BUSANO",25,54,0,79,"2013","043"
"7144","BUSCA",4527,1092,731,6350,"2013","034"
"7145","BUSCATE",63,0,0,63,"2013","038"
"7146","BUSNAGO",4,5,0,9,"2013",NA
"7147","BUSSERO",1,603,0,604,"2013","040"
"7148","BUSSETO",21,3319,0,3340,"2013","007"
"7149","BUSSOLENGO",2156,131,61,2348,"2013","015"
"7150","BUSSOLENO",42,260,0,302,"2013","044"
"7151","BUSTO ARSIZIO",37,245,24,306,"2013","026"
"7152","BUSTO GAROLFO",94,222,0,316,"2013","041"
"7153","BUTTAPIETRA",14,265,2,281,"2013","016"
"7154","BUTTIGLIERA ALTA",73,44,0,117,"2013","045"
"7155","BUTTIGLIERA D'ASTI",1833,101,63,1997,"2013","012"
"7156","CA' D'ANDREA",8,1210,0,1218,"2013","008"
"7157","CABELLA LIGURE",77,0,0,77,"2013","025"
"7158","CADEGLIANO-VICONAGO",2,0,0,2,"2013","027"
"7159","CADELBOSCO DI SOPRA",28,1815,3,1846,"2013","008"
"7160","CADEO",64,2221,0,2285,"2013","007"
"7161","CADONEGHE",14,5,17,36,"2013","016"
"7162","CADORAGO",1,1,55,57,"2013","036"
"7163","CADREZZATE",2,0,0,2,"2013","028"
"7164","CAERANO DI SAN MARCO",265,111,6,382,"2013","006"
"7165","CAFASSE",96,15,0,111,"2013","046"
"7166","CAGLIO",9,2,0,11,"2013","037"
"7167","CAGNO",0,18,0,18,"2013","038"
"7168","CAINO",8,0,0,8,"2013","031"
"7169","CAIOLO",7,74,0,81,"2013","011"
"7170","CAIRATE",4,0,2,6,"2013","029"
"7171","CALAMANDRANA",103,0,0,103,"2013","013"
"7172","CALASCA-CASTIGLIONE",20,0,0,20,"2013","014"
"7173","CALCINATE",210,235,0,445,"2013","043"
"7174","CALCINATO",3094,1857,873,5824,"2013","032"
"7175","CALCIO",201,1484,0,1685,"2013","044"
"7176","CALCO",16,163,0,179,"2013","012"
"7177","CALDERARA DI RENO",58,80,0,138,"2013","009"
"7178","CALDIERO",1,0,0,1,"2013","017"
"7179","CALDOGNO",160,356,16,532,"2013","018"
"7180","CALENDASCO",128,378,0,506,"2013","008"
"7181","CALESTANO",13,472,0,485,"2013","008"
"7182","CALLABIANA",15,0,0,15,"2013","008"
"7183","CALLIANO",242,0,0,242,"2013","014"
"7184","CALOLZIOCORTE",13,0,14,27,"2013","013"
"7185","CALOSSO",15,0,0,15,"2013","015"
"7186","CALTIGNAGA",910,221,0,1131,"2013","030"
"7187","CALTO",28,0,0,28,"2013","008"
"7188","CALTRANO",1722,0,0,1722,"2013","019"
"7189","CALUSCO D'ADDA",16,0,0,16,"2013","046"
"7190","CALUSO",698,176,0,874,"2013","047"
"7191","CALVAGESE DELLA RIVIERA",66,179,0,245,"2013","033"
"7192","CALVATONE",17,117,3,137,"2013","009"
"7193","CALVENE",6,74,0,80,"2013","020"
"7194","CALVENZANO",79,433,0,512,"2013","047"
"7195","CALVIGNASCO",1,38,0,39,"2013","042"
"7196","CALVISANO",11377,4223,51,15651,"2013","034"
"7197","CAMAGNA MONFERRATO",29,0,0,29,"2013","026"
"7198","CAMAIRAGO",0,1213,0,1213,"2013","007"
"7199","CAMANDONA",3,0,0,3,"2013","009"
"7200","CAMBIAGO",22,101,0,123,"2013","044"
"7201","CAMBIANO",322,0,0,322,"2013","048"
"7202","CAMBIASCA",7,0,0,7,"2013","015"
"7203","CAMBURZANO",81,0,14,95,"2013","010"
"7204","CAMERANA",302,0,0,302,"2013","035"
"7205","CAMERANO CASASCO",25,0,0,25,"2013","016"
"7206","CAMERATA CORNELLO",6,55,0,61,"2013","048"
"7207","CAMERI",98,521,39,658,"2013","032"
"7208","CAMINATA",25,0,0,25,"2013","009"
"7209","CAMISANO",195,2764,0,2959,"2013","010"
"7210","CAMISANO VICENTINO",415,1389,31,1835,"2013","021"
"7211","CAMPAGNA LUPIA",119,115,0,234,"2013","002"
"7212","CAMPAGNOLA CREMASCA",142,448,0,590,"2013","011"
"7213","CAMPAGNOLA EMILIA",8,771,0,779,"2013","009"
"7214","CAMPEGINE",9,1040,0,1049,"2013","010"
"7215","CAMPERTOGNO",147,37,20,204,"2013","025"
"7216","CAMPIGLIA CERVO",0,0,9,9,"2013","011"
"7217","CAMPIGLIA DEI BERICI",776,156,0,932,"2013","022"
"7218","CAMPIGLIONE-FENILE",751,0,73,824,"2013","049"
"7219","CAMPO SAN MARTINO",96,116,0,212,"2013","020"
"7220","CAMPODARSEGO",733,91,0,824,"2013","017"
"7221","CAMPODORO",73,306,0,379,"2013","018"
"7222","CAMPOGALLIANO",0,535,0,535,"2013","003"
"7223","CAMPOLONGO MAGGIORE",47,52,0,99,"2013","003"
"7224","CAMPOLONGO SUL BRENTA",25,0,0,25,"2013","023"
"7225","CAMPONOGARA",127,46,13,186,"2013","004"
"7226","CAMPOSAMPIERO",262,115,0,377,"2013","019"
"7227","CAMPOSPINOSO",1,0,0,1,"2013","026"
"7228","CAMUGNANO",165,135,0,300,"2013","010"
"7229","CANALE",681,0,0,681,"2013","037"
"7230","CANARO",248,29,0,277,"2013","009"
"7231","CANDA",20,0,0,20,"2013","010"
"7232","CANDELO",85,97,49,231,"2013","012"
"7233","CANDIA CANAVESE",26,0,0,26,"2013","050"
"7234","CANDIANA",10501,245,0,10746,"2013","021"
"7235","CANDIOLO",144,521,48,713,"2013","051"
"7236","CANEGRATE",1,0,0,1,"2013","046"
"7237","CANELLI",12,0,0,12,"2013","017"
"7238","CANEVINO",17,0,0,17,"2013","028"
"7239","CANISCHIO",4,0,0,4,"2013","052"
"7240","CANNERO RIVIERA",2,0,0,2,"2013","016"
"7241","CANNETO SULL'OGLIO",1359,1485,1061,3905,"2013","008"
"7242","CANNOBIO",11,0,0,11,"2013","017"
"7243","CANONICA D'ADDA",27,354,0,381,"2013","049"
"7244","CANOSIO",11,0,27,38,"2013","038"
"7245","CANOSSA",31,328,0,359,"2013","018"
"7246","CANTALUPA",110,0,0,110,"2013","053"
"7247","CANTALUPO LIGURE",27,0,0,27,"2013","028"
"7248","CANTARANA",97,0,0,97,"2013","018"
"7249","CANTELLO",136,158,0,294,"2013","030"
"7250","CANTOIRA",61,16,13,90,"2013","054"
"7251","CANTU'",214,255,8,477,"2013","041"
"7252","CANZO",1,0,10,11,"2013","042"
"7253","CAORLE",678,87,0,765,"2013","005"
"7254","CAORSO",33,430,0,463,"2013","010"
"7255","CAPERGNANICA",301,1206,0,1507,"2013","012"
"7256","CAPIAGO INTIMIANO",8,24,1,33,"2013","043"
"7257","CAPIZZONE",11,13,0,24,"2013","050"
"7258","CAPO DI PONTE",25,67,0,92,"2013","035"
"7259","CAPONAGO",57,0,0,57,"2013",NA
"7260","CAPOVALLE",20,10,1,31,"2013","036"
"7261","CAPPELLA CANTONE",0,535,0,535,"2013","013"
"7262","CAPPELLA DE' PICENARDI",9,356,0,365,"2013","014"
"7263","CAPPELLA MAGGIORE",33,26,0,59,"2013","007"
"7264","CAPRALBA",2,1522,0,1524,"2013","015"
"7265","CAPRAUNA",6,0,0,6,"2013","039"
"7266","CAPRIANO DEL COLLE",15,935,0,950,"2013","037"
"7267","CAPRIATA D'ORBA",47,0,0,47,"2013","029"
"7268","CAPRIATE SAN GERVASIO",1,0,0,1,"2013",NA
"7269","CAPRIE",22,0,0,22,"2013","055"
"7270","CAPRIGLIO",2,0,0,2,"2013","019"
"7271","CAPRILE",32,6,0,38,"2013","013"
"7272","CAPRINO BERGAMASCO",27,33,0,60,"2013","052"
"7273","CAPRINO VERONESE",138,711,27,876,"2013","018"
"7274","CAPRIOLO",312,36,38,386,"2013","038"
"7275","CARAGLIO",3010,789,320,4119,"2013","040"
"7276","CARAMAGNA PIEMONTE",934,543,40,1517,"2013","041"
"7277","CARAVAGGIO",360,2903,48,3311,"2013","053"
"7278","CARAVATE",3,109,0,112,"2013","031"
"7279","CARAVINO",3,0,0,3,"2013","056"
"7280","CARBONARA AL TICINO",0,209,0,209,"2013","030"
"7281","CARBONARA DI PO",0,277,239,516,"2013","009"
"7282","CARBONARA SCRIVIA",27,0,0,27,"2013","030"
"7283","CARBONATE",92,31,18,141,"2013","045"
"7284","CARBONERA",89,387,0,476,"2013","008"
"7285","CARCERI",786,0,0,786,"2013","022"
"7286","CARCOFORO",0,1,0,1,"2013","029"
"7287","CARDANO AL CAMPO",10,0,0,10,"2013","032"
"7288","CARDE'",2681,1703,0,4384,"2013","042"
"7289","CAREMA",66,10,0,76,"2013","057"
"7290","CARENNO",26,0,7,33,"2013","014"
"7291","CARENTINO",148,535,0,683,"2013","031"
"7292","CARESANA",6,0,0,6,"2013","030"
"7293","CAREZZANO",5,0,0,5,"2013","032"
"7294","CARIGNANO",3125,1468,225,4818,"2013","058"
"7295","CARISIO",37,0,0,37,"2013","032"
"7296","CARLAZZO",11,52,32,95,"2013","047"
"7297","CARMAGNOLA",6199,2655,136,8990,"2013","059"
"7298","CARMIGNANO DI BRENTA",229,1416,0,1645,"2013","023"
"7299","CARNAGO",18,49,0,67,"2013","033"
"7300","CAROBBIO DEGLI ANGELI",86,25,0,111,"2013","055"
"7301","CARONNO PERTUSELLA",4,0,0,4,"2013","034"
"7302","CARONNO VARESINO",19,0,0,19,"2013","035"
"7303","CARPANETO PIACENTINO",136,3666,0,3802,"2013","011"
"7304","CARPENEDOLO",1742,3948,8,5698,"2013","039"
"7305","CARPENETO",137,0,0,137,"2013","033"
"7306","CARPI",12,1870,0,1882,"2013","005"
"7307","CARPIANO",108,1232,0,1340,"2013","050"
"7308","CARPIGNANO SESIA",85,9,0,94,"2013","036"
"7309","CARPINETI",130,1507,7,1644,"2013","011"
"7310","CARRE'",404,155,0,559,"2013","024"
"7311","CARREGA LIGURE",41,0,0,41,"2013","034"
"7312","CARROSIO",2,0,0,2,"2013","035"
"7313","CARRU'",777,41,0,818,"2013","043"
"7314","CARTIGLIANO",17,51,0,68,"2013","025"
"7315","CARTIGNANO",188,57,0,245,"2013","044"
"7316","CARTOSIO",56,0,0,56,"2013","036"
"7317","CARTURA",475,23,0,498,"2013","026"
"7318","CARUGATE",1,105,0,106,"2013","051"
"7319","CARUGO",6,0,0,6,"2013","048"
"7320","CARVICO",15,0,0,15,"2013","057"
"7321","CASAL CERMELLI",9,0,0,9,"2013","037"
"7322","CASALBELTRAME",2,0,147,149,"2013","037"
"7323","CASALBORGONE",77,0,0,77,"2013","060"
"7324","CASALBUTTANO ED UNITI",16,1214,0,1230,"2013","016"
"7325","CASALE CORTE CERRO",11,0,0,11,"2013","019"
"7326","CASALE CREMASCO-VIDOLASCO",58,1511,0,1569,"2013","017"
"7327","CASALE DI SCODOSIA",547,0,0,547,"2013","027"
"7328","CASALE LITTA",23,147,2,172,"2013","036"
"7329","CASALE MONFERRATO",158,203,0,361,"2013","039"
"7330","CASALE SUL SILE",114,173,0,287,"2013","009"
"7331","CASALECCHIO DI RENO",1,0,0,1,"2013","011"
"7332","CASALEGGIO BOIRO",5,0,0,5,"2013","038"
"7333","CASALEONE",76,0,0,76,"2013","019"
"7334","CASALETTO CEREDANO",9,0,0,9,"2013","018"
"7335","CASALETTO DI SOPRA",9,315,0,324,"2013","019"
"7336","CASALETTO LODIGIANO",10,415,46,471,"2013","008"
"7337","CASALETTO VAPRIO",88,662,0,750,"2013","020"
"7338","CASALFIUMANESE",326,159,0,485,"2013","012"
"7339","CASALGRANDE",14,1102,0,1116,"2013","012"
"7340","CASALGRASSO",172,432,0,604,"2013","045"
"7341","CASALINO",5,432,0,437,"2013","040"
"7342","CASALMAGGIORE",15,734,1,750,"2013","021"
"7343","CASALMAIOCCO",75,571,0,646,"2013","009"
"7344","CASALMORANO",92,1897,0,1989,"2013","022"
"7345","CASALMORO",956,243,283,1482,"2013","010"
"7346","CASALNOCETO",13,0,0,13,"2013","040"
"7347","CASALOLDO",936,1043,824,2803,"2013","011"
"7348","CASALPUSTERLENGO",0,1153,0,1153,"2013","010"
"7349","CASALROMANO",70,260,167,497,"2013","012"
"7350","CASALSERUGO",110,16,57,183,"2013","028"
"7351","CASALVOLONE",6,53,0,59,"2013","041"
"7352","CASALZUIGNO",3,98,0,101,"2013","037"
"7353","CASARGO",12,6,0,18,"2013","015"
"7354","CASARILE",19,31,0,50,"2013","055"
"7355","CASATENOVO",277,20,0,297,"2013","016"
"7356","CASAZZA",16,12,12,40,"2013","058"
"7357","CASCIAGO",34,27,0,61,"2013","038"
"7358","CASEI GEROLA",650,0,0,650,"2013","033"
"7359","CASELETTE",98,329,28,455,"2013","062"
"7360","CASELLE LANDI",322,479,0,801,"2013","011"
"7361","CASELLE LURANI",114,222,0,336,"2013","012"
"7362","CASELLE TORINESE",267,1328,0,1595,"2013","063"
"7363","CASIER",12,108,0,120,"2013","010"
"7364","CASINA",160,923,0,1083,"2013","013"
"7365","CASIRATE D'ADDA",190,396,0,586,"2013","059"
"7366","CASLINO D'ERBA",0,15,3,18,"2013","052"
"7367","CASNATE CON BERNATE",65,0,0,65,"2013","053"
"7368","CASNIGO",51,154,0,205,"2013","060"
"7369","CASOLA VALSENIO",145,76,0,221,"2013","005"
"7370","CASORATE PRIMO",14,126,0,140,"2013","034"
"7371","CASORATE SEMPIONE",1,0,0,1,"2013","039"
"7372","CASOREZZO",3,300,0,303,"2013","058"
"7373","CASORZO",5,0,0,5,"2013","020"
"7374","CASPOGGIO",0,38,0,38,"2013","013"
"7375","CASSAGO BRIANZA",4,41,2,47,"2013","017"
"7376","CASSANO D'ADDA",195,261,0,456,"2013","059"
"7377","CASSANO MAGNAGO",23,103,18,144,"2013","040"
"7378","CASSANO SPINOLA",397,0,0,397,"2013","042"
"7379","CASSINA DE' PECCHI",0,455,0,455,"2013","060"
"7380","CASSINA RIZZARDI",1,0,0,1,"2013","055"
"7381","CASSINA VALSASSINA",6,68,0,74,"2013","018"
"7382","CASSINASCO",38,24,0,62,"2013","021"
"7383","CASSINE",160,0,0,160,"2013","043"
"7384","CASSINELLE",7,0,0,7,"2013","044"
"7385","CASSINETTA DI LUGAGNANO",6,160,0,166,"2013","061"
"7386","CASSOLA",1058,22,0,1080,"2013","026"
"7387","CASSOLNOVO",27,51,0,78,"2013","035"
"7388","CASTAGNARO",362,0,0,362,"2013","020"
"7389","CASTAGNETO PO",48,0,0,48,"2013","064"
"7390","CASTAGNITO",221,0,0,221,"2013","046"
"7391","CASTAGNOLE DELLE LANZE",292,0,0,292,"2013","022"
"7392","CASTAGNOLE MONFERRATO",55,0,0,55,"2013","023"
"7393","CASTAGNOLE PIEMONTE",1328,960,0,2288,"2013","065"
"7394","CASTANA",5,0,0,5,"2013","036"
"7395","CASTANO PRIMO",86,0,0,86,"2013","062"
"7396","CASTEGGIO",22,0,0,22,"2013","037"
"7397","CASTEGNATO",33,972,24,1029,"2013","040"
"7398","CASTEGNERO",95,60,1,156,"2013","027"
"7399","CASTEL BOGLIONE",33,0,0,33,"2013","024"
"7400","CASTEL BOLOGNESE",31,0,0,31,"2013","006"
"7401","CASTEL D'AIANO",50,528,28,606,"2013","013"
"7402","CASTEL D'ARIO",0,288,719,1007,"2013","014"
"7403","CASTEL D'AZZANO",2238,142,0,2380,"2013","021"
"7404","CASTEL DEL RIO",6,31,0,37,"2013","014"
"7405","CASTEL DI CASIO",58,21,0,79,"2013","015"
"7406","CASTEL GABBIANO",0,1384,0,1384,"2013","024"
"7407","CASTEL GOFFREDO",2362,333,532,3227,"2013","015"
"7408","CASTEL GUELFO DI BOLOGNA",108,280,0,388,"2013","016"
"7409","CASTEL MAGGIORE",8,0,0,8,"2013","019"
"7410","CASTEL MELLA",3,377,0,380,"2013","042"
"7411","CASTEL ROCCHERO",20,0,0,20,"2013","032"
"7412","CASTEL ROZZONE",6,43,0,49,"2013","063"
"7413","CASTEL SAN GIOVANNI",153,944,0,1097,"2013","013"
"7414","CASTEL SAN PIETRO TERME",480,313,0,793,"2013","020"
"7415","CASTELBALDO",7,0,0,7,"2013","029"
"7416","CASTELBELFORTE",1257,35,0,1292,"2013","013"
"7417","CASTELCOVATI",10,289,0,299,"2013","041"
"7418","CASTELCUCCO",36,242,0,278,"2013","011"
"7419","CASTELDELCI",150,0,1,151,"2013","021"
"7420","CASTELDELFINO",57,0,0,57,"2013","047"
"7421","CASTELDIDONE",48,0,0,48,"2013","023"
"7422","CASTELFRANCO EMILIA",1166,2591,0,3757,"2013","006"
"7423","CASTELFRANCO VENETO",5293,194,10,5497,"2013","012"
"7424","CASTELGOMBERTO",458,483,0,941,"2013","028"
"7425","CASTELGUGLIELMO",426,0,0,426,"2013","011"
"7426","CASTELL'ALFERO",412,0,0,412,"2013","025"
"7427","CASTELL'ARQUATO",145,759,0,904,"2013","012"
"7428","CASTELLAMONTE",318,316,2,636,"2013","066"
"7429","CASTELLAR",3,8,0,11,"2013","048"
"7430","CASTELLARANO",18,280,0,298,"2013","014"
"7431","CASTELLAVAZZO",2,0,0,2,"2013","009"
"7432","CASTELLAZZO BORMIDA",114,28,0,142,"2013","047"
"7433","CASTELLAZZO NOVARESE",5,0,0,5,"2013","042"
"7434","CASTELLEONE",811,3643,0,4454,"2013","025"
"7435","CASTELLERO",3,0,0,3,"2013","026"
"7436","CASTELLETTO CERVO",26,0,0,26,"2013","015"
"7437","CASTELLETTO D'ERRO",2,0,0,2,"2013",NA
"7438","CASTELLETTO D'ORBA",10,0,0,10,"2013","049"
"7439","CASTELLETTO DI BRANDUZZO",12,0,0,12,"2013","038"
"7440","CASTELLETTO MERLI",104,0,0,104,"2013","050"
"7441","CASTELLETTO MONFERRATO",109,0,0,109,"2013","051"
"7442","CASTELLETTO SOPRA TICINO",124,55,0,179,"2013","043"
"7443","CASTELLETTO STURA",1202,65,88,1355,"2013","049"
"7444","CASTELLETTO UZZONE",44,0,0,44,"2013","050"
"7445","CASTELLI CALEPIO",50,291,0,341,"2013","062"
"7446","CASTELLINALDO",963,0,0,963,"2013","051"
"7447","CASTELLINO TANARO",140,0,0,140,"2013","052"
"7448","CASTELLO CABIAGLIO",11,0,0,11,"2013","043"
"7449","CASTELLO D'ARGILE",46,74,0,120,"2013","017"
"7450","CASTELLO DELL'ACQUA",16,16,0,32,"2013","014"
"7451","CASTELLO DI ANNONE",128,0,0,128,"2013","028"
"7452","CASTELLO DI BRIANZA",11,0,0,11,"2013","019"
"7453","CASTELLO DI GODEGO",5776,153,0,5929,"2013","013"
"7454","CASTELLO DI SERRAVALLE",68,544,0,612,"2013","018"
"7455","CASTELLUCCHIO",740,1685,1313,3738,"2013","016"
"7456","CASTELMAGNO",63,41,0,104,"2013","053"
"7457","CASTELMARTE",9,1,0,10,"2013","058"
"7458","CASTELMASSA",2,115,0,117,"2013","012"
"7459","CASTELNOVETTO",1,0,0,1,"2013","040"
"7460","CASTELNOVO BARIANO",915,79,0,994,"2013","013"
"7461","CASTELNOVO DI SOTTO",5,1091,3,1099,"2013","015"
"7462","CASTELNOVO NE' MONTI",84,1537,38,1659,"2013","016"
"7463","CASTELNUOVO BELBO",4,0,0,4,"2013","029"
"7464","CASTELNUOVO BOCCA D'ADDA",3069,75,0,3144,"2013","013"
"7465","CASTELNUOVO BORMIDA",21,0,0,21,"2013","052"
"7466","CASTELNUOVO BOZZENTE",9,16,0,25,"2013","059"
"7467","CASTELNUOVO DEL GARDA",2874,286,0,3160,"2013","022"
"7468","CASTELNUOVO DON BOSCO",193,0,0,193,"2013","031"
"7469","CASTELNUOVO NIGRA",37,0,0,37,"2013","067"
"7470","CASTELNUOVO RANGONE",0,801,0,801,"2013","007"
"7471","CASTELNUOVO SCRIVIA",163,0,16,179,"2013","053"
"7472","CASTELSEPRIO",2,0,3,5,"2013","044"
"7473","CASTELSPINA",11,0,0,11,"2013","054"
"7474","CASTELVECCANA",13,0,8,21,"2013","045"
"7475","CASTELVERDE",320,3277,52,3649,"2013","026"
"7476","CASTELVETRO DI MODENA",31,1342,0,1373,"2013","008"
"7477","CASTELVETRO PIACENTINO",601,871,0,1472,"2013","014"
"7478","CASTELVISCONTI",11,1679,0,1690,"2013","027"
"7479","CASTENASO",60,222,0,282,"2013","021"
"7480","CASTENEDOLO",933,1456,0,2389,"2013","043"
"7481","CASTIGLIONE D'ADDA",6,505,0,511,"2013","014"
"7482","CASTIGLIONE D'INTELVI",4,17,4,25,"2013","060"
"7483","CASTIGLIONE DEI PEPOLI",123,82,0,205,"2013","022"
"7484","CASTIGLIONE DELLE STIVIERE",3511,1520,1429,6460,"2013","017"
"7485","CASTIGLIONE FALLETTO",20,0,0,20,"2013","055"
"7486","CASTIGLIONE OLONA",3,8,12,23,"2013","046"
"7487","CASTIGLIONE TINELLA",29,0,0,29,"2013","056"
"7488","CASTIGLIONE TORINESE",9,0,0,9,"2013","068"
"7489","CASTINO",164,0,0,164,"2013","057"
"7490","CASTIONE ANDEVENNO",18,31,0,49,"2013","015"
"7491","CASTIONE DELLA PRESOLANA",33,7,0,40,"2013","064"
"7492","CASTIRAGA VIDARDO",5,310,0,315,"2013","015"
"7493","CASTO",28,36,2,66,"2013","044"
"7494","CASTREZZATO",333,1085,0,1418,"2013","045"
"7495","CASTRO",1,0,0,1,"2013","065"
"7496","CASTROCARO TERME E TERRA DEL SOLE",10,15,1,26,"2013","005"
"7497","CASTRONNO",2,0,0,2,"2013","047"
"7498","CAVACURTA",55,410,0,465,"2013","016"
"7499","CAVAGLIA'",1239,196,8,1443,"2013","016"
"7500","CAVAGLIETTO",0,189,0,189,"2013","044"
"7501","CAVAGNOLO",31,0,0,31,"2013","069"
"7502","CAVAION VERONESE",11,0,0,11,"2013","023"
"7503","CAVALLASCA",0,0,17,17,"2013","061"
"7504","CAVALLERLEONE",421,876,77,1374,"2013","058"
"7505","CAVALLERMAGGIORE",2282,2130,36,4448,"2013","059"
"7506","CAVALLINO-TREPORTI",17,0,0,17,"2013","044"
"7507","CAVALLIRIO",3,0,0,3,"2013","047"
"7508","CAVARGNA",0,0,15,15,"2013","062"
"7509","CAVARIA CON PREMEZZO",2,0,1,3,"2013","048"
"7510","CAVARZERE",5920,10,0,5930,"2013","006"
"7511","CAVASO DEL TOMBA",79,122,0,201,"2013","014"
"7512","CAVATORE",5,0,0,5,"2013","055"
"7513","CAVENAGO D'ADDA",7,718,147,872,"2013","017"
"7514","CAVERNAGO",1,0,0,1,"2013","066"
"7515","CAVEZZO",0,281,0,281,"2013","009"
"7516","CAVOUR",2862,278,1028,4168,"2013","070"
"7517","CAVRIAGO",8,583,0,591,"2013","017"
"7518","CAVRIANA",2155,1627,426,4208,"2013","018"
"7519","CAZZAGO SAN MARTINO",3815,273,149,4237,"2013","046"
"7520","CAZZANO DI TRAMIGNA",5,0,0,5,"2013","024"
"7521","CAZZANO SANT'ANDREA",315,7,0,322,"2013","067"
"7522","CECIMA",24,0,0,24,"2013","042"
"7523","CEDEGOLO",3,25,0,28,"2013","047"
"7524","CEDRASCO",0,56,0,56,"2013","016"
"7525","CEGGIA",8,0,0,8,"2013","007"
"7526","CELLA DATI",6,121,24,151,"2013","028"
"7527","CELLA MONTE",188,0,0,188,"2013","056"
"7528","CELLARENGO",343,85,127,555,"2013","033"
"7529","CELLATICA",3,60,0,63,"2013","048"
"7530","CELLE DI MACRA",104,6,0,110,"2013","060"
"7531","CELLE ENOMONDO",178,0,0,178,"2013","034"
"7532","CELLIO",6,0,0,6,"2013","038"
"7533","CENATE SOPRA",21,0,0,21,"2013","068"
"7534","CENATE SOTTO",20,0,0,20,"2013","069"
"7535","CENCENIGHE AGORDINO",0,4,0,4,"2013","010"
"7536","CENE",22,48,0,70,"2013","070"
"7537","CENESELLI",1,203,25,229,"2013","014"
"7538","CENTALLO",6148,603,361,7112,"2013","061"
"7539","CENTO",1,0,0,1,"2013","004"
"7540","CEPPO MORELLI",23,0,0,23,"2013","021"
"7541","CERANO",81,0,0,81,"2013","049"
"7542","CERANO D'INTELVI",8,0,21,29,"2013","063"
"7543","CERANOVA",9,634,0,643,"2013","043"
"7544","CERCENASCO",159,204,0,363,"2013","071"
"7545","CERCINO",16,61,0,77,"2013","017"
"7546","CEREA",1342,192,0,1534,"2013","025"
"7547","CEREGNANO",1,0,0,1,"2013","015"
"7548","CERES",11,0,0,11,"2013","072"
"7549","CERESARA",1290,419,139,1848,"2013","019"
"7550","CERESETO",116,0,0,116,"2013","057"
"7551","CERESOLE ALBA",3059,642,0,3701,"2013","062"
"7552","CERESOLE REALE",0,27,0,27,"2013","073"
"7553","CERETE",12,159,0,171,"2013","071"
"7554","CERETTO LOMELLINA",2,0,0,2,"2013","044"
"7555","CERIANO LAGHETTO",1,47,0,48,"2013",NA
"7556","CERIGNALE",33,0,0,33,"2013","015"
"7557","CERMENATE",1,209,4,214,"2013","064"
"7558","CERNOBBIO",1,0,0,1,"2013",NA
"7559","CERNUSCO LOMBARDONE",19,0,0,19,"2013","020"
"7560","CERNUSCO SUL NAVIGLIO",3,175,0,178,"2013","070"
"7561","CERRETO CASTELLO",22,58,0,80,"2013","017"
"7562","CERRETO D'ASTI",3,0,0,3,"2013","035"
"7563","CERRETO GRUE",19,0,0,19,"2013","058"
"7564","CERRETTO LANGHE",12,0,0,12,"2013","063"
"7565","CERRINA MONFERRATO",39,0,0,39,"2013","059"
"7566","CERRIONE",98,93,324,515,"2013","018"
"7567","CERRO AL LAMBRO",3,723,0,726,"2013","071"
"7568","CERRO MAGGIORE",2,66,0,68,"2013","072"
"7569","CERRO TANARO",292,0,0,292,"2013","036"
"7570","CERRO VERONESE",8,148,0,156,"2013","026"
"7571","CERTOSA DI PAVIA",8,0,0,8,"2013","046"
"7572","CERVARESE SANTA CROCE",45,153,119,317,"2013","030"
"7573","CERVASCA",967,318,2,1287,"2013","064"
"7574","CERVATTO",11,0,0,11,"2013",NA
"7575","CERVENO",14,18,0,32,"2013","049"
"7576","CERVERE",1630,219,172,2021,"2013","065"
"7577","CERVIA",5,0,0,5,"2013","007"
"7578","CERVIGNANO D'ADDA",0,827,0,827,"2013","018"
"7579","CESANA BRIANZA",3,19,0,22,"2013","021"
"7580","CESANA TORINESE",22,0,33,55,"2013","074"
"7581","CESANO BOSCONE",0,90,0,90,"2013","074"
"7582","CESANO MADERNO",2,0,0,2,"2013",NA
"7583","CESARA",2,1,0,3,"2013","022"
"7584","CESENA",85,19,0,104,"2013","007"
"7585","CESENATICO",4,78,0,82,"2013","008"
"7586","CESIOMAGGIORE",283,99,0,382,"2013","011"
"7587","CESSALTO",55,129,23,207,"2013","015"
"7588","CESSOLE",166,0,0,166,"2013","037"
"7589","CETO",6,41,2,49,"2013","050"
"7590","CEVA",944,0,0,944,"2013","066"
"7591","CEVO",36,6,1,43,"2013","051"
"7592","CHERASCO",4377,994,23,5394,"2013","067"
"7593","CHIALAMBERTO",31,48,0,79,"2013","075"
"7594","CHIAMPO",41,82,0,123,"2013","029"
"7595","CHIANOCCO",91,0,0,91,"2013","076"
"7596","CHIARANO",16,489,0,505,"2013","016"
"7597","CHIARI",1235,5076,18,6329,"2013","052"
"7598","CHIAVENNA",4,28,0,32,"2013","018"
"7599","CHIAVERANO",32,0,0,32,"2013","077"
"7600","CHIERI",2553,447,42,3042,"2013","078"
"7601","CHIES D'ALPAGO",17,0,0,17,"2013","012"
"7602","CHIESA IN VALMALENCO",20,61,0,81,"2013","019"
"7603","CHIESANUOVA",41,107,0,148,"2013","079"
"7604","CHIEVE",44,929,0,973,"2013","029"
"7605","CHIGNOLO D'ISOLA",50,325,0,375,"2013","072"
"7606","CHIGNOLO PO",35,82,0,117,"2013","048"
"7607","CHIOGGIA",2463,0,0,2463,"2013","008"
"7608","CHIOMONTE",2,23,0,25,"2013","080"
"7609","CHIUDUNO",49,4,0,53,"2013","073"
"7610","CHIUPPANO",22,42,0,64,"2013","030"
"7611","CHIURO",0,80,0,80,"2013","020"
"7612","CHIUSA DI PESIO",1309,303,237,1849,"2013","068"
"7613","CHIUSA DI SAN MICHELE",0,0,64,64,"2013","081"
"7614","CHIUSANO D'ASTI",25,0,0,25,"2013","038"
"7615","CHIVASSO",1494,260,0,1754,"2013","082"
"7616","CICOGNOLO",0,804,0,804,"2013","030"
"7617","CICONIO",92,94,0,186,"2013","083"
"7618","CIGLIANO",286,69,37,392,"2013","042"
"7619","CIGLIE'",398,0,0,398,"2013","069"
"7620","CIGOGNOLA",23,0,0,23,"2013","049"
"7621","CIGOLE",1148,1413,0,2561,"2013","053"
"7622","CILAVEGNA",21,35,0,56,"2013","050"
"7623","CIMADOLMO",19,156,0,175,"2013","017"
"7624","CIMBERGO",4,1,0,5,"2013","054"
"7625","CINAGLIO",787,0,0,787,"2013","039"
"7626","CINGIA DE' BOTTI",17,1063,0,1080,"2013","031"
"7627","CINO",8,9,0,17,"2013","021"
"7628","CINTANO",32,2,0,34,"2013","084"
"7629","CINTO CAOMAGGIORE",458,9,20,487,"2013","009"
"7630","CINTO EUGANEO",89,28,0,117,"2013","031"
"7631","CINZANO",16,0,0,16,"2013","085"
"7632","CIRIE'",227,261,0,488,"2013","086"
"7633","CIRIMIDO",1,32,0,33,"2013","068"
"7634","CISANO BERGAMASCO",18,0,0,18,"2013","074"
"7635","CISERANO",15,40,0,55,"2013","075"
"7636","CISLAGO",46,0,0,46,"2013","050"
"7637","CISLIANO",165,417,0,582,"2013","078"
"7638","CISMON DEL GRAPPA",2,5,0,7,"2013","031"
"7639","CISON DI VALMARINO",86,32,0,118,"2013","018"
"7640","CISSONE",5,0,0,5,"2013","070"
"7641","CISTERNA D'ASTI",50,0,0,50,"2013","040"
"7642","CITTADELLA",2026,1092,101,3219,"2013","032"
"7643","CITTIGLIO",23,15,0,38,"2013","051"
"7644","CIVATE",13,0,0,13,"2013","022"
"7645","CIVENNA",6,28,0,34,"2013","070"
"7646","CIVIASCO",2,6,0,8,"2013","043"
"7647","CIVIDATE AL PIANO",619,659,0,1278,"2013","076"
"7648","CIVIDATE CAMUNO",6,0,0,6,"2013","055"
"7649","CIVITELLA DI ROMAGNA",423,0,14,437,"2013","009"
"7650","CIVO",12,28,0,40,"2013","022"
"7651","CLAINO CON OSTENO",0,0,7,7,"2013","071"
"7652","CLAVESANA",412,0,0,412,"2013","071"
"7653","CLIVIO",31,52,0,83,"2013","052"
"7654","CLUSONE",57,180,0,237,"2013","077"
"7655","COASSOLO TORINESE",24,40,2,66,"2013","088"
"7656","COAZZE",23,0,4,27,"2013","089"
"7657","COAZZOLO",44,0,0,44,"2013","041"
"7658","COCCAGLIO",321,719,6,1046,"2013","056"
"7659","COCCONATO",114,0,0,114,"2013","042"
"7660","COCQUIO-TREVISAGO",31,0,0,31,"2013","053"
"7661","CODEVIGO",622,138,6,766,"2013","033"
"7662","CODIGORO",4358,198,0,4556,"2013","005"
"7663","CODOGNE'",38,254,3,295,"2013","019"
"7664","CODOGNO",26,962,0,988,"2013","019"
"7665","COGGIOLA",4,0,0,4,"2013","019"
"7666","COGLIATE",78,0,0,78,"2013",NA
"7667","COGOLLO DEL CENGIO",363,108,0,471,"2013","032"
"7668","COLERE",1,0,0,1,"2013","078"
"7669","COLI",40,0,0,40,"2013","016"
"7670","COLICO",93,109,44,246,"2013","023"
"7671","COLLAGNA",6,55,0,61,"2013","019"
"7672","COLLE BRIANZA",16,6,2,24,"2013","024"
"7673","COLLE SANTA LUCIA",0,15,0,15,"2013","014"
"7674","COLLE UMBERTO",30,213,0,243,"2013","020"
"7675","COLLECCHIO",37,2372,0,2409,"2013","009"
"7676","COLLEGNO",103,322,3,428,"2013","090"
"7677","COLLERETTO CASTELNUOVO",7,30,0,37,"2013","091"
"7678","COLLERETTO GIACOSA",32,0,0,32,"2013","092"
"7679","COLLIO",51,86,0,137,"2013","058"
"7680","COLOGNA VENETA",9657,194,0,9851,"2013","027"
"7681","COLOGNE",467,558,22,1047,"2013","059"
"7682","COLOGNO AL SERIO",55,970,0,1025,"2013","079"
"7683","COLOGNO MONZESE",6,0,0,6,"2013","081"
"7684","COLOGNOLA AI COLLI",5,0,0,5,"2013","028"
"7685","COLORINA",37,440,0,477,"2013","023"
"7686","COLORNO",18,1459,0,1477,"2013","010"
"7687","COLTURANO",0,80,0,80,"2013","082"
"7688","COLZATE",13,25,0,38,"2013","080"
"7689","COMACCHIO",523,174,0,697,"2013","006"
"7690","COMAZZO",40,729,15,784,"2013","020"
"7691","COMELICO SUPERIORE",25,136,0,161,"2013","015"
"7692","COMERIO",5,0,0,5,"2013","055"
"7693","COMEZZANO-CIZZAGO",229,1696,0,1925,"2013","060"
"7694","COMIGNAGO",3,0,0,3,"2013","052"
"7695","COMMESSAGGIO",2,15,15,32,"2013","020"
"7696","COMO",3,60,7,70,"2013","075"
"7697","COMPIANO",13,14,0,27,"2013","011"
"7698","COMUN NUOVO",69,34,0,103,"2013","081"
"7699","CONA",11873,0,0,11873,"2013","010"
"7700","CONCAMARISE",0,187,0,187,"2013","029"
"7701","CONCESIO",21,34,0,55,"2013","061"
"7702","CONCO",43,264,5,312,"2013","033"
"7703","CONCORDIA SAGITTARIA",1158,0,0,1158,"2013","011"
"7704","CONCORDIA SULLA SECCHIA",24,346,51,421,"2013","010"
"7705","CONCOREZZO",14,31,0,45,"2013",NA
"7706","CONDOVE",163,26,66,255,"2013","093"
"7707","CONEGLIANO",50,123,0,173,"2013","021"
"7708","CONFIENZA",56,18,36,110,"2013","052"
"7709","CONIOLO",162,0,0,162,"2013","060"
"7710","CONSELICE",538,219,0,757,"2013","008"
"7711","CONSELVE",1157,44,0,1201,"2013","034"
"7712","CONZANO",118,0,0,118,"2013","061"
"7713","COPPARO",50,0,0,50,"2013","007"
"7714","CORBETTA",974,44,30,1048,"2013","085"
"7715","CORBOLA",32,167,0,199,"2013","017"
"7716","CORDIGNANO",110,357,0,467,"2013","022"
"7717","CORIANO",30,248,0,278,"2013","003"
"7718","CORIO",131,18,0,149,"2013","094"
"7719","CORNA IMAGNA",25,34,0,59,"2013","082"
"7720","CORNALBA",4,5,0,9,"2013","249"
"7721","CORNAREDO",34,162,10,206,"2013","087"
"7722","CORNATE D'ADDA",23,111,0,134,"2013",NA
"7723","CORNEDO VICENTINO",11,145,0,156,"2013","034"
"7724","CORNEGLIANO LAUDENSE",0,218,0,218,"2013","021"
"7725","CORNELIANO D'ALBA",137,0,0,137,"2013","072"
"7726","CORNIGLIO",46,531,0,577,"2013","012"
"7727","CORNO GIOVINE",146,57,0,203,"2013","022"
"7728","CORNOVECCHIO",129,0,0,129,"2013","023"
"7729","CORNUDA",1510,365,0,1875,"2013","023"
"7730","CORREGGIO",5,1917,5,1927,"2013","020"
"7731","CORREZZANA",22,39,0,61,"2013",NA
"7732","CORREZZOLA",4749,23,0,4772,"2013","035"
"7733","CORRIDO",20,3,6,29,"2013","077"
"7734","CORSIONE",7,0,0,7,"2013","044"
"7735","CORTANDONE",3,0,0,3,"2013",NA
"7736","CORTANZE",84,0,0,84,"2013","046"
"7737","CORTAZZONE",9,0,0,9,"2013","047"
"7738","CORTE BRUGNATELLA",103,4,0,107,"2013","017"
"7739","CORTE DE' CORTESI CON CIGNONE",5,117,0,122,"2013","032"
"7740","CORTE DE' FRATI",34,956,0,990,"2013","033"
"7741","CORTE FRANCA",94,100,0,194,"2013","062"
"7742","CORTE PALASIO",10,1587,18,1615,"2013","024"
"7743","CORTEMAGGIORE",171,1636,0,1807,"2013","018"
"7744","CORTEMILIA",249,0,0,249,"2013","073"
"7745","CORTENO GOLGI",17,92,7,116,"2013","063"
"7746","CORTENOVA",7,37,0,44,"2013","025"
"7747","CORTENUOVA",195,1278,0,1473,"2013","083"
"7748","CORTEOLONA",9,0,0,9,"2013","056"
"7749","CORTIGLIONE",14,0,0,14,"2013","048"
"7750","CORTINA D'AMPEZZO",18,38,0,56,"2013","016"
"7751","CORVINO SAN QUIRICO",4,0,0,4,"2013","057"
"7752","CORZANO",130,213,0,343,"2013","064"
"7753","COSIO VALTELLINO",25,642,0,667,"2013","024"
"7754","COSSANO BELBO",416,0,0,416,"2013","074"
"7755","COSSATO",189,174,0,363,"2013","020"
"7756","COSSOGNO",5,0,0,5,"2013","023"
"7757","COSTA DE' NOBILI",71,26,9,106,"2013","058"
"7758","COSTA DI MEZZATE",36,0,0,36,"2013","084"
"7759","COSTA DI ROVIGO",0,283,0,283,"2013","018"
"7760","COSTA MASNAGA",22,9,0,31,"2013","026"
"7761","COSTA SERINA",13,6,0,19,"2013","247"
"7762","COSTA VALLE IMAGNA",3,0,0,3,"2013","085"
"7763","COSTA VESCOVATO",0,0,9,9,"2013","062"
"7764","COSTA VOLPINO",26,24,0,50,"2013","086"
"7765","COSTABISSARA",20,74,19,113,"2013","035"
"7766","COSTERMANO",25,28,0,53,"2013","030"
"7767","COSTIGLIOLE D'ASTI",611,0,0,611,"2013","050"
"7768","COSTIGLIOLE SALUZZO",478,81,0,559,"2013","075"
"7769","COTIGNOLA",79,0,0,79,"2013","009"
"7770","COVO",827,1347,0,2174,"2013","087"
"7771","COZZO",1,0,0,1,"2013",NA
"7772","CRANDOLA VALSASSINA",3,3,0,6,"2013","027"
"7773","CRAVAGLIANA",7,15,0,22,"2013","048"
"7774","CRAVEGGIA",15,0,0,15,"2013","024"
"7775","CREAZZO",7,25,0,32,"2013","036"
"7776","CREDARO",4,161,0,165,"2013","088"
"7777","CREDERA RUBBIANO",0,1489,0,1489,"2013","034"
"7778","CREMA",306,2339,0,2645,"2013","035"
"7779","CREMELLA",7,0,0,7,"2013","028"
"7780","CREMENO",4,39,40,83,"2013","029"
"7781","CREMIA",3,8,6,17,"2013","083"
"7782","CREMOLINO",81,0,0,81,"2013","063"
"7783","CREMONA",116,1834,0,1950,"2013","036"
"7784","CREMOSANO",27,715,0,742,"2013","037"
"7785","CRESCENTINO",77,0,27,104,"2013","049"
"7786","CRESPADORO",35,67,2,104,"2013","037"
"7787","CRESPANO DEL GRAPPA",1403,655,0,2058,"2013","024"
"7788","CRESPELLANO",218,46,0,264,"2013","023"
"7789","CRESPIATICA",73,308,0,381,"2013","025"
"7790","CRESPINO",2130,0,0,2130,"2013","019"
"7791","CRESSA",36,248,0,284,"2013","055"
"7792","CREVACUORE",4,0,0,4,"2013","021"
"7793","CREVALCORE",509,34,0,543,"2013","024"
"7794","CREVOLADOSSOLA",90,60,0,150,"2013","025"
"7795","CRISSOLO",0,7,0,7,"2013",NA
"7796","CROCETTA DEL MONTELLO",56,41,6,103,"2013","025"
"7797","CRODO",45,103,11,159,"2013","026"
"7798","CROSIO DELLA VALLE",2,0,0,2,"2013","057"
"7799","CROTTA D'ADDA",1,515,0,516,"2013","038"
"7800","CROVA",4,0,0,4,"2013","052"
"7801","CUASSO AL MONTE",9,0,0,9,"2013","058"
"7802","CUCCARO MONFERRATO",19,0,0,19,"2013","064"
"7803","CUCCIAGO",5,0,0,5,"2013","084"
"7804","CUCEGLIO",47,0,0,47,"2013","096"
"7805","CUGGIONO",457,74,0,531,"2013","096"
"7806","CUMIANA",1472,361,63,1896,"2013","097"
"7807","CUMIGNANO SUL NAVIGLIO",0,1396,0,1396,"2013","039"
"7808","CUNARDO",3,0,1,4,"2013","060"
"7809","CUNEO",7658,553,1691,9902,"2013","078"
"7810","CUNICO",1800,0,0,1800,"2013","051"
"7811","CUORGNE'",159,124,0,283,"2013","098"
"7812","CURA CARPIGNANO",5,276,0,281,"2013","060"
"7813","CUREGGIO",28,47,0,75,"2013","058"
"7814","CURIGLIA CON MONTEVIASCO",0,2,3,5,"2013","061"
"7815","CURINO",9,0,0,9,"2013","023"
"7816","CURNO",59,76,0,135,"2013","089"
"7817","CURSOLO-ORASSO",25,0,0,25,"2013","027"
"7818","CURTAROLO",89,198,47,334,"2013","036"
"7819","CURTATONE",3811,1257,1504,6572,"2013","021"
"7820","CUSAGO",100,336,1,437,"2013","097"
"7821","CUSINO",8,0,6,14,"2013","085"
"7822","CUSIO",3,0,0,3,"2013","090"
"7823","CUVEGLIO",9,0,0,9,"2013","062"
"7824","CUVIO",5,80,0,85,"2013","063"
"7825","DAIRAGO",27,28,0,55,"2013","099"
"7826","DALMINE",92,106,0,198,"2013","091"
"7827","DANTA DI CADORE",1,0,0,1,"2013",NA
"7828","DARFO BOARIO TERME",6,350,8,364,"2013","065"
"7829","DAVERIO",15,0,0,15,"2013","064"
"7830","DAZIO",0,12,0,12,"2013","025"
"7831","DELEBIO",42,202,0,244,"2013","026"
"7832","DELLO",724,1693,5,2422,"2013","066"
"7833","DEMONTE",1360,129,11,1500,"2013","079"
"7834","DENICE",2,0,0,2,"2013","065"
"7835","DERNICE",9,2,0,11,"2013","066"
"7836","DEROVERE",6,177,0,183,"2013","040"
"7837","DESANA",50,0,0,50,"2013","054"
"7838","DESENZANO DEL GARDA",151,1842,98,2091,"2013","067"
"7839","DESIO",36,0,0,36,"2013",NA
"7840","DIANO D'ALBA",89,0,0,89,"2013","080"
"7841","DIVIGNANO",65,0,0,65,"2013","060"
"7842","DIZZASCO",0,0,6,6,"2013","087"
"7843","DOGLIANI",1654,0,0,1654,"2013","081"
"7844","DOLO",437,245,0,682,"2013","012"
"7845","DOMASO",9,3,2,14,"2013","089"
"7846","DOMODOSSOLA",36,19,9,64,"2013","028"
"7847","DONATO",137,0,34,171,"2013","024"
"7848","DONGO",2,9,1,12,"2013","090"
"7849","DORIO",2,0,0,2,"2013","032"
"7850","DORMELLETTO",2,0,0,2,"2013","062"
"7851","DORNO",14,43,79,136,"2013","061"
"7852","DORZANO",3,0,0,3,"2013","025"
"7853","DOSOLO",22,327,175,524,"2013","022"
"7854","DOSSENA",26,45,0,71,"2013","092"
"7855","DOSSO DEL LIRO",4,10,2,16,"2013","092"
"7856","DOVADOLA",113,0,0,113,"2013","011"
"7857","DOVERA",22,1271,0,1293,"2013","041"
"7858","DOZZA",4,26,0,30,"2013","025"
"7859","DRESANO",6,0,0,6,"2013","101"
"7860","DREZZO",1,0,2,3,"2013","093"
"7861","DRIZZONA",1,440,0,441,"2013","042"
"7862","DRONERO",1254,203,94,1551,"2013","082"
"7863","DRUENTO",603,70,75,748,"2013","099"
"7864","DRUOGNO",14,6,0,20,"2013","029"
"7865","DUBINO",16,660,8,684,"2013","027"
"7866","DUE CARRARE",112,0,0,112,"2013","106"
"7867","DUEVILLE",459,659,11,1129,"2013","038"
"7868","DUMENZA",2,0,7,9,"2013","065"
"7869","DUSINO SAN MICHELE",403,41,0,444,"2013","052"
"7870","EDOLO",17,62,3,82,"2013","068"
"7871","ELLO",8,0,0,8,"2013","033"
"7872","ELVA",16,0,11,27,"2013","083"
"7873","ENDINE GAIANO",43,121,0,164,"2013","093"
"7874","ENEGO",24,221,4,249,"2013","039"
"7875","ENTRACQUE",91,0,0,91,"2013","084"
"7876","ENTRATICO",47,7,0,54,"2013","094"
"7877","ENVIE",1839,521,76,2436,"2013","085"
"7878","ERACLEA",4085,274,0,4359,"2013","013"
"7879","ERBA",54,393,1,448,"2013","095"
"7880","ERBE'",197,42,0,239,"2013","032"
"7881","ERBEZZO",43,689,0,732,"2013","033"
"7882","ERBUSCO",213,70,0,283,"2013","069"
"7883","ERVE",6,0,0,6,"2013","034"
"7884","ESINE",3,200,3,206,"2013","070"
"7885","ESINO LARIO",16,0,0,16,"2013","035"
"7886","ESTE",522,74,0,596,"2013","037"
"7887","EUPILIO",12,43,10,65,"2013","097"
"7888","EXILLES",3,0,0,3,"2013",NA
"7889","FABBRICA CURONE",12,21,0,33,"2013","067"
"7890","FABBRICO",3,158,0,161,"2013","021"
"7891","FAEDO VALTELLINO",2,18,0,20,"2013","028"
"7892","FAENZA",264,106,0,370,"2013","010"
"7893","FAGGETO LARIO",8,0,2,10,"2013","098"
"7894","FAGNANO OLONA",16,86,6,108,"2013","067"
"7895","FALCADE",8,19,0,27,"2013","019"
"7896","FALOPPIO",45,0,6,51,"2013","099"
"7897","FANANO",82,473,0,555,"2013","011"
"7898","FARA GERA D'ADDA",127,563,0,690,"2013","096"
"7899","FARA NOVARESE",5,0,0,5,"2013","065"
"7900","FARA OLIVANA CON SOLA",561,274,0,835,"2013","097"
"7901","FARA VICENTINO",747,554,170,1471,"2013","040"
"7902","FARIGLIANO",535,0,0,535,"2013","086"
"7903","FARINI",92,111,0,203,"2013","019"
"7904","FARRA D'ALPAGO",8,125,0,133,"2013","020"
"7905","FARRA DI SOLIGO",99,51,0,150,"2013","026"
"7906","FAULE",39,128,0,167,"2013","087"
"7907","FAVRIA",334,588,0,922,"2013","101"
"7908","FEISOGLIO",79,0,0,79,"2013","088"
"7909","FELETTO",36,23,0,59,"2013","102"
"7910","FELINO",32,1084,0,1116,"2013","013"
"7911","FELIZZANO",49,0,0,49,"2013","068"
"7912","FELTRE",188,1232,0,1420,"2013","021"
"7913","FENEGRO'",20,1,19,40,"2013","100"
"7914","FENESTRELLE",23,0,0,23,"2013","103"
"7915","FERNO",1,44,0,45,"2013","068"
"7916","FERRARA",320,250,0,570,"2013","008"
"7917","FERRARA DI MONTE BALDO",0,48,24,72,"2013","034"
"7918","FERRERA DI VARESE",9,0,0,9,"2013","069"
"7919","FERRERA ERBOGNONE",50,0,0,50,"2013","062"
"7920","FERRERE",1000,0,0,1000,"2013","053"
"7921","FERRIERE",144,10,0,154,"2013","020"
"7922","FIANO",7,0,0,7,"2013","104"
"7923","FICAROLO",21,0,0,21,"2013","021"
"7924","FIDENZA",645,3709,64,4418,"2013","014"
"7925","FIESCO",22,592,0,614,"2013","043"
"7926","FIESSE",1001,443,251,1695,"2013","071"
"7927","FIESSO D'ARTICO",11,45,0,56,"2013","014"
"7928","FIESSO UMBERTIANO",119,38,0,157,"2013","022"
"7929","FIGINO SERENZA",73,88,0,161,"2013","101"
"7930","FILAGO",25,4,0,29,"2013","098"
"7931","FILIGHERA",1,143,0,144,"2013","063"
"7932","FINALE EMILIA",69,82,0,151,"2013","012"
"7933","FINO DEL MONTE",4,23,0,27,"2013","099"
"7934","FINO MORNASCO",13,0,0,13,"2013","102"
"7935","FIORANO AL SERIO",10,23,0,33,"2013","100"
"7936","FIORANO CANAVESE",6,0,0,6,"2013","105"
"7937","FIORANO MODENESE",23,53,0,76,"2013","013"
"7938","FIORENZUOLA D'ARDA",154,1898,0,2052,"2013","021"
"7939","FIUMALBO",97,113,0,210,"2013","014"
"7940","FLERO",175,292,0,467,"2013","072"
"7941","FOBELLO",18,2,0,20,"2013","057"
"7942","FOGLIZZO",155,0,0,155,"2013","106"
"7943","FOLLINA",301,109,0,410,"2013","027"
"7944","FOMBIO",204,315,18,537,"2013","026"
"7945","FONTANELICE",173,151,0,324,"2013","026"
"7946","FONTANELLA",2959,2428,0,5387,"2013","101"
"7947","FONTANELLATO",161,2196,0,2357,"2013","015"
"7948","FONTANELLE",81,742,14,837,"2013","028"
"7949","FONTANETO D'AGOGNA",15,57,0,72,"2013","066"
"7950","FONTANETTO PO",2,0,0,2,"2013","058"
"7951","FONTANILE",4,0,0,4,"2013","054"
"7952","FONTANIVA",329,360,0,689,"2013","038"
"7953","FONTE",1140,611,0,1751,"2013","029"
"7954","FONTENO",10,1,0,11,"2013","102"
"7955","FONTEVIVO",1,1368,0,1369,"2013","016"
"7956","FONZASO",64,171,0,235,"2013","022"
"7957","FOPPOLO",0,16,0,16,"2013","103"
"7958","FORCOLA",11,173,0,184,"2013","029"
"7959","FORESTO SPARSO",16,91,2,109,"2013","104"
"7960","FORLI'",546,194,0,740,"2013","012"
"7961","FORLIMPOPOLI",14,11,0,25,"2013","013"
"7962","FORMAZZA",1,16,11,28,"2013","031"
"7963","FORMIGARA",0,1075,177,1252,"2013","044"
"7964","FORMIGINE",32,1781,1,1814,"2013","015"
"7965","FORMIGLIANA",26,0,0,26,"2013","059"
"7966","FORMIGNANA",6,0,0,6,"2013","009"
"7967","FORNO CANAVESE",60,0,0,60,"2013","107"
"7968","FORNO DI ZOLDO",16,3,0,19,"2013","024"
"7969","FORNOVO DI TARO",12,526,2,540,"2013","017"
"7970","FORNOVO SAN GIOVANNI",20,681,0,701,"2013","105"
"7971","FORTUNAGO",36,0,0,36,"2013","064"
"7972","FOSSALTA DI PIAVE",9,0,0,9,"2013","015"
"7973","FOSSALTA DI PORTOGRUARO",0,922,0,922,"2013","016"
"7974","FOSSANO",15674,3961,1200,20835,"2013","089"
"7975","FOSSO'",102,26,0,128,"2013","017"
"7976","FOZA",49,53,18,120,"2013","041"
"7977","FRABOSA SOPRANA",194,204,0,398,"2013","090"
"7978","FRABOSA SOTTANA",264,0,37,301,"2013","091"
"7979","FRACONALTO",22,0,0,22,"2013","069"
"7980","FRASCARO",0,51,0,51,"2013","071"
"7981","FRASCAROLO",178,62,0,240,"2013","065"
"7982","FRASSINELLE POLESINE",272,0,0,272,"2013","023"
"7983","FRASSINELLO MONFERRATO",54,0,0,54,"2013","072"
"7984","FRASSINETO PO",30,0,0,30,"2013","073"
"7985","FRASSINETTO",99,21,0,120,"2013","108"
"7986","FRASSINO",31,3,0,34,"2013","092"
"7987","FRASSINORO",122,169,0,291,"2013","016"
"7988","FRATTA POLESINE",98,49,15,162,"2013","024"
"7989","FREGONA",10,56,0,66,"2013","030"
"7990","FRESONARA",20,0,0,20,"2013","074"
"7991","FRINCO",258,0,0,258,"2013","055"
"7992","FRONT",70,0,0,70,"2013","109"
"7993","FROSSASCO",1941,0,86,2027,"2013","110"
"7994","FRUGAROLO",180,131,0,311,"2013","075"
"7995","FUBINE",330,0,0,330,"2013","076"
"7996","FUIPIANO VALLE IMAGNA",9,38,0,47,"2013","106"
"7997","FUMANE",18,38,6,62,"2013","035"
"7998","FUSIGNANO",5,0,0,5,"2013","011"
"7999","FUSINE",0,25,0,25,"2013","030"
"8000","GABBIONETA-BINANUOVA",129,540,0,669,"2013","045"
"8001","GABIANO",46,0,0,46,"2013","077"
"8002","GADESCO-PIEVE DELMONA",1,369,56,426,"2013","046"
"8003","GAGGIANO",63,491,0,554,"2013","103"
"8004","GAGGIO MONTANO",249,374,0,623,"2013","027"
"8005","GAGLIANICO",5,0,0,5,"2013","026"
"8006","GAIARINE",772,0,1,773,"2013","031"
"8007","GAIBA",20,0,0,20,"2013","025"
"8008","GAIOLA",0,1,0,1,"2013","093"
"8009","GALBIATE",66,9,0,75,"2013","036"
"8010","GALEATA",186,0,9,195,"2013","014"
"8011","GALGAGNANO",0,831,0,831,"2013","027"
"8012","GALLARATE",4,34,0,38,"2013","070"
"8013","GALLIATE",39,18,0,57,"2013","068"
"8014","GALLIATE LOMBARDO",7,0,0,7,"2013","071"
"8015","GALLIERA",2,44,0,46,"2013","028"
"8016","GALLIERA VENETA",2942,146,0,3088,"2013","039"
"8017","GALLIO",11,226,0,237,"2013","042"
"8018","GALZIGNANO TERME",23,0,0,23,"2013","040"
"8019","GAMALERO",28,0,0,28,"2013","078"
"8020","GAMBARA",4713,2030,262,7005,"2013","073"
"8021","GAMBASCA",5,0,0,5,"2013","094"
"8022","GAMBOLO'",76,152,0,228,"2013","068"
"8023","GAMBUGLIANO",3,54,0,57,"2013","044"
"8024","GANDELLINO",18,0,0,18,"2013","107"
"8025","GANDINO",54,143,0,197,"2013","108"
"8026","GANDOSSO",5,27,0,32,"2013","109"
"8027","GARBAGNA",137,0,0,137,"2013","079"
"8028","GARBAGNA NOVARESE",2,0,0,2,"2013","069"
"8029","GARBAGNATE MONASTERO",6,0,0,6,"2013","037"
"8030","GARDONE RIVIERA",8,0,0,8,"2013","074"
"8031","GARDONE VAL TROMPIA",43,0,0,43,"2013","075"
"8032","GARESSIO",175,0,0,175,"2013","095"
"8033","GARGALLO",1,0,0,1,"2013","070"
"8034","GARGNANO",32,0,52,84,"2013","076"
"8035","GARLASCO",13,0,0,13,"2013","069"
"8036","GARLATE",3,0,0,3,"2013","038"
"8037","GARZENO",16,9,17,42,"2013","106"
"8038","GARZIGLIANA",345,0,34,379,"2013","111"
"8039","GASSINO TORINESE",33,5,0,38,"2013","112"
"8040","GATTATICO",5,2371,0,2376,"2013","022"
"8041","GATTEO",3,0,0,3,"2013","016"
"8042","GATTICO",32,125,159,316,"2013","071"
"8043","GATTINARA",43,0,0,43,"2013","061"
"8044","GAVARDO",98,413,0,511,"2013","077"
"8045","GAVERINA TERME",19,30,0,49,"2013","110"
"8046","GAVI",41,0,0,41,"2013","081"
"8047","GAVIRATE",48,0,0,48,"2013","072"
"8048","GAZOLDO DEGLI IPPOLITI",440,84,10,534,"2013","024"
"8049","GAZZADA SCHIANNO",10,9,0,19,"2013","073"
"8050","GAZZANIGA",21,73,0,94,"2013","111"
"8051","GAZZO",72,3111,0,3183,"2013","041"
"8052","GAZZO VERONESE",1131,254,0,1385,"2013","037"
"8053","GAZZOLA",138,1246,0,1384,"2013","022"
"8054","GAZZUOLO",569,36,14,619,"2013","025"
"8055","GEMMANO",27,70,0,97,"2013","004"
"8056","GEMONIO",3,0,1,4,"2013","074"
"8057","GENIVOLTA",19,1966,0,1985,"2013","047"
"8058","GENOLA",2118,1298,91,3507,"2013","096"
"8059","GENZONE",189,59,0,248,"2013","070"
"8060","GERA LARIO",93,204,0,297,"2013","107"
"8061","GERENZAGO",0,39,0,39,"2013","071"
"8062","GERENZANO",81,86,0,167,"2013","075"
"8063","GERMAGNANO",16,1,0,17,"2013","113"
"8064","GERMAGNO",1,0,0,1,"2013","032"
"8065","GERMIGNAGA",10,55,0,65,"2013","076"
"8066","GEROLA ALTA",1,0,0,1,"2013","031"
"8067","GEROSA",19,13,0,32,"2013","112"
"8068","GERRE DE' CAPRIOLI",0,331,0,331,"2013","048"
"8069","GESSATE",48,402,0,450,"2013","106"
"8070","GHEDI",3624,6079,39,9742,"2013","078"
"8071","GHEMME",8,0,0,8,"2013","073"
"8072","GHIFFA",2,0,0,2,"2013","033"
"8073","GHISALBA",12,729,0,741,"2013","113"
"8074","GHISLARENGO",17,0,0,17,"2013","062"
"8075","GIACCIANO CON BARUCHELLA",2,0,10,12,"2013","027"
"8076","GIAGLIONE",21,0,0,21,"2013","114"
"8077","GIANICO",149,162,112,423,"2013","079"
"8078","GIAVENO",191,434,154,779,"2013","115"
"8079","GIAVERA DEL MONTELLO",602,155,0,757,"2013","032"
"8080","GIFFLENGA",1,0,0,1,"2013","027"
"8081","GIGNESE",3,0,1,4,"2013","034"
"8082","GIRONICO",33,84,14,131,"2013","109"
"8083","GIUSSAGO",41,205,0,246,"2013","072"
"8084","GIUSSANO",5,0,0,5,"2013",NA
"8085","GIVOLETTO",28,0,0,28,"2013","116"
"8086","GODEGA DI SANT'URBANO",55,126,0,181,"2013","033"
"8087","GODIASCO",13,0,0,13,"2013","073"
"8088","GOITO",3660,4689,1314,9663,"2013","026"
"8089","GOLASECCA",20,33,0,53,"2013","077"
"8090","GOLFERENZO",0,0,11,11,"2013","074"
"8091","GOMBITO",5,835,0,840,"2013","049"
"8092","GONZAGA",18392,2810,3416,24618,"2013","027"
"8093","GORDONA",102,137,5,244,"2013","032"
"8094","GORGO AL MONTICANO",82,383,0,465,"2013","034"
"8095","GORGONZOLA",13,288,0,301,"2013","108"
"8096","GORLA MAGGIORE",9,185,0,194,"2013","078"
"8097","GORLA MINORE",93,0,0,93,"2013","079"
"8098","GORLAGO",51,286,2,339,"2013","114"
"8099","GORLE",1,0,0,1,"2013","115"
"8100","GORNATE-OLONA",16,0,2,18,"2013","080"
"8101","GORNO",30,67,0,97,"2013","116"
"8102","GORZEGNO",39,0,0,39,"2013","097"
"8103","GOSSOLENGO",64,484,0,548,"2013","023"
"8104","GOTTASECCA",45,0,0,45,"2013","098"
"8105","GOTTOLENGO",12940,1368,101,14409,"2013","080"
"8106","GOVONE",296,0,0,296,"2013","099"
"8107","GOZZANO",9,0,0,9,"2013","076"
"8108","GRAFFIGNANA",59,210,109,378,"2013","028"
"8109","GRAGLIA",133,10,78,221,"2013","028"
"8110","GRAGNANO TREBBIENSE",35,2287,0,2322,"2013","024"
"8111","GRANA",43,0,0,43,"2013","056"
"8112","GRANAGLIONE",1,0,0,1,"2013","029"
"8113","GRANAROLO DELL'EMILIA",42,221,0,263,"2013","030"
"8114","GRANCONA",40,156,0,196,"2013","045"
"8115","GRANDOLA ED UNITI",4,27,29,60,"2013","111"
"8116","GRANOZZO CON MONTICELLO",3,52,0,55,"2013","077"
"8117","GRANTOLA",69,0,0,69,"2013","081"
"8118","GRANTORTO",82,1023,0,1105,"2013","042"
"8119","GRANZE",1029,0,0,1029,"2013","043"
"8120","GRASSOBBIO",12,169,0,181,"2013","117"
"8121","GRAVEDONA ED UNITI",9,14,104,127,"2013","249"
"8122","GRAVELLONA LOMELLINA",11,0,0,11,"2013","075"
"8123","GRAVELLONA TOCE",18,0,0,18,"2013","035"
"8124","GRAVERE",1,0,0,1,"2013","117"
"8125","GRAZZANO BADOGLIO",487,0,0,487,"2013","057"
"8126","GREMIASCO",29,0,0,29,"2013","083"
"8127","GREZZAGO",38,0,0,38,"2013","110"
"8128","GREZZANA",193,768,0,961,"2013","038"
"8129","GRIANTE",1,0,7,8,"2013","113"
"8130","GRIGNASCO",6,57,0,63,"2013","079"
"8131","GRINZANE CAVOUR",43,0,0,43,"2013","100"
"8132","GRISIGNANO DI ZOCCO",49,480,19,548,"2013","046"
"8133","GRIZZANA MORANDI",39,0,0,39,"2013","031"
"8134","GROMO",39,103,2,144,"2013","118"
"8135","GRONDONA",10,0,0,10,"2013","085"
"8136","GRONE",20,24,0,44,"2013","119"
"8137","GRONTARDO",0,2016,0,2016,"2013","050"
"8138","GROPELLO CAIROLI",41,0,0,41,"2013","076"
"8139","GROPPARELLO",83,23,0,106,"2013","025"
"8140","GROSCAVALLO",24,0,15,39,"2013","118"
"8141","GROSIO",31,215,9,255,"2013","033"
"8142","GROSOTTO",7,52,0,59,"2013","034"
"8143","GROSSO",63,0,0,63,"2013","119"
"8144","GRUARO",14,128,0,142,"2013","018"
"8145","GRUGLIASCO",114,35,29,178,"2013","120"
"8146","GRUMELLO CREMONESE ED UNITI",17,1240,227,1484,"2013","051"
"8147","GRUMELLO DEL MONTE",326,121,4,451,"2013","120"
"8148","GRUMOLO DELLE ABBADESSE",80,251,0,331,"2013","047"
"8149","GUALTIERI",651,586,22,1259,"2013","023"
"8150","GUANZATE",24,0,2,26,"2013","114"
"8151","GUARDA VENETA",723,0,0,723,"2013","028"
"8152","GUARDABOSONE",31,18,0,49,"2013","066"
"8153","GUARDAMIGLIO",8,341,0,349,"2013","029"
"8154","GUARENE",285,0,0,285,"2013","101"
"8155","GUASTALLA",47,1174,8,1229,"2013","024"
"8156","GUDO VISCONTI",9,0,0,9,"2013","112"
"8157","GUIDIZZOLO",1422,823,174,2419,"2013","028"
"8158","GUIGLIA",49,529,0,578,"2013","017"
"8159","GUSSAGO",124,797,0,921,"2013","081"
"8160","GUSSOLA",3,51,0,54,"2013","052"
"8161","IDRO",2,0,0,2,"2013","082"
"8162","IESOLO",30,49,2,81,"2013","019"
"8163","IGLIANO",52,0,18,70,"2013","102"
"8164","ILLASI",2,50,0,52,"2013","039"
"8165","IMBERSAGO",7,0,0,7,"2013","039"
"8166","IMOLA",88,20,0,108,"2013","032"
"8167","INARZO",8,0,0,8,"2013","082"
"8168","INCISA SCAPACCINO",37,0,0,37,"2013","058"
"8169","INCUDINE",2,3,0,5,"2013","083"
"8170","INDUNO OLONA",22,70,0,92,"2013","083"
"8171","INTRAGNA",2,0,0,2,"2013","037"
"8172","INTROBIO",36,23,0,59,"2013","040"
"8173","INTROZZO",2,0,0,2,"2013","041"
"8174","INVERIGO",76,0,30,106,"2013","118"
"8175","INVERNO E MONTELEONE",97,160,0,257,"2013","077"
"8176","INVERSO PINASCA",26,0,0,26,"2013","122"
"8177","INVERUNO",23,160,0,183,"2013","113"
"8178","INVORIO",28,116,0,144,"2013","082"
"8179","INZAGO",195,688,0,883,"2013","114"
"8180","IRMA",10,0,2,12,"2013","084"
"8181","ISASCA",12,0,0,12,"2013","103"
"8182","ISEO",45,35,0,80,"2013","085"
"8183","ISOLA D'ASTI",319,0,0,319,"2013","059"
"8184","ISOLA DELLA SCALA",3272,265,0,3537,"2013","040"
"8185","ISOLA DI FONDRA",1,21,0,22,"2013","121"
"8186","ISOLA DOVARESE",0,557,0,557,"2013","053"
"8187","ISOLA RIZZA",2086,385,0,2471,"2013","041"
"8188","ISOLA VICENTINA",1946,649,88,2683,"2013","048"
"8189","ISOLABELLA",119,371,0,490,"2013","123"
"8190","ISORELLA",10320,697,50,11067,"2013","086"
"8191","ISPRA",76,130,0,206,"2013","084"
"8192","ISSIGLIO",55,18,0,73,"2013","124"
"8193","ISSO",7,1311,0,1318,"2013","122"
"8194","ISTRANA",2921,402,18,3341,"2013","035"
"8195","IVREA",215,184,0,399,"2013","125"
"8196","IZANO",21,915,0,936,"2013","054"
"8197","JERAGO CON ORAGO",2,0,0,2,"2013","085"
"8198","JOLANDA DI SAVOIA",71,0,0,71,"2013","010"
"8199","LA CASSA",7,0,283,290,"2013","126"
"8200","LA LOGGIA",186,0,83,269,"2013","127"
"8201","LA MORRA",142,0,0,142,"2013","105"
"8202","LA VALLE AGORDINA",10,44,0,54,"2013","027"
"8203","LACCHIARELLA",21,69,0,90,"2013","115"
"8204","LAGNASCO",35,35,0,70,"2013","104"
"8205","LAGOSANTO",40,0,0,40,"2013","011"
"8206","LAINATE",11,0,6,17,"2013","116"
"8207","LAINO",5,1,0,6,"2013","120"
"8208","LAMA MOCOGNO",106,458,0,564,"2013","018"
"8209","LAMBRUGO",0,72,0,72,"2013","121"
"8210","LAMON",16,45,0,61,"2013","026"
"8211","LAMPORO",29,0,0,29,"2013","067"
"8212","LANDRIANO",20,233,0,253,"2013","078"
"8213","LANGHIRANO",1,866,0,867,"2013","018"
"8214","LANGOSCO",8,0,0,8,"2013","079"
"8215","LANZADA",17,75,0,92,"2013","036"
"8216","LANZO D'INTELVI",6,0,1,7,"2013","122"
"8217","LANZO TORINESE",133,0,11,144,"2013","128"
"8218","LASNIGO",11,32,0,43,"2013","123"
"8219","LAURIANO",15,0,0,15,"2013","129"
"8220","LAVENA PONTE TRESA",4,0,0,4,"2013","086"
"8221","LAVENO-MOMBELLO",15,0,0,15,"2013","087"
"8222","LAVENONE",29,1,0,30,"2013","087"
"8223","LAZISE",48,100,5,153,"2013","043"
"8224","LAZZATE",27,0,0,27,"2013",NA
"8225","LECCO",23,57,3,83,"2013","042"
"8226","LEFFE",24,85,0,109,"2013","124"
"8227","LEGGIUNO",4,0,0,4,"2013","088"
"8228","LEGNAGO",152,33,0,185,"2013","044"
"8229","LEGNANO",0,55,0,55,"2013","118"
"8230","LEGNARO",190,34,54,278,"2013","044"
"8231","LEINI'",503,615,83,1201,"2013","130"
"8232","LEMIE",16,67,0,83,"2013","131"
"8233","LENDINARA",640,164,15,819,"2013","029"
"8234","LENNA",20,0,0,20,"2013","125"
"8235","LENNO",15,1,2,18,"2013","125"
"8236","LENO",5409,6902,958,13269,"2013","088"
"8237","LENTA",1,12,0,13,"2013","068"
"8238","LENTATE SUL SEVESO",18,152,59,229,"2013",NA
"8239","LENTIAI",132,126,0,258,"2013","028"
"8240","LEQUIO BERRIA",45,0,0,45,"2013","106"
"8241","LEQUIO TANARO",1211,56,0,1267,"2013","107"
"8242","LERMA",32,0,0,32,"2013","088"
"8243","LESA",6,0,0,6,"2013","084"
"8244","LESEGNO",715,0,0,715,"2013","108"
"8245","LESIGNANO DE' BAGNI",35,1204,0,1239,"2013","019"
"8246","LESMO",0,176,0,176,"2013",NA
"8247","LESSOLO",155,2,0,157,"2013","132"
"8248","LESSONA",6,17,0,23,"2013","029"
"8249","LEVATE",0,21,0,21,"2013","126"
"8250","LEVICE",109,2,0,111,"2013","109"
"8251","LEZZENO",1,0,3,4,"2013","126"
"8252","LIERNA",5,0,0,5,"2013","043"
"8253","LIGNANA",1,0,0,1,"2013","070"
"8254","LIGONCHIO",26,78,0,104,"2013","025"
"8255","LIMANA",35,128,0,163,"2013","029"
"8256","LIMBIATE",4,0,13,17,"2013",NA
"8257","LIMENA",730,567,90,1387,"2013","045"
"8258","LIMIDO COMASCO",4,23,0,27,"2013","128"
"8259","LIMONE PIEMONTE",82,0,0,82,"2013","110"
"8260","LINAROLO",109,322,0,431,"2013","081"
"8261","LIPOMO",1,0,0,1,"2013",NA
"8262","LIRIO",28,0,0,28,"2013","082"
"8263","LISCATE",19,0,0,19,"2013","122"
"8264","LISIO",60,0,0,60,"2013","111"
"8265","LISSONE",133,0,0,133,"2013",NA
"8266","LIVIGNO",29,314,9,352,"2013","037"
"8267","LIVINALLONGO DEL COL DI LANA",3,74,0,77,"2013","030"
"8268","LIVO",3,0,0,3,"2013","130"
"8269","LIVORNO FERRARIS",3,44,0,47,"2013","071"
"8270","LIVRAGA",40,1099,20,1159,"2013","030"
"8271","LIZZANO IN BELVEDERE",33,67,35,135,"2013","033"
"8272","LOAZZOLO",6,0,2,8,"2013","060"
"8273","LOCANA",145,167,0,312,"2013","134"
"8274","LOCATE DI TRIULZI",0,1044,0,1044,"2013","125"
"8275","LOCATE VARESINO",19,0,0,19,"2013","131"
"8276","LOCATELLO",47,22,0,69,"2013","127"
"8277","LODI",580,1342,45,1967,"2013","031"
"8278","LODI VECCHIO",2,945,0,947,"2013","032"
"8279","LODRINO",20,0,0,20,"2013","090"
"8280","LOGRATO",661,711,0,1372,"2013","091"
"8281","LOIANO",28,322,0,350,"2013","034"
"8282","LOMAGNA",1,0,0,1,"2013","044"
"8283","LOMBARDORE",47,0,0,47,"2013","135"
"8284","LOMBRIASCO",64,93,0,157,"2013","136"
"8285","LOMELLO",4,75,0,79,"2013","083"
"8286","LONATE CEPPINO",3,261,1,265,"2013","089"
"8287","LONATE POZZOLO",18,0,9,27,"2013","090"
"8288","LONATO",2593,4447,137,7177,"2013","092"
"8289","LONGARE",87,221,2,310,"2013","051"
"8290","LONGARONE",4,0,0,4,"2013","031"
"8291","LONGHENA",0,274,0,274,"2013","093"
"8292","LONGIANO",16,0,0,16,"2013","018"
"8293","LONIGO",5294,469,7,5770,"2013","052"
"8294","LORANZE'",14,17,0,31,"2013","137"
"8295","LOREGGIA",308,510,0,818,"2013","046"
"8296","LOREGLIA",6,0,0,6,"2013","038"
"8297","LORENZAGO DI CADORE",3,0,0,3,"2013","032"
"8298","LOREO",567,158,0,725,"2013","030"
"8299","LORIA",6347,23,5,6375,"2013","036"
"8300","LOSINE",0,26,0,26,"2013","094"
"8301","LOVERE",16,19,0,35,"2013","128"
"8302","LOVERO",1,6,0,7,"2013","038"
"8303","LOZIO",0,2,0,2,"2013","095"
"8304","LOZZA",0,121,0,121,"2013","091"
"8305","LOZZO ATESTINO",1570,4,5,1579,"2013","047"
"8306","LOZZO DI CADORE",1,0,0,1,"2013","033"
"8307","LOZZOLO",22,0,0,22,"2013","072"
"8308","LU",72,0,0,72,"2013","089"
"8309","LUGAGNANO VAL D'ARDA",40,222,0,262,"2013","026"
"8310","LUGNACCO",0,2,0,2,"2013","138"
"8311","LUGO",456,105,0,561,"2013","012"
"8312","LUGO DI VICENZA",15,131,0,146,"2013","053"
"8313","LUINO",19,29,0,48,"2013","092"
"8314","LUISAGO",13,0,0,13,"2013","135"
"8315","LUMEZZANE",25,0,0,25,"2013","096"
"8316","LURAGO D'ERBA",6,0,0,6,"2013","136"
"8317","LURAGO MARINONE",0,111,0,111,"2013","137"
"8318","LURANO",21,0,0,21,"2013","129"
"8319","LURATE CACCIVIO",9,0,75,84,"2013","138"
"8320","LUSERNA SAN GIOVANNI",193,72,63,328,"2013","139"
"8321","LUSERNETTA",97,0,0,97,"2013","140"
"8322","LUSIA",26,0,0,26,"2013","031"
"8323","LUSIANA",30,78,0,108,"2013","054"
"8324","LUSIGLIE'",80,0,0,80,"2013","141"
"8325","LUVINATE",1,0,0,1,"2013","093"
"8326","LUZZANA",12,0,0,12,"2013","130"
"8327","LUZZARA",1470,1505,0,2975,"2013","026"
"8328","MACCAGNO",0,8,0,8,"2013","094"
"8329","MACCASTORNA",563,0,0,563,"2013","033"
"8330","MACELLO",1510,240,307,2057,"2013","142"
"8331","MACLODIO",156,290,0,446,"2013","097"
"8332","MACUGNAGA",5,9,0,14,"2013","039"
"8333","MADESIMO",4,20,0,24,"2013","035"
"8334","MADIGNANO",24,604,0,628,"2013","055"
"8335","MADONE",17,0,0,17,"2013","131"
"8336","MADONNA DEL SASSO",18,0,0,18,"2013","040"
"8337","MAGASA",5,14,0,19,"2013","098"
"8338","MAGENTA",27,623,0,650,"2013","130"
"8339","MAGGIORA",122,28,0,150,"2013","088"
"8340","MAGHERNO",0,85,0,85,"2013","085"
"8341","MAGLIANO ALFIERI",589,0,0,589,"2013","113"
"8342","MAGLIANO ALPI",500,106,0,606,"2013","114"
"8343","MAGNACAVALLO",52,241,366,659,"2013","029"
"8344","MAGNAGO",62,0,0,62,"2013","131"
"8345","MAGNANO",16,10,0,26,"2013","030"
"8346","MAIOLO",89,5,0,94,"2013","022"
"8347","MAIRAGO",5,529,0,534,"2013","034"
"8348","MAIRANO",340,703,26,1069,"2013","099"
"8349","MALAGNINO",122,686,0,808,"2013","056"
"8350","MALCESINE",25,81,0,106,"2013","045"
"8351","MALEGNO",5,49,2,56,"2013","100"
"8352","MALEO",141,1181,1,1323,"2013","035"
"8353","MALESCO",5,16,11,32,"2013","041"
"8354","MALGESSO",52,0,0,52,"2013","095"
"8355","MALNATE",42,41,0,83,"2013","096"
"8356","MALO",2102,361,0,2463,"2013","055"
"8357","MALONNO",11,237,2,250,"2013","101"
"8358","MALVICINO",6,7,0,13,"2013","090"
"8359","MANDELLO DEL LARIO",11,0,0,11,"2013","046"
"8360","MANDELLO VITTA",2,0,0,2,"2013","090"
"8361","MANERBA DEL GARDA",28,0,8,36,"2013","102"
"8362","MANERBIO",932,1384,0,2316,"2013","103"
"8363","MANGO",31,0,0,31,"2013","115"
"8364","MANSUE'",66,387,15,468,"2013","037"
"8365","MANTA",3,0,0,3,"2013","116"
"8366","MANTELLO",8,96,0,104,"2013","039"
"8367","MANTOVA",817,771,133,1721,"2013","030"
"8368","MAPELLO",17,13,0,30,"2013","132"
"8369","MARANELLO",118,649,0,767,"2013","019"
"8370","MARANO DI VALPOLICELLA",58,89,4,151,"2013","046"
"8371","MARANO SUL PANARO",98,762,0,860,"2013","020"
"8372","MARANO TICINO",3,232,0,235,"2013","091"
"8373","MARANO VICENTINO",174,323,0,497,"2013","056"
"8374","MARCALLO CON CASONE",2,259,0,261,"2013","134"
"8375","MARCARIA",2371,3362,571,6304,"2013","031"
"8376","MARCHENO",9,6,0,15,"2013","104"
"8377","MARCHIROLO",3,0,0,3,"2013","097"
"8378","MARCIGNAGO",34,0,0,34,"2013","086"
"8379","MARCON",262,12,0,274,"2013","020"
"8380","MARENE",3235,2044,137,5416,"2013","117"
"8381","MARENO DI PIAVE",1012,240,0,1252,"2013","038"
"8382","MARENTINO",148,0,0,148,"2013","144"
"8383","MARETTO",111,0,0,111,"2013","062"
"8384","MARGARITA",717,0,0,717,"2013","118"
"8385","MARGNO",4,6,0,10,"2013","047"
"8386","MARIANA MANTOVANA",67,307,49,423,"2013","032"
"8387","MARIANO COMENSE",530,80,0,610,"2013","143"
"8388","MARMENTINO",19,23,3,45,"2013","105"
"8389","MARMIROLO",2888,2417,2554,7859,"2013","033"
"8390","MARMORA",20,59,11,90,"2013","119"
"8391","MARONE",64,56,0,120,"2013","106"
"8392","MAROSTICA",209,700,12,921,"2013","057"
"8393","MARSAGLIA",164,0,0,164,"2013","120"
"8394","MARTELLAGO",44,2,1,47,"2013","021"
"8395","MARTIGNANA DI PO",1,0,0,1,"2013","057"
"8396","MARTINENGO",245,2523,0,2768,"2013","133"
"8397","MARTINIANA PO",132,83,0,215,"2013","121"
"8398","MARUDO",0,293,0,293,"2013","036"
"8399","MARZABOTTO",4,92,0,96,"2013","036"
"8400","MARZANO",33,222,0,255,"2013","087"
"8401","MARZIO",5,0,0,5,"2013","099"
"8402","MASATE",0,0,141,141,"2013","136"
"8403","MASCIAGO PRIMO",44,0,0,44,"2013","100"
"8404","MASER",3865,55,0,3920,"2013","039"
"8405","MASERA",21,46,1,68,"2013","042"
"8406","MASERA' DI PADOVA",259,88,101,448,"2013","048"
"8407","MASERADA SUL PIAVE",2710,112,0,2822,"2013","040"
"8408","MASI",74,0,0,74,"2013","049"
"8409","MASI TORELLO",2,68,0,70,"2013","012"
"8410","MASIO",421,0,0,421,"2013","091"
"8411","MASLIANICO",0,0,1,1,"2013","144"
"8412","MASON VICENTINO",22,462,0,484,"2013","058"
"8413","MASSA LOMBARDA",6,0,0,6,"2013","013"
"8414","MASSALENGO",0,174,0,174,"2013","037"
"8415","MASSANZAGO",684,149,0,833,"2013","050"
"8416","MASSAZZA",31,7,0,38,"2013","031"
"8417","MASSELLO",3,0,0,3,"2013","145"
"8418","MASSERANO",72,0,0,72,"2013","032"
"8419","MASSINO VISCONTI",14,30,0,44,"2013","093"
"8420","MASSIOLA",2,0,0,2,"2013","043"
"8421","MATHI",93,0,0,93,"2013","146"
"8422","MATTIE",12,0,0,12,"2013","147"
"8423","MAZZANO",101,833,0,934,"2013","107"
"8424","MAZZE'",1328,0,0,1328,"2013","148"
"8425","MAZZO DI VALTELLINA",7,31,4,42,"2013","040"
"8426","MEANA DI SUSA",1,0,0,1,"2013","149"
"8427","MEDE",21,58,0,79,"2013","088"
"8428","MEDESANO",84,1293,0,1377,"2013","020"
"8429","MEDICINA",300,144,0,444,"2013","037"
"8430","MEDIGLIA",31,1215,163,1409,"2013","139"
"8431","MEDOLAGO",10,0,0,10,"2013","250"
"8432","MEDOLE",733,651,719,2103,"2013","034"
"8433","MEDOLLA",1,484,0,485,"2013","021"
"8434","MEDUNA DI LIVENZA",21,17,0,38,"2013","041"
"8435","MEGLIADINO SAN FIDENZIO",938,0,0,938,"2013","051"
"8436","MEGLIADINO SAN VITALE",1408,0,0,1408,"2013","052"
"8437","MEINA",2,0,0,2,"2013","095"
"8438","MEL",81,326,0,407,"2013","034"
"8439","MELARA",201,0,0,201,"2013","032"
"8440","MELAZZO",208,0,0,208,"2013","092"
"8441","MELDOLA",180,56,0,236,"2013","019"
"8442","MELEGNANO",2,186,0,188,"2013","140"
"8443","MELETI",20,450,0,470,"2013","038"
"8444","MELLE",44,29,0,73,"2013","122"
"8445","MELLO",25,46,0,71,"2013","041"
"8446","MELZO",9,302,0,311,"2013","142"
"8447","MENAGGIO",2,0,1,3,"2013","145"
"8448","MENCONICO",18,0,0,18,"2013","089"
"8449","MEOLO",1295,130,0,1425,"2013","022"
"8450","MERANA",22,0,0,22,"2013","093"
"8451","MERATE",179,292,30,501,"2013","048"
"8452","MERCATO SARACENO",193,20,1,214,"2013","020"
"8453","MERCENASCO",315,0,0,315,"2013","150"
"8454","MERGOZZO",29,0,0,29,"2013","044"
"8455","MERLARA",512,7,0,519,"2013","053"
"8456","MERLINO",20,866,0,886,"2013","039"
"8457","MERONE",21,66,10,97,"2013","147"
"8458","MESE",26,28,0,54,"2013","043"
"8459","MESENZANA",0,20,0,20,"2013","102"
"8460","MESERO",0,64,0,64,"2013","144"
"8461","MESOLA",2055,263,0,2318,"2013","014"
"8462","MESTRINO",102,147,19,268,"2013","054"
"8463","MEUGLIANO",7,0,0,7,"2013","151"
"8464","MEZZAGO",1,0,0,1,"2013",NA
"8465","MEZZANA BIGLI",67,0,0,67,"2013","090"
"8466","MEZZANE DI SOTTO",0,20,0,20,"2013","047"
"8467","MEZZANI",8,349,0,357,"2013","021"
"8468","MEZZANINO",6,0,0,6,"2013","092"
"8469","MEZZEGRA",2,4,11,17,"2013","148"
"8470","MEZZENILE",31,45,0,76,"2013","152"
"8471","MEZZOLDO",1,22,0,23,"2013","134"
"8472","MEZZOMERICO",7,0,0,7,"2013","097"
"8473","MIAGLIANO",6,0,0,6,"2013","034"
"8474","MIANE",21,11,0,32,"2013","042"
"8475","MIASINO",0,0,30,30,"2013","098"
"8476","MIAZZINA",2,0,0,2,"2013","045"
"8477","MIGLIARINO",1040,0,0,1040,"2013","015"
"8478","MIGLIARO",928,88,0,1016,"2013","026"
"8479","MILANO",465,89,0,554,"2013","146"
"8480","MILZANO",2,864,0,866,"2013","108"
"8481","MINERBE",1986,221,0,2207,"2013","048"
"8482","MINERBIO",67,0,0,67,"2013","038"
"8483","MIRA",1433,661,9,2103,"2013","023"
"8484","MIRABELLO MONFERRATO",68,0,0,68,"2013","094"
"8485","MIRADOLO TERME",34,72,22,128,"2013","093"
"8486","MIRANDOLA",293,1006,0,1299,"2013","022"
"8487","MIRANO",810,773,17,1600,"2013","024"
"8488","MISANO ADRIATICO",14,0,0,14,"2013","005"
"8489","MISANO DI GERA D'ADDA",18,203,25,246,"2013","135"
"8490","MISINTO",4,0,0,4,"2013",NA
"8491","MISSAGLIA",22,219,194,435,"2013","049"
"8492","MODENA",521,2732,0,3253,"2013","023"
"8493","MODIGLIANA",96,2,4,102,"2013","022"
"8494","MOGLIA",5158,675,563,6396,"2013","035"
"8495","MOGLIANO VENETO",1053,427,112,1592,"2013","043"
"8496","MOIO DE' CALVI",5,5,0,10,"2013","136"
"8497","MOIOLA",5,3,0,8,"2013","123"
"8498","MOLARE",4,0,0,4,"2013","095"
"8499","MOLINELLA",1882,209,0,2091,"2013","039"
"8500","MOLLIA",3,0,0,3,"2013","078"
"8501","MOLTENO",17,43,0,60,"2013","051"
"8502","MOLVENA",14,8,0,22,"2013","059"
"8503","MOMBALDONE",66,0,2,68,"2013","064"
"8504","MOMBARCARO",102,0,0,102,"2013","124"
"8505","MOMBARUZZO",9,0,0,9,"2013","065"
"8506","MOMBASIGLIO",115,0,0,115,"2013","125"
"8507","MOMBELLO DI TORINO",40,0,0,40,"2013","153"
"8508","MOMBELLO MONFERRATO",42,0,0,42,"2013","097"
"8509","MOMBERCELLI",59,0,0,59,"2013","066"
"8510","MOMO",151,741,0,892,"2013","100"
"8511","MOMPERONE",5,0,0,5,"2013","098"
"8512","MONALE",44,0,0,44,"2013","067"
"8513","MONASTERO BORMIDA",394,0,0,394,"2013","068"
"8514","MONASTERO DI LANZO",18,63,1,82,"2013","155"
"8515","MONASTERO DI VASCO",429,7,35,471,"2013","126"
"8516","MONASTEROLO CASOTTO",44,0,0,44,"2013","127"
"8517","MONASTEROLO DEL CASTELLO",5,14,0,19,"2013","137"
"8518","MONASTEROLO DI SAVIGLIANO",370,244,36,650,"2013","128"
"8519","MONASTIER DI TREVISO",1787,395,0,2182,"2013","044"
"8520","MONCALIERI",347,369,0,716,"2013","156"
"8521","MONCALVO",123,0,0,123,"2013","069"
"8522","MONCENISIO",7,0,0,7,"2013","157"
"8523","MONCESTINO",8,0,0,8,"2013","099"
"8524","MONCHIERO",206,0,0,206,"2013","129"
"8525","MONCHIO DELLE CORTI",30,156,0,186,"2013","022"
"8526","MONCRIVELLO",120,178,0,298,"2013","079"
"8527","MONCUCCO TORINESE",39,0,0,39,"2013","070"
"8528","MONDAINO",12,0,0,12,"2013","006"
"8529","MONDOVI'",5346,402,27,5775,"2013","130"
"8530","MONESIGLIO",114,0,0,114,"2013","131"
"8531","MONFORTE D'ALBA",242,0,0,242,"2013","132"
"8532","MONFUMO",51,253,0,304,"2013","045"
"8533","MONGARDINO",26,0,0,26,"2013","071"
"8534","MONGHIDORO",22,66,40,128,"2013","040"
"8535","MONGIARDINO LIGURE",18,0,17,35,"2013","100"
"8536","MONGRANDO",120,116,9,245,"2013","035"
"8537","MONGUZZO",20,0,0,20,"2013","153"
"8538","MONIGA DEL GARDA",0,22,0,22,"2013","109"
"8539","MONNO",5,48,0,53,"2013","110"
"8540","MONSELICE",521,59,0,580,"2013","055"
"8541","MONTA'",109,0,0,109,"2013","133"
"8542","MONTABONE",89,0,0,89,"2013","072"
"8543","MONTACUTO",26,0,0,26,"2013","102"
"8544","MONTAFIA",63,0,0,63,"2013","073"
"8545","MONTAGNA IN VALTELLINA",7,89,0,96,"2013","044"
"8546","MONTAGNANA",1611,45,14,1670,"2013","056"
"8547","MONTALDO BORMIDA",3,0,0,3,"2013","104"
"8548","MONTALDO DI MONDOVI'",89,6,0,95,"2013","134"
"8549","MONTALDO ROERO",23,0,0,23,"2013","135"
"8550","MONTALDO SCARAMPI",24,0,0,24,"2013","074"
"8551","MONTALDO TORINESE",472,0,0,472,"2013","158"
"8552","MONTALENGHE",3,0,0,3,"2013","159"
"8553","MONTALTO DORA",18,0,0,18,"2013","160"
"8554","MONTALTO PAVESE",50,0,0,50,"2013","094"
"8555","MONTANARO",152,144,15,311,"2013","161"
"8556","MONTANASO LOMBARDO",267,421,0,688,"2013","040"
"8557","MONTANERA",1711,805,133,2649,"2013","136"
"8558","MONTANO LUCINO",7,19,8,34,"2013","154"
"8559","MONTE COLOMBO",73,0,0,73,"2013","007"
"8560","MONTE CREMASCO",335,181,0,516,"2013","058"
"8561","MONTE DI MALO",472,175,0,647,"2013","063"
"8562","MONTE ISOLA",26,0,0,26,"2013","111"
"8563","MONTE MARENZO",14,0,1,15,"2013","052"
"8564","MONTE SAN PIETRO",104,167,0,271,"2013","042"
"8565","MONTEBELLO DELLA BATTAGLIA",0,44,0,44,"2013","095"
"8566","MONTEBELLO VICENTINO",85,0,217,302,"2013","060"
"8567","MONTEBELLUNA",3607,623,34,4264,"2013","046"
"8568","MONTECALVO VERSIGGIA",2,0,0,2,"2013",NA
"8569","MONTECASTELLO",1,0,0,1,"2013","105"
"8570","MONTECCHIA DI CROSARA",977,0,0,977,"2013","049"
"8571","MONTECCHIO EMILIA",27,1318,0,1345,"2013","027"
"8572","MONTECCHIO MAGGIORE",200,61,1,262,"2013","061"
"8573","MONTECCHIO PRECALCINO",223,146,49,418,"2013","062"
"8574","MONTECHIARO D'ACQUI",76,0,0,76,"2013","106"
"8575","MONTECHIARO D'ASTI",262,0,0,262,"2013","075"
"8576","MONTECHIARUGOLO",7,3175,0,3182,"2013","023"
"8577","MONTECRESTESE",34,35,0,69,"2013","046"
"8578","MONTECRETO",8,391,0,399,"2013","024"
"8579","MONTEFIORE CONCA",32,8,0,40,"2013","008"
"8580","MONTEFIORINO",16,348,0,364,"2013","025"
"8581","MONTEFORTE D'ALPONE",809,54,0,863,"2013","050"
"8582","MONTEGALDA",217,205,0,422,"2013","064"
"8583","MONTEGALDELLA",120,234,61,415,"2013","065"
"8584","MONTEGIOCO",36,0,0,36,"2013","107"
"8585","MONTEGRIDOLFO",2,0,0,2,"2013","009"
"8586","MONTEGRINO VALTRAVAGLIA",18,0,0,18,"2013","103"
"8587","MONTEGROSSO D'ASTI",23,0,0,23,"2013","076"
"8588","MONTEGROTTO TERME",16,0,49,65,"2013","057"
"8589","MONTELLO",2,0,0,2,"2013","139"
"8590","MONTELUPO ALBESE",81,0,0,81,"2013","137"
"8591","MONTEMAGNO",141,0,0,141,"2013","077"
"8592","MONTEMALE DI CUNEO",15,0,0,15,"2013","138"
"8593","MONTEMARZINO",1,0,0,1,"2013","108"
"8594","MONTEMEZZO",2,0,0,2,"2013","155"
"8595","MONTERENZIO",339,158,2,499,"2013","041"
"8596","MONTEROSSO GRANA",17,127,2,146,"2013","139"
"8597","MONTESCANO",1,0,0,1,"2013","097"
"8598","MONTESCHENO",2,0,0,2,"2013","047"
"8599","MONTESCUDO",174,0,0,174,"2013","010"
"8600","MONTESE",57,1289,0,1346,"2013","026"
"8601","MONTESEGALE",16,0,0,16,"2013","098"
"8602","MONTEU DA PO",100,0,0,100,"2013","162"
"8603","MONTEU ROERO",740,0,0,740,"2013","140"
"8604","MONTEVECCHIA",12,4,0,16,"2013","053"
"8605","MONTEVEGLIO",14,53,3,70,"2013","043"
"8606","MONTEVIALE",143,8,0,151,"2013","066"
"8607","MONTEZEMOLO",132,0,0,132,"2013","141"
"8608","MONTICELLI BRUSATI",9,206,2,217,"2013","112"
"8609","MONTICELLI D'ONGINA",312,586,0,898,"2013","027"
"8610","MONTICELLI PAVESE",1126,356,0,1482,"2013","099"
"8611","MONTICELLO BRIANZA",9,0,260,269,"2013","054"
"8612","MONTICELLO CONTE OTTO",104,788,0,892,"2013","067"
"8613","MONTICELLO D'ALBA",96,0,0,96,"2013","142"
"8614","MONTICHIARI",10660,6445,501,17606,"2013","113"
"8615","MONTIGLIO MONFERRATO",255,0,0,255,"2013","121"
"8616","MONTIRONE",4291,634,0,4925,"2013","114"
"8617","MONTODINE",7,1010,0,1017,"2013","059"
"8618","MONTORFANO",15,0,0,15,"2013","157"
"8619","MONTORSO VICENTINO",581,155,0,736,"2013","068"
"8620","MONTU' BECCARIA",3,0,0,3,"2013","100"
"8621","MONVALLE",15,29,0,44,"2013","104"
"8622","MONZA",6,115,0,121,"2013",NA
"8623","MONZAMBANO",1346,699,651,2696,"2013","036"
"8624","MONZUNO",89,70,0,159,"2013","044"
"8625","MORANO SUL PO",2,0,0,2,"2013","109"
"8626","MORANSENGO",129,0,0,129,"2013","079"
"8627","MORAZZONE",18,83,0,101,"2013","105"
"8628","MORBEGNO",19,91,1,111,"2013","045"
"8629","MORBELLO",6,0,0,6,"2013","110"
"8630","MORDANO",1,0,0,1,"2013","045"
"8631","MORENGO",72,53,0,125,"2013","140"
"8632","MORETTA",1371,717,210,2298,"2013","143"
"8633","MORFASSO",109,6,0,115,"2013","028"
"8634","MORGANO",1491,15,0,1506,"2013","047"
"8635","MORIAGO DELLA BATTAGLIA",2203,81,0,2284,"2013","048"
"8636","MORIMONDO",40,1375,0,1415,"2013","150"
"8637","MORIONDO TORINESE",258,0,0,258,"2013","163"
"8638","MORNAGO",30,0,0,30,"2013","106"
"8639","MORNESE",39,0,0,39,"2013","111"
"8640","MORNICO AL SERIO",2951,283,87,3321,"2013","141"
"8641","MORNICO LOSANA",36,0,0,36,"2013","101"
"8642","MOROZZO",2077,503,403,2983,"2013","144"
"8643","MORSASCO",138,0,3,141,"2013","112"
"8644","MORTARA",53,0,0,53,"2013","102"
"8645","MORTERONE",18,0,0,18,"2013","055"
"8646","MOSCAZZANO",146,1134,226,1506,"2013","060"
"8647","MOSSANO",555,66,0,621,"2013","069"
"8648","MOSSO",27,13,15,55,"2013","084"
"8649","MOTTA BALUFFI",5,97,0,102,"2013","061"
"8650","MOTTA DI LIVENZA",508,33,1,542,"2013","049"
"8651","MOTTA VISCONTI",1,0,0,1,"2013","151"
"8652","MOTTALCIATA",50,59,0,109,"2013","037"
"8653","MOTTEGGIANA",779,1165,614,2558,"2013","037"
"8654","MOZZANICA",198,666,0,864,"2013","142"
"8655","MOZZATE",22,95,0,117,"2013","159"
"8656","MOZZECANE",3436,679,31,4146,"2013","051"
"8657","MUGGIÒ",7,0,0,7,"2013",NA
"8658","MULAZZANO",3,1138,0,1141,"2013","041"
"8659","MURA",30,46,7,83,"2013","115"
"8660","MURAZZANO",381,0,66,447,"2013","145"
"8661","MURELLO",444,1181,198,1823,"2013","146"
"8662","MURISENGO",308,0,0,308,"2013","113"
"8663","MUSCOLINE",58,353,5,416,"2013","116"
"8664","MUSILE DI PIAVE",33,46,0,79,"2013","025"
"8665","MUSSO",1,4,3,8,"2013","160"
"8666","MUSSOLENTE",143,226,87,456,"2013","070"
"8667","MUZZANO",34,0,0,34,"2013","038"
"8668","NANTO",215,191,0,406,"2013","071"
"8669","NARZOLE",984,153,21,1158,"2013","147"
"8670","NAVE",61,147,0,208,"2013","117"
"8671","NEBBIUNO",42,11,8,61,"2013","103"
"8672","NEGRAR",14,120,0,134,"2013","052"
"8673","NEIVE",30,0,0,30,"2013","148"
"8674","NEMBRO",40,0,0,40,"2013","144"
"8675","NERVESA DELLA BATTAGLIA",472,287,0,759,"2013","050"
"8676","NERVIANO",34,140,0,174,"2013","154"
"8677","NESSO",0,12,0,12,"2013","161"
"8678","NETRO",112,63,0,175,"2013","039"
"8679","NEVIANO DEGLI ARDUINI",36,1971,0,2007,"2013","024"
"8680","NEVIGLIE",6,0,0,6,"2013","149"
"8681","NIARDO",2,174,15,191,"2013","118"
"8682","NIBBIANO",247,0,0,247,"2013","029"
"8683","NIBIONNO",3,10,0,13,"2013","056"
"8684","NICHELINO",61,0,0,61,"2013","164"
"8685","NICORVO",12,0,0,12,"2013","103"
"8686","NIELLA BELBO",48,109,0,157,"2013","150"
"8687","NIELLA TANARO",162,0,0,162,"2013","151"
"8688","NIZZA MONFERRATO",101,0,0,101,"2013","080"
"8689","NOALE",456,73,16,545,"2013","026"
"8690","NOASCA",14,19,30,63,"2013","165"
"8691","NOCETO",35,3077,15,3127,"2013","025"
"8692","NOGARA",1962,549,0,2511,"2013","053"
"8693","NOGAROLE ROCCA",667,267,0,934,"2013","054"
"8694","NOGAROLE VICENTINO",13,39,0,52,"2013","072"
"8695","NOLE",95,142,0,237,"2013","166"
"8696","NONANTOLA",4,157,0,161,"2013","027"
"8697","NONE",813,957,204,1974,"2013","168"
"8698","NOSATE",0,425,0,425,"2013","155"
"8699","NOVA MILANESE",2,46,0,48,"2013",NA
"8700","NOVAFELTRIA",1135,200,0,1335,"2013","023"
"8701","NOVALESA",24,17,0,41,"2013","169"
"8702","NOVARA",47,280,0,327,"2013","106"
"8703","NOVATE MEZZOLA",14,57,0,71,"2013","046"
"8704","NOVE",22,286,15,323,"2013","073"
"8705","NOVEDRATE",1077,0,0,1077,"2013","163"
"8706","NOVELLARA",2696,2091,3,4790,"2013","028"
"8707","NOVELLO",994,0,0,994,"2013","152"
"8708","NOVENTA DI PIAVE",10,22,0,32,"2013","027"
"8709","NOVENTA PADOVANA",10,0,0,10,"2013","058"
"8710","NOVENTA VICENTINA",3601,0,0,3601,"2013","074"
"8711","NOVI DI MODENA",877,782,0,1659,"2013","028"
"8712","NOVI LIGURE",496,0,0,496,"2013","114"
"8713","NOVIGLIO",18,498,0,516,"2013","158"
"8714","NUVOLENTO",9,860,0,869,"2013","119"
"8715","NUVOLERA",1406,319,0,1725,"2013","120"
"8716","OCCHIEPPO INFERIORE",8,118,0,126,"2013","040"
"8717","OCCHIEPPO SUPERIORE",43,41,39,123,"2013","041"
"8718","OCCHIOBELLO",5,169,0,174,"2013","033"
"8719","OCCIMIANO",43,0,0,43,"2013","115"
"8720","ODALENGO GRANDE",94,0,0,94,"2013","116"
"8721","ODERZO",165,412,0,577,"2013","051"
"8722","ODOLO",2,0,0,2,"2013","121"
"8723","OFFANENGO",233,454,0,687,"2013","062"
"8724","OFFLAGA",653,3400,0,4053,"2013","122"
"8725","OGGEBBIO",5,0,0,5,"2013","049"
"8726","OGGIONA CON SANTO STEFANO",3,32,0,35,"2013","107"
"8727","OGGIONO",51,83,3,137,"2013","057"
"8728","OGLIANICO",99,294,0,393,"2013","170"
"8729","OLCENENGO",3,0,0,3,"2013","088"
"8730","OLDENICO",2,0,0,2,"2013","089"
"8731","OLEGGIO",221,833,0,1054,"2013","108"
"8732","OLEGGIO CASTELLO",33,0,0,33,"2013","109"
"8733","OLGIATE COMASCO",54,0,18,72,"2013","165"
"8734","OLGIATE MOLGORA",23,102,0,125,"2013","058"
"8735","OLGIATE OLONA",3,0,0,3,"2013","108"
"8736","OLGINATE",10,0,0,10,"2013","059"
"8737","OLIVETO LARIO",15,0,0,15,"2013","060"
"8738","OLMENETA",16,349,96,461,"2013","063"
"8739","OLMO AL BREMBO",2,5,0,7,"2013","145"
"8740","OLMO GENTILE",36,0,4,40,"2013","081"
"8741","OLTRE IL COLLE",37,87,0,124,"2013","146"
"8742","OLTRESSENDA ALTA",16,22,0,38,"2013","147"
"8743","OLTRONA DI SAN MAMETTE",16,0,0,16,"2013","169"
"8744","OME",18,19,0,37,"2013","123"
"8745","OMEGNA",26,0,0,26,"2013","050"
"8746","ONCINO",63,0,0,63,"2013","154"
"8747","ONETA",1,43,0,44,"2013","148"
"8748","ONO SAN PIETRO",2,18,0,20,"2013","124"
"8749","ONORE",8,17,0,25,"2013","149"
"8750","OPERA",0,61,0,61,"2013","159"
"8751","OPPEANO",4247,878,0,5125,"2013","055"
"8752","ORBASSANO",651,0,230,881,"2013","171"
"8753","ORGIANO",522,18,0,540,"2013","075"
"8754","ORIGGIO",57,0,0,57,"2013","109"
"8755","ORIO CANAVESE",66,0,0,66,"2013","172"
"8756","ORIO LITTA",0,143,0,143,"2013","042"
"8757","ORMEA",138,12,0,150,"2013","155"
"8758","ORMELLE",25,177,23,225,"2013","052"
"8759","ORNAGO",23,34,0,57,"2013",NA
"8760","ORNAVASSO",19,0,0,19,"2013","051"
"8761","ORNICA",7,0,0,7,"2013","151"
"8762","ORSAGO",17,127,0,144,"2013","053"
"8763","ORSARA BORMIDA",14,0,0,14,"2013","119"
"8764","ORSENIGO",7,47,2,56,"2013","170"
"8765","ORTA SAN GIULIO",1,0,0,1,"2013","112"
"8766","ORZINUOVI",622,3929,103,4654,"2013","125"
"8767","ORZIVECCHI",24,577,0,601,"2013","126"
"8768","OSASCO",404,0,78,482,"2013","173"
"8769","OSASIO",186,294,0,480,"2013","174"
"8770","OSIO SOPRA",27,612,0,639,"2013","152"
"8771","OSIO SOTTO",13,0,0,13,"2013","153"
"8772","OSMATE",45,0,0,45,"2013","111"
"8773","OSNAGO",276,72,0,348,"2013","061"
"8774","OSPEDALETTO EUGANEO",368,48,0,416,"2013","059"
"8775","OSPEDALETTO LODIGIANO",0,966,0,966,"2013","043"
"8776","OSPITALETTO",103,125,0,228,"2013","127"
"8777","OSSAGO LODIGIANO",61,1711,86,1858,"2013","044"
"8778","OSSIMO",0,26,0,26,"2013","128"
"8779","OSSONA",52,0,0,52,"2013","164"
"8780","OSSUCCIO",0,0,4,4,"2013","172"
"8781","OSTANA",41,0,0,41,"2013","156"
"8782","OSTELLATO",4246,12,0,4258,"2013","017"
"8783","OSTIANO",456,1280,66,1802,"2013","064"
"8784","OSTIGLIA",48,33,62,143,"2013","038"
"8785","OTTIGLIO",96,0,0,96,"2013","120"
"8786","OTTOBIANO",2,58,0,60,"2013","106"
"8787","OTTONE",89,0,0,89,"2013","030"
"8788","OULX",48,0,0,48,"2013","175"
"8789","OVADA",45,0,0,45,"2013","121"
"8790","OVIGLIO",31,0,0,31,"2013","122"
"8791","OZEGNA",132,24,0,156,"2013","176"
"8792","OZZANO DELL'EMILIA",157,270,0,427,"2013","046"
"8793","OZZANO MONFERRATO",68,0,0,68,"2013","123"
"8794","OZZERO",49,288,0,337,"2013","165"
"8795","PADENGHE SUL GARDA",53,0,0,53,"2013","129"
"8796","PADERNO D'ADDA",0,25,0,25,"2013","062"
"8797","PADERNO DEL GRAPPA",62,143,0,205,"2013","054"
"8798","PADERNO DUGNANO",43,0,8,51,"2013","166"
"8799","PADERNO FRANCIACORTA",1,125,88,214,"2013","130"
"8800","PADERNO PONCHIELLI",285,1804,86,2175,"2013","065"
"8801","PADOVA",443,306,101,850,"2013","060"
"8802","PAESANA",672,62,9,743,"2013","157"
"8803","PAESE",2098,720,106,2924,"2013","055"
"8804","PAGAZZANO",5,0,0,5,"2013","154"
"8805","PAGNO",35,0,0,35,"2013","158"
"8806","PAGNONA",12,0,9,21,"2013","063"
"8807","PAISCO LOVENO",1,12,0,13,"2013","131"
"8808","PAITONE",48,34,0,82,"2013","132"
"8809","PALADINA",0,5,0,5,"2013","155"
"8810","PALAGANO",118,720,1,839,"2013","029"
"8811","PALANZANO",13,497,0,510,"2013","026"
"8812","PALAZZAGO",79,109,0,188,"2013","156"
"8813","PALAZZO CANAVESE",4,0,0,4,"2013","177"
"8814","PALAZZO PIGNANO",34,906,0,940,"2013","066"
"8815","PALAZZOLO SULL'OGLIO",1463,1253,37,2753,"2013","133"
"8816","PALAZZOLO VERCELLESE",4,0,0,4,"2013","090"
"8817","PALESTRO",0,0,12,12,"2013","107"
"8818","PALLANZENO",1,0,0,1,"2013","052"
"8819","PALOSCO",445,438,0,883,"2013","157"
"8820","PALU'",658,0,0,658,"2013","056"
"8821","PAMPARATO",60,0,0,60,"2013","159"
"8822","PANCALIERI",10,146,0,156,"2013","178"
"8823","PANDINO",32,3540,416,3988,"2013","067"
"8824","PANTIGLIATE",3,0,0,3,"2013","167"
"8825","PAPOZZE",46,98,0,144,"2013","034"
"8826","PARABIAGO",75,43,0,118,"2013","168"
"8827","PARATICO",8,44,0,52,"2013","134"
"8828","PARETO",61,3,0,64,"2013","125"
"8829","PARMA",838,9547,0,10385,"2013","027"
"8830","PARODI LIGURE",14,0,44,58,"2013","126"
"8831","PAROLDO",21,0,0,21,"2013","160"
"8832","PARONA",8,0,0,8,"2013","109"
"8833","PARRE",41,64,0,105,"2013","158"
"8834","PARUZZARO",27,34,0,61,"2013","114"
"8835","PARZANICA",0,2,9,11,"2013","159"
"8836","PASPARDO",2,6,0,8,"2013","135"
"8837","PASSERANO MARMORITO",100,0,0,100,"2013","082"
"8838","PASSIRANO",217,246,0,463,"2013","136"
"8839","PASTRENGO",3,136,0,139,"2013","057"
"8840","PASTURO",44,131,30,205,"2013","065"
"8841","PAULLO",0,472,0,472,"2013","169"
"8842","PAVAROLO",72,0,0,72,"2013","180"
"8843","PAVIA",147,244,3,394,"2013","110"
"8844","PAVONE CANAVESE",132,0,0,132,"2013","181"
"8845","PAVONE DEL MELLA",1452,435,14,1901,"2013","137"
"8846","PAVULLO NEL FRIGNANO",671,3905,0,4576,"2013","030"
"8847","PECETTO DI VALENZA",36,0,0,36,"2013","128"
"8848","PECETTO TORINESE",115,0,0,115,"2013","183"
"8849","PECORARA",347,121,0,468,"2013","031"
"8850","PEDAVENA",7,121,0,128,"2013","036"
"8851","PEDEMONTE",8,5,0,13,"2013","076"
"8852","PEDEROBBA",140,170,0,310,"2013","056"
"8853","PEDRENGO",17,163,0,180,"2013","160"
"8854","PEGLIO",5,0,7,12,"2013","178"
"8855","PEGOGNAGA",2351,1751,1660,5762,"2013","039"
"8856","PEIA",9,6,1,16,"2013","161"
"8857","PELLEGRINO PARMENSE",19,760,9,788,"2013","028"
"8858","PELLIO INTELVI",3,15,26,44,"2013","179"
"8859","PENANGO",74,0,0,74,"2013","083"
"8860","PENNABILLI",266,17,0,283,"2013","024"
"8861","PEREGO",3,0,7,10,"2013","066"
"8862","PERLEDO",5,0,0,5,"2013","067"
"8863","PERLETTO",183,0,0,183,"2013","161"
"8864","PERLO",38,1,0,39,"2013","162"
"8865","PERNUMIA",345,150,0,495,"2013","061"
"8866","PERO",4,0,0,4,"2013",NA
"8867","PEROSA ARGENTINA",51,17,0,68,"2013","184"
"8868","PEROSA CANAVESE",103,166,0,269,"2013","185"
"8869","PERRERO",29,0,0,29,"2013","186"
"8870","PERSICO DOSIMO",2,1783,0,1785,"2013","068"
"8871","PERTENGO",1,0,0,1,"2013","091"
"8872","PERTICA ALTA",14,11,3,28,"2013","139"
"8873","PERTICA BASSA",29,55,1,85,"2013","140"
"8874","PERTUSIO",59,0,0,59,"2013","187"
"8875","PESCANTINA",39,115,0,154,"2013","058"
"8876","PESCAROLO ED UNITI",82,825,0,907,"2013","069"
"8877","PESCHIERA BORROMEO",359,124,0,483,"2013","171"
"8878","PESSANO CON BORNAGO",68,125,0,193,"2013","172"
"8879","PESSINA CREMONESE",404,2858,0,3262,"2013","070"
"8880","PESSINETTO",4,0,0,4,"2013","188"
"8881","PETTENASCO",13,0,0,13,"2013","116"
"8882","PETTINENGO",7,0,27,34,"2013","042"
"8883","PETTORAZZA GRIMANI",280,220,0,500,"2013","035"
"8884","PEVERAGNO",1149,453,71,1673,"2013","163"
"8885","PEZZAZE",15,22,0,37,"2013","141"
"8886","PEZZOLO VALLE UZZONE",77,0,0,77,"2013","164"
"8887","PIACENZA",600,1335,0,1935,"2013","032"
"8888","PIACENZA D'ADIGE",436,0,0,436,"2013","062"
"8889","PIADENA",0,449,5,454,"2013","071"
"8890","PIAN CAMUNO",1,221,0,222,"2013","142"
"8891","PIANCOGNO",1,35,0,36,"2013","206"
"8892","PIANELLO DEL LARIO",0,2,7,9,"2013","183"
"8893","PIANELLO VAL TIDONE",345,72,0,417,"2013","033"
"8894","PIANENGO",2,59,0,61,"2013","072"
"8895","PIANEZZA",302,407,74,783,"2013","189"
"8896","PIANEZZE",91,111,0,202,"2013","077"
"8897","PIANFEI",861,65,32,958,"2013","165"
"8898","PIANICO",12,89,0,101,"2013","162"
"8899","PIANIGA",30,30,6,66,"2013","028"
"8900","PIANORO",151,198,0,349,"2013","047"
"8901","PIANTEDO",18,317,0,335,"2013","048"
"8902","PIARIO",0,31,0,31,"2013","163"
"8903","PIASCO",140,243,0,383,"2013","166"
"8904","PIATEDA",19,70,0,89,"2013","049"
"8905","PIATTO",22,0,0,22,"2013","043"
"8906","PIAZZA BREMBANA",0,4,0,4,"2013","164"
"8907","PIAZZOLA SUL BRENTA",2735,1189,4,3928,"2013","063"
"8908","PIAZZOLO",18,0,0,18,"2013","166"
"8909","PIEA",71,0,0,71,"2013","084"
"8910","PIEDIMULERA",0,32,1,33,"2013","053"
"8911","PIERANICA",33,0,0,33,"2013","073"
"8912","PIETRA DE' GIORGI",11,0,0,11,"2013","111"
"8913","PIEVE D'ALPAGO",27,39,0,66,"2013","038"
"8914","PIEVE D'OLMI",2,1458,332,1792,"2013","074"
"8915","PIEVE DEL CAIRO",2,66,0,68,"2013","113"
"8916","PIEVE DI CADORE",6,9,0,15,"2013","039"
"8917","PIEVE DI CORIANO",0,0,140,140,"2013","040"
"8918","PIEVE DI SOLIGO",73,118,14,205,"2013","057"
"8919","PIEVE EMANUELE",0,333,86,419,"2013","173"
"8920","PIEVE FISSIRAGA",96,1202,0,1298,"2013","045"
"8921","PIEVE PORTO MORONE",107,0,0,107,"2013","114"
"8922","PIEVE SAN GIACOMO",34,1828,0,1862,"2013","075"
"8923","PIEVE VERGONTE",33,2,26,61,"2013","054"
"8924","PIEVEPELAGO",56,83,0,139,"2013","031"
"8925","PILA",1,0,0,1,"2013",NA
"8926","PINAROLO PO",2388,0,0,2388,"2013","115"
"8927","PINASCA",90,34,4,128,"2013","190"
"8928","PINCARA",415,0,0,415,"2013","036"
"8929","PINEROLO",1652,151,162,1965,"2013","191"
"8930","PINO D'ASTI",7,0,0,7,"2013","085"
"8931","PINO TORINESE",545,0,69,614,"2013","192"
"8932","PIOBESI TORINESE",451,1069,101,1621,"2013","193"
"8933","PIODE",0,18,0,18,"2013","097"
"8934","PIOLTELLO",6,0,0,6,"2013","175"
"8935","PIOMBINO DESE",4729,562,0,5291,"2013","064"
"8936","PIOSSASCO",448,399,163,1010,"2013","194"
"8937","PIOVA' MASSAIA",91,0,0,91,"2013","086"
"8938","PIOVE DI SACCO",2670,185,13,2868,"2013","065"
"8939","PIOVENE ROCCHETTE",1228,138,0,1366,"2013","078"
"8940","PIOVERA",234,292,0,526,"2013","130"
"8941","PIOZZANO",175,7,0,182,"2013","034"
"8942","PIOZZO",363,0,0,363,"2013","169"
"8943","PISCINA",1712,0,0,1712,"2013","195"
"8944","PISOGNE",15,248,1,264,"2013","143"
"8945","PIUBEGA",2823,604,48,3475,"2013","041"
"8946","PIURO",12,151,0,163,"2013","050"
"8947","PIVERONE",41,109,0,150,"2013","196"
"8948","PIZZIGHETTONE",143,3552,0,3695,"2013","076"
"8949","PLESIO",4,0,1,5,"2013","185"
"8950","POCAPAGLIA",463,62,0,525,"2013","170"
"8951","PODENZANO",112,721,0,833,"2013","035"
"8952","POGGIO BERNI",96,0,0,96,"2013","012"
"8953","POGGIO RENATICO",0,346,0,346,"2013","018"
"8954","POGGIO RUSCO",459,350,116,925,"2013","042"
"8955","POGGIRIDENTI",4,7,0,11,"2013","051"
"8956","POGLIANO MILANESE",1,0,0,1,"2013","176"
"8957","POGNANO",18,381,0,399,"2013","167"
"8958","POIRINO",3716,580,0,4296,"2013","197"
"8959","POJANA MAGGIORE",1475,35,0,1510,"2013","079"
"8960","POLAVENO",20,4,0,24,"2013","144"
"8961","POLESELLA",11,0,0,11,"2013","037"
"8962","POLESINE PARMENSE",9,329,0,338,"2013","029"
"8963","POLINAGO",56,711,0,767,"2013","032"
"8964","POLLONE",260,26,0,286,"2013","046"
"8965","POLONGHERA",221,183,0,404,"2013","171"
"8966","POLPENAZZE DEL GARDA",12,124,0,136,"2013","145"
"8967","POLVERARA",70,80,0,150,"2013","066"
"8968","POMARETTO",40,0,12,52,"2013","198"
"8969","POMARO MONFERRATO",16,217,0,233,"2013","131"
"8970","POMBIA",8,53,0,61,"2013","121"
"8971","POMPIANO",22,1274,0,1296,"2013","146"
"8972","POMPONESCO",7,434,15,456,"2013","043"
"8973","PONCARALE",521,721,42,1284,"2013","147"
"8974","PONDERANO",32,25,37,94,"2013","047"
"8975","PONNA",1,0,15,16,"2013","187"
"8976","PONSO",115,0,0,115,"2013","067"
"8977","PONT-CANAVESE",34,90,0,124,"2013","199"
"8978","PONTE DELL'OLIO",77,189,0,266,"2013","036"
"8979","PONTE DI LEGNO",4,25,0,29,"2013","148"
"8980","PONTE DI PIAVE",58,93,0,151,"2013","058"
"8981","PONTE IN VALTELLINA",6,16,0,22,"2013","052"
"8982","PONTE LAMBRO",2,20,0,22,"2013","188"
"8983","PONTE NELLE ALPI",34,203,0,237,"2013","040"
"8984","PONTE NIZZA",93,34,0,127,"2013","117"
"8985","PONTE NOSSA",0,28,0,28,"2013","168"
"8986","PONTE SAN NICOLO'",196,35,32,263,"2013","069"
"8987","PONTE SAN PIETRO",5,0,0,5,"2013","170"
"8988","PONTECCHIO POLESINE",791,0,0,791,"2013","038"
"8989","PONTECHIANALE",219,0,0,219,"2013","172"
"8990","PONTECURONE",2,0,0,2,"2013","132"
"8991","PONTELONGO",437,0,0,437,"2013","068"
"8992","PONTENURE",85,140,0,225,"2013","037"
"8993","PONTERANICA",8,0,0,8,"2013","169"
"8994","PONTESTURA",7,0,0,7,"2013","133"
"8995","PONTEVICO",330,2715,200,3245,"2013","149"
"8996","PONTI",104,0,9,113,"2013","134"
"8997","PONTI SUL MINCIO",231,367,34,632,"2013","044"
"8998","PONTIDA",32,0,0,32,"2013","171"
"8999","PONTIROLO NUOVO",372,523,0,895,"2013","172"
"9000","PONTOGLIO",827,1075,0,1902,"2013","150"
"9001","PONZANO MONFERRATO",33,0,0,33,"2013","135"
"9002","PONZANO VENETO",452,200,2,654,"2013","059"
"9003","PONZONE",42,8,0,50,"2013","136"
"9004","PORLEZZA",18,63,22,103,"2013","189"
"9005","PORRETTA TERME",51,0,0,51,"2013","049"
"9006","PORTACOMARO",39,0,0,39,"2013","087"
"9007","PORTALBERA",2,0,0,2,"2013","118"
"9008","PORTE",14,0,0,14,"2013","200"
"9009","PORTICO E SAN BENEDETTO",54,0,0,54,"2013","031"
"9010","PORTO CERESIO",2,0,0,2,"2013","113"
"9011","PORTO MANTOVANO",1131,844,2068,4043,"2013","045"
"9012","PORTO TOLLE",67,0,0,67,"2013","039"
"9013","PORTO VALTRAVAGLIA",2,0,8,10,"2013","114"
"9014","PORTO VIRO",3861,0,0,3861,"2013","052"
"9015","PORTOBUFFOLE'",4,0,37,41,"2013","060"
"9016","PORTOGRUARO",1073,276,5,1354,"2013","029"
"9017","PORTOMAGGIORE",438,429,0,867,"2013","019"
"9018","PORTULA",10,0,0,10,"2013","048"
"9019","POSINA",2,13,0,15,"2013","080"
"9020","POSSAGNO",16,12,0,28,"2013","061"
"9021","POSTALESIO",1,0,3,4,"2013","053"
"9022","POSTUA",5,3,0,8,"2013","102"
"9023","POVE DEL GRAPPA",13,58,0,71,"2013","081"
"9024","POVEGLIANO",73,186,76,335,"2013","062"
"9025","POVEGLIANO VERONESE",2427,651,0,3078,"2013","060"
"9026","POVIGLIO",26,1074,0,1100,"2013","029"
"9027","POZZAGLIO ED UNITI",22,2538,0,2560,"2013","077"
"9028","POZZO D'ADDA",197,0,0,197,"2013","177"
"9029","POZZOL GROPPO",35,0,0,35,"2013","137"
"9030","POZZOLENGO",806,673,39,1518,"2013","151"
"9031","POZZOLEONE",423,1677,11,2111,"2013","082"
"9032","POZZOLO FORMIGARO",11,0,70,81,"2013","138"
"9033","POZZONOVO",1337,0,0,1337,"2013","070"
"9034","POZZUOLO MARTESANA",35,910,0,945,"2013","178"
"9035","PRADALUNGA",19,0,0,19,"2013","173"
"9036","PRADLEVES",2,4,0,6,"2013","173"
"9037","PRAGELATO",21,0,3,24,"2013","201"
"9038","PRALBOINO",1577,902,0,2479,"2013","152"
"9039","PRALI",40,0,0,40,"2013","202"
"9040","PRALORMO",1318,267,0,1585,"2013","203"
"9041","PRALUNGO",63,0,24,87,"2013","049"
"9042","PRAMAGGIORE",21,55,0,76,"2013","030"
"9043","PRAMOLLO",6,0,0,6,"2013","204"
"9044","PRAROSTINO",25,7,0,32,"2013","205"
"9045","PRASCO",20,0,0,20,"2013","139"
"9046","PRASCORSANO",5,0,0,5,"2013","206"
"9047","PRATA CAMPORTACCIO",32,148,0,180,"2013","054"
"9048","PRATIGLIONE",1,0,0,1,"2013","207"
"9049","PRATO SESIA",0,8,0,8,"2013","122"
"9050","PRAY",56,0,0,56,"2013","050"
"9051","PRAZZO",140,47,11,198,"2013","174"
"9052","PREDAPPIO",131,27,0,158,"2013","032"
"9053","PREDORE",28,0,0,28,"2013","174"
"9054","PREDOSA",109,81,0,190,"2013","140"
"9055","PREGANZIOL",10,201,0,211,"2013","063"
"9056","PREGNANA MILANESE",19,130,0,149,"2013","179"
"9057","PREMANA",16,2,3,21,"2013","069"
"9058","PREMENO",4,0,1,5,"2013","055"
"9059","PREMIA",19,208,0,227,"2013","056"
"9060","PREMILCUORE",342,0,35,377,"2013","033"
"9061","PREMOLO",16,12,0,28,"2013","175"
"9062","PREMOSELLO-CHIOVENDA",20,0,9,29,"2013","057"
"9063","PRESEGLIE",52,0,0,52,"2013","153"
"9064","PRESEZZO",3,0,0,3,"2013",NA
"9065","PRESSANA",3152,119,0,3271,"2013","061"
"9066","PRESTINE",2,71,3,76,"2013","154"
"9067","PREVALLE",103,558,2,663,"2013","155"
"9068","PRIERO",17,0,0,17,"2013","175"
"9069","PRIGNANO SULLA SECCHIA",136,1147,40,1323,"2013","033"
"9070","PRIMALUNA",17,52,6,75,"2013","070"
"9071","PRIOCCA",772,0,0,772,"2013","176"
"9072","PRIOLA",81,0,0,81,"2013","177"
"9073","PROSERPIO",6,3,0,9,"2013","192"
"9074","PROVAGLIO D'ISEO",63,190,5,258,"2013","156"
"9075","PROVAGLIO VAL SABBIA",24,0,3,27,"2013","157"
"9076","PRUNETTO",89,0,0,89,"2013","178"
"9077","PUEGNAGO SUL GARDA",15,99,3,117,"2013","158"
"9078","PUMENENGO",1411,457,181,2049,"2013","177"
"9079","PUOS D'ALPAGO",15,117,0,132,"2013","041"
"9080","PUSIANO",0,0,1,1,"2013","193"
"9081","QUAGLIUZZO",13,0,0,13,"2013","208"
"9082","QUAREGNA",5,0,0,5,"2013","051"
"9083","QUARGNENTO",688,0,0,688,"2013","141"
"9084","QUARNA SOTTO",7,0,0,7,"2013","059"
"9085","QUARONA",18,5,0,23,"2013","107"
"9086","QUARTO D'ALTINO",70,88,0,158,"2013","031"
"9087","QUASSOLO",24,31,0,55,"2013","209"
"9088","QUATTORDIO",594,0,0,594,"2013","142"
"9089","QUATTRO CASTELLA",27,1370,0,1397,"2013","030"
"9090","QUERO",49,53,9,111,"2013","042"
"9091","QUINCINETTO",33,40,0,73,"2013","210"
"9092","QUINGENTOLE",336,73,114,523,"2013","046"
"9093","QUINTANO",0,276,3,279,"2013","078"
"9094","QUINTO DI TREVISO",137,230,40,407,"2013","064"
"9095","QUINTO VERCELLESE",33,0,0,33,"2013","108"
"9096","QUINTO VICENTINO",114,628,71,813,"2013","083"
"9097","QUINZANO D'OGLIO",262,2893,0,3155,"2013","159"
"9098","QUISTELLO",85,1620,766,2471,"2013","047"
"9099","QUITTENGO",3,0,0,3,"2013","052"
"9100","RACCONIGI",1706,2033,94,3833,"2013","179"
"9101","RAMISETO",15,279,6,300,"2013","031"
"9102","RAMPONIO VERNA",11,12,3,26,"2013","194"
"9103","RANCIO VALCUVIA",2,3,0,5,"2013","115"
"9104","RANCO",0,0,36,36,"2013","116"
"9105","RANICA",13,16,0,29,"2013","178"
"9106","RANZANICO",10,14,0,24,"2013","179"
"9107","RASSA",0,31,0,31,"2013","110"
"9108","RAVENNA",1317,1316,0,2633,"2013","014"
"9109","RE",15,0,0,15,"2013","060"
"9110","REANO",25,0,0,25,"2013","211"
"9111","RECOARO TERME",59,105,0,164,"2013","084"
"9112","REDAVALLE",110,0,0,110,"2013","120"
"9113","REDONDESCO",148,300,472,920,"2013","048"
"9114","REFRANCORE",66,0,0,66,"2013","089"
"9115","REFRONTOLO",27,38,0,65,"2013","065"
"9116","REGGIO NELL'EMILIA",43,11000,0,11043,"2013","033"
"9117","REGGIOLO",989,2654,0,3643,"2013","032"
"9118","REMEDELLO",6923,2358,53,9334,"2013","160"
"9119","RENATE",2,0,1,3,"2013",NA
"9120","RESANA",2762,53,20,2835,"2013","066"
"9121","RESCALDINA",1,0,0,1,"2013",NA
"9122","REVELLO",5176,1785,0,6961,"2013","180"
"9123","REVERE",1,130,2,133,"2013","049"
"9124","REVIGLIASCO D'ASTI",270,0,0,270,"2013","090"
"9125","REVINE LAGO",9,14,0,23,"2013","067"
"9126","REZZAGO",1,0,0,1,"2013",NA
"9127","REZZATO",380,579,0,959,"2013","161"
"9128","RHO",3,387,0,390,"2013","182"
"9129","RIBORDONE",10,0,0,10,"2013","212"
"9130","RICCIONE",4,0,0,4,"2013","013"
"9131","RICENGO",39,1948,0,1987,"2013","079"
"9132","RIESE PIO X",7696,420,38,8154,"2013","068"
"9133","RIFREDDO",1110,86,0,1196,"2013","181"
"9134","RIMA SAN GIUSEPPE",5,0,0,5,"2013","111"
"9135","RIMASCO",0,7,0,7,"2013","112"
"9136","RIMELLA",3,22,0,25,"2013","113"
"9137","RIMINI",108,95,0,203,"2013","014"
"9138","RIO SALICETO",950,503,0,1453,"2013","034"
"9139","RIOLO TERME",317,0,0,317,"2013","015"
"9140","RIOLUNATO",54,23,0,77,"2013","035"
"9141","RIPALTA ARPINA",72,293,0,365,"2013","080"
"9142","RIPALTA CREMASCA",3,219,0,222,"2013","081"
"9143","RIPALTA GUERINA",1,466,0,467,"2013","082"
"9144","RIVA DI SOLTO",10,0,0,10,"2013","180"
"9145","RIVA PRESSO CHIERI",3413,66,55,3534,"2013","215"
"9146","RIVA VALDOBBIA",14,20,5,39,"2013","114"
"9147","RIVALBA",115,0,0,115,"2013","213"
"9148","RIVALTA DI TORINO",159,4,0,163,"2013","214"
"9149","RIVAMONTE AGORDINO",0,36,0,36,"2013","043"
"9150","RIVANAZZANO",171,0,0,171,"2013","122"
"9151","RIVARA",63,145,0,208,"2013","216"
"9152","RIVAROLO CANAVESE",1073,673,0,1746,"2013","217"
"9153","RIVAROLO DEL RE ED UNITI",3459,341,0,3800,"2013","083"
"9154","RIVAROLO MANTOVANO",86,1103,44,1233,"2013","050"
"9155","RIVAROSSA",6,149,0,155,"2013","218"
"9156","RIVERGARO",98,545,0,643,"2013","038"
"9157","RIVOLI",1661,0,84,1745,"2013","219"
"9158","RIVOLI VERONESE",168,13,0,181,"2013","062"
"9159","RIVOLTA D'ADDA",2046,2806,1,4853,"2013","084"
"9160","RO",13,42,0,55,"2013","020"
"9161","ROANA",50,464,0,514,"2013","085"
"9162","ROASCIO",26,0,0,26,"2013","184"
"9163","ROASIO",24,0,0,24,"2013","116"
"9164","ROATTO",110,0,0,110,"2013","091"
"9165","ROBASSOMERO",31,71,0,102,"2013","220"
"9166","ROBBIO",5,237,0,242,"2013","123"
"9167","ROBECCHETTO CON INDUNO",185,169,0,354,"2013","183"
"9168","ROBECCO D'OGLIO",4,3106,0,3110,"2013","085"
"9169","ROBECCO PAVESE",38,0,0,38,"2013","124"
"9170","ROBECCO SUL NAVIGLIO",93,644,2,739,"2013","184"
"9171","ROBELLA",376,0,0,376,"2013","092"
"9172","ROBILANTE",143,0,0,143,"2013","185"
"9173","ROBURENT",18,0,0,18,"2013","186"
"9174","ROCCA CANAVESE",51,0,0,51,"2013","221"
"9175","ROCCA CIGLIE'",43,0,0,43,"2013","188"
"9176","ROCCA D'ARAZZO",401,0,0,401,"2013","093"
"9177","ROCCA DE' BALDI",2648,1299,264,4211,"2013","189"
"9178","ROCCA DE' GIORGI",2,0,0,2,"2013","125"
"9179","ROCCA GRIMALDA",12,0,0,12,"2013","147"
"9180","ROCCA PIETORE",0,2,0,2,"2013","044"
"9181","ROCCA SAN CASCIANO",136,0,0,136,"2013","036"
"9182","ROCCABIANCA",0,862,0,862,"2013","030"
"9183","ROCCABRUNA",121,0,46,167,"2013","187"
"9184","ROCCAFORTE LIGURE",34,0,0,34,"2013","146"
"9185","ROCCAFORTE MONDOVI'",1104,12,0,1116,"2013","190"
"9186","ROCCAFRANCA",1577,1192,48,2817,"2013","162"
"9187","ROCCASPARVERA",125,0,0,125,"2013","191"
"9188","ROCCAVERANO",230,0,0,230,"2013","094"
"9189","ROCCAVIONE",39,0,0,39,"2013","192"
"9190","ROCCHETTA LIGURE",26,0,0,26,"2013","148"
"9191","ROCCHETTA PALAFEA",8,0,0,8,"2013","095"
"9192","ROCCHETTA TANARO",331,0,0,331,"2013","096"
"9193","RODANO",30,150,0,180,"2013","185"
"9194","RODDI",85,24,0,109,"2013","194"
"9195","RODDINO",94,0,0,94,"2013","195"
"9196","RODELLO",100,0,0,100,"2013","196"
"9197","RODENGO-SAIANO",135,202,45,382,"2013","163"
"9198","RODERO",10,4,3,17,"2013",NA
"9199","RODIGO",901,1035,1051,2987,"2013","051"
"9200","ROE' VOLCIANO",13,0,0,13,"2013","164"
"9201","ROGENO",185,212,0,397,"2013","072"
"9202","ROGNANO",9,0,0,9,"2013","127"
"9203","ROGNO",14,95,0,109,"2013","182"
"9204","ROGOLO",5,0,0,5,"2013","056"
"9205","ROLETTO",210,87,0,297,"2013","222"
"9206","ROLO",0,230,0,230,"2013","035"
"9207","ROMAGNANO SESIA",34,0,0,34,"2013","130"
"9208","ROMAGNESE",136,0,0,136,"2013","128"
"9209","ROMANENGO",0,1849,0,1849,"2013","086"
"9210","ROMANO CANAVESE",37,0,0,37,"2013","223"
"9211","ROMANO D'EZZELINO",230,486,24,740,"2013","086"
"9212","ROMANO DI LOMBARDIA",248,2943,0,3191,"2013","183"
"9213","ROMENTINO",11,0,0,11,"2013","131"
"9214","RONAGO",2,49,0,51,"2013","199"
"9215","RONCA'",7,3,0,10,"2013","063"
"9216","RONCADE",2453,133,0,2586,"2013","069"
"9217","RONCADELLE",330,617,0,947,"2013","165"
"9218","RONCARO",2,0,0,2,"2013","129"
"9219","RONCELLO",1,0,0,1,"2013",NA
"9220","RONCO ALL'ADIGE",6891,12,0,6903,"2013","064"
"9221","RONCO BIELLESE",6,71,0,77,"2013","053"
"9222","RONCO BRIANTINO",0,124,0,124,"2013",NA
"9223","RONCO CANAVESE",62,0,0,62,"2013","224"
"9224","RONCOFERRARO",2632,408,671,3711,"2013","052"
"9225","RONCOFREDDO",25,61,0,86,"2013","037"
"9226","RONCOLA",39,25,0,64,"2013","185"
"9227","RONDISSONE",12,0,0,12,"2013","225"
"9228","RONSECCO",6,0,0,6,"2013",NA
"9229","ROPPOLO",9,0,0,9,"2013","054"
"9230","RORA'",30,0,0,30,"2013","226"
"9231","ROSA'",151,930,0,1081,"2013","087"
"9232","ROSASCO",2,0,0,2,"2013","130"
"9233","ROSATE",3198,513,0,3711,"2013","188"
"9234","ROSIGNANO MONFERRATO",98,0,0,98,"2013","149"
"9235","ROSOLINA",6,0,0,6,"2013","040"
"9236","ROSSA",3,12,0,15,"2013","121"
"9237","ROSSANA",71,51,0,122,"2013","197"
"9238","ROSSANO VENETO",307,216,17,540,"2013","088"
"9239","ROSTA",5,0,88,93,"2013","228"
"9240","ROTA D'IMAGNA",19,33,0,52,"2013","186"
"9241","ROTTOFRENO",338,622,0,960,"2013","039"
"9242","ROTZO",95,0,0,95,"2013","089"
"9243","ROURE",15,0,0,15,"2013","227"
"9244","ROVAGNATE",19,0,6,25,"2013","073"
"9245","ROVASENDA",4,0,0,4,"2013","122"
"9246","ROVATO",1791,1907,0,3698,"2013","166"
"9247","ROVELLASCA",16,73,0,89,"2013","201"
"9248","ROVELLO PORRO",1,0,0,1,"2013",NA
"9249","ROVERBELLA",12524,549,402,13475,"2013","053"
"9250","ROVERCHIARA",4622,61,0,4683,"2013","065"
"9251","ROVERE' VERONESE",214,1278,0,1492,"2013","067"
"9252","ROVEREDO DI GUA'",1514,84,0,1598,"2013","066"
"9253","ROVESCALA",12,0,0,12,"2013","131"
"9254","ROVETTA",33,133,0,166,"2013","187"
"9255","ROVIGO",1282,0,0,1282,"2013","041"
"9256","ROVOLON",189,133,62,384,"2013","071"
"9257","ROZZANO",0,2,0,2,"2013","189"
"9258","RUBANO",57,51,46,154,"2013","072"
"9259","RUBIANA",4,0,0,4,"2013","229"
"9260","RUBIERA",0,570,0,570,"2013","036"
"9261","RUDIANO",462,1069,5,1536,"2013","167"
"9262","RUEGLIO",94,88,0,182,"2013","230"
"9263","RUFFIA",245,332,0,577,"2013","198"
"9264","RUINO",129,0,0,129,"2013","132"
"9265","RUSSI",6,101,0,107,"2013","016"
"9266","SABBIO CHIESE",21,25,0,46,"2013","168"
"9267","SABBIONETA",6,127,27,160,"2013","054"
"9268","SACCOLONGO",66,449,78,593,"2013","073"
"9269","SAGLIANO MICCA",51,0,0,51,"2013","056"
"9270","SALA BAGANZA",13,80,0,93,"2013","031"
"9271","SALA BIELLESE",2,0,0,2,"2013","057"
"9272","SALA BOLOGNESE",273,112,0,385,"2013","050"
"9273","SALA COMACINA",0,0,1,1,"2013","203"
"9274","SALARA",2,0,0,2,"2013","042"
"9275","SALASSA",12,0,0,12,"2013","231"
"9276","SALBERTRAND",32,0,0,32,"2013","232"
"9277","SALCEDO",822,65,2,889,"2013","090"
"9278","SALE",41,0,0,41,"2013","151"
"9279","SALE DELLE LANGHE",52,0,0,52,"2013","199"
"9280","SALE MARASINO",68,31,0,99,"2013","169"
"9281","SALE SAN GIOVANNI",34,0,0,34,"2013","200"
"9282","SALERANO SUL LAMBRO",4,174,0,178,"2013","046"
"9283","SALETTO",11,39,0,50,"2013","074"
"9284","SALGAREDA",2044,329,18,2391,"2013","070"
"9285","SALICETO",75,0,0,75,"2013","201"
"9286","SALIZZOLE",1861,623,0,2484,"2013","068"
"9287","SALMOUR",213,0,0,213,"2013","202"
"9288","SALO'",0,48,0,48,"2013","170"
"9289","SALSOMAGGIORE TERME",28,1194,18,1240,"2013","032"
"9290","SALTRIO",37,0,0,37,"2013","117"
"9291","SALUDECIO",101,45,0,146,"2013","015"
"9292","SALUGGIA",455,190,0,645,"2013","128"
"9293","SALUSSOLA",382,93,0,475,"2013","058"
"9294","SALUZZO",3175,3706,0,6881,"2013","203"
"9295","SALVIROLA",654,139,0,793,"2013","087"
"9296","SALZANO",155,27,2,184,"2013","032"
"9297","SAMARATE",21,0,0,21,"2013","118"
"9298","SAMBUCO",11,0,0,11,"2013","204"
"9299","SAMOLACO",155,705,15,875,"2013","057"
"9300","SAMONE",16,0,0,16,"2013","235"
"9301","SAMPEYRE",235,42,0,277,"2013","205"
"9302","SAN BARTOLOMEO VAL CAVARGNA",7,0,8,15,"2013","204"
"9303","SAN BASSANO",8,1672,0,1680,"2013","088"
"9304","SAN BELLINO",1891,0,0,1891,"2013","043"
"9305","SAN BENEDETTO BELBO",29,64,0,93,"2013","206"
"9306","SAN BENEDETTO PO",466,1633,1233,3332,"2013","055"
"9307","SAN BENEDETTO VAL DI SAMBRO",197,151,0,348,"2013","051"
"9308","SAN BENIGNO CANAVESE",273,0,33,306,"2013","236"
"9309","SAN BERNARDINO VERBANO",8,0,0,8,"2013","061"
"9310","SAN BIAGIO DI CALLALTA",255,79,0,334,"2013","071"
"9311","SAN BONIFACIO",2442,0,0,2442,"2013","069"
"9312","SAN CARLO CANAVESE",213,315,0,528,"2013","237"
"9313","SAN CESARIO SUL PANARO",19,971,0,990,"2013","036"
"9314","SAN CIPRIANO PO",62,0,0,62,"2013","133"
"9315","SAN CLEMENTE",24,0,0,24,"2013","016"
"9316","SAN COLOMBANO AL LAMBRO",24,290,0,314,"2013","191"
"9317","SAN COLOMBANO BELMONTE",5,20,0,25,"2013","238"
"9318","SAN CRISTOFORO",10,0,0,10,"2013","152"
"9319","SAN DAMIANO D'ASTI",4273,0,0,4273,"2013","097"
"9320","SAN DAMIANO MACRA",42,0,0,42,"2013","207"
"9321","SAN DANIELE PO",33,1421,0,1454,"2013","089"
"9322","SAN DIDERO",0,17,0,17,"2013","239"
"9323","SAN DONA' DI PIAVE",318,432,10,760,"2013","033"
"9324","SAN DONATO MILANESE",3,0,0,3,"2013","192"
"9325","SAN FEDELE INTELVI",29,22,8,59,"2013","205"
"9326","SAN FELICE DEL BENACO",4,0,0,4,"2013","171"
"9327","SAN FELICE SUL PANARO",6,664,0,670,"2013","037"
"9328","SAN FERMO DELLA BATTAGLIA",8,0,17,25,"2013","206"
"9329","SAN FIOR",37,55,0,92,"2013","072"
"9330","SAN FIORANO",0,120,0,120,"2013","047"
"9331","SAN FRANCESCO AL CAMPO",473,381,0,854,"2013","240"
"9332","SAN GENESIO ED UNITI",2,431,0,433,"2013","135"
"9333","SAN GERMANO CHISONE",49,30,0,79,"2013","242"
"9334","SAN GERMANO DEI BERICI",246,271,0,517,"2013","092"
"9335","SAN GERMANO VERCELLESE",19,0,0,19,"2013","131"
"9336","SAN GERVASIO BRESCIANO",0,249,0,249,"2013","172"
"9337","SAN GIACOMO DELLE SEGNATE",189,172,219,580,"2013","056"
"9338","SAN GIACOMO FILIPPO",1,0,0,1,"2013","058"
"9339","SAN GIACOMO VERCELLESE",1889,0,0,1889,"2013","035"
"9340","SAN GILLIO",147,57,0,204,"2013","243"
"9341","SAN GIORGIO CANAVESE",298,59,0,357,"2013","244"
"9342","SAN GIORGIO DELLE PERTICHE",309,147,2,458,"2013","075"
"9343","SAN GIORGIO DI LOMELLINA",7,0,0,7,"2013","136"
"9344","SAN GIORGIO DI MANTOVA",412,138,35,585,"2013","057"
"9345","SAN GIORGIO DI PIANO",20,0,0,20,"2013","052"
"9346","SAN GIORGIO IN BOSCO",322,1075,0,1397,"2013","076"
"9347","SAN GIORGIO MONFERRATO",11,0,0,11,"2013","153"
"9348","SAN GIORGIO PIACENTINO",233,756,0,989,"2013","040"
"9349","SAN GIORGIO SCARAMPI",103,0,0,103,"2013","098"
"9350","SAN GIORIO DI SUSA",6,28,0,34,"2013","245"
"9351","SAN GIOVANNI BIANCO",39,37,0,76,"2013","188"
"9352","SAN GIOVANNI DEL DOSSO",0,299,79,378,"2013","058"
"9353","SAN GIOVANNI ILARIONE",717,16,4,737,"2013","070"
"9354","SAN GIOVANNI IN CROCE",0,426,5,431,"2013","090"
"9355","SAN GIOVANNI IN MARIGNANO",13,0,0,13,"2013","017"
"9356","SAN GIOVANNI IN PERSICETO",161,812,0,973,"2013","053"
"9357","SAN GIOVANNI LUPATOTO",517,20,0,537,"2013","071"
"9358","SAN GIULIANO MILANESE",6,506,0,512,"2013","195"
"9359","SAN GIUSTO CANAVESE",99,28,0,127,"2013","246"
"9360","SAN GREGORIO NELLE ALPI",26,75,0,101,"2013","045"
"9361","SAN LAZZARO DI SAVENA",27,10,0,37,"2013","054"
"9362","SAN LEO",227,303,1,531,"2013","025"
"9363","SAN MARTINO ALFIERI",15,0,0,15,"2013","099"
"9364","SAN MARTINO BUON ALBERGO",414,989,0,1403,"2013","073"
"9365","SAN MARTINO CANAVESE",36,0,0,36,"2013","247"
"9366","SAN MARTINO DALL'ARGINE",277,832,44,1153,"2013","059"
"9367","SAN MARTINO DEL LAGO",20,0,0,20,"2013","091"
"9368","SAN MARTINO DI LUPARI",2396,333,78,2807,"2013","077"
"9369","SAN MARTINO DI VENEZZE",3,0,0,3,"2013","044"
"9370","SAN MARTINO IN RIO",1,902,0,903,"2013","037"
"9371","SAN MARTINO IN STRADA",295,701,0,996,"2013","048"
"9372","SAN MARTINO SICCOMARIO",1,3,0,4,"2013","137"
"9373","SAN MARZANO OLIVETO",45,0,0,45,"2013","100"
"9374","SAN MAURIZIO CANAVESE",128,560,14,702,"2013","248"
"9375","SAN MAURIZIO D'OPAGLIO",18,0,0,18,"2013","133"
"9376","SAN MAURO DI SALINE",72,286,28,386,"2013","074"
"9377","SAN MAURO PASCOLI",1,0,0,1,"2013","041"
"9378","SAN MAURO TORINESE",20,0,0,20,"2013","249"
"9379","SAN MICHELE AL TAGLIAMENTO",2111,31,0,2142,"2013","034"
"9380","SAN MICHELE MONDOVI'",149,0,0,149,"2013","210"
"9381","SAN NAZARIO",15,0,0,15,"2013","093"
"9382","SAN NAZZARO SESIA",97,0,0,97,"2013","134"
"9383","SAN NAZZARO VAL CAVARGNA",9,0,4,13,"2013","207"
"9384","SAN PAOLO",354,2019,20,2393,"2013","138"
"9385","SAN PAOLO CERVO",3,0,0,3,"2013","060"
"9386","SAN PAOLO D'ARGON",29,32,0,61,"2013","189"
"9387","SAN PAOLO SOLBRITO",13,0,0,13,"2013","101"
"9388","SAN PELLEGRINO TERME",40,37,0,77,"2013","190"
"9389","SAN PIETRO DI CADORE",10,42,0,52,"2013","047"
"9390","SAN PIETRO DI FELETTO",25,25,0,50,"2013","073"
"9391","SAN PIETRO IN CASALE",35,167,0,202,"2013","055"
"9392","SAN PIETRO IN CERRO",9,746,0,755,"2013","041"
"9393","SAN PIETRO IN GU",709,3317,0,4026,"2013","078"
"9394","SAN PIETRO MOSEZZO",12,0,0,12,"2013","135"
"9395","SAN PIETRO MUSSOLINO",11,0,0,11,"2013","094"
"9396","SAN PIETRO VAL LEMINA",2,0,0,2,"2013","250"
"9397","SAN PIETRO VIMINARIO",374,248,0,622,"2013","079"
"9398","SAN POLO D'ENZA",12,788,0,800,"2013","038"
"9399","SAN POLO DI PIAVE",792,95,0,887,"2013","074"
"9400","SAN PONSO",2,49,0,51,"2013","251"
"9401","SAN POSSIDONIO",555,346,0,901,"2013","038"
"9402","SAN PROSPERO",3,517,0,520,"2013","039"
"9403","SAN RAFFAELE CIMENA",43,0,0,43,"2013","252"
"9404","SAN ROCCO AL PORTO",310,277,0,587,"2013","049"
"9405","SAN SALVATORE MONFERRATO",145,0,0,145,"2013","154"
"9406","SAN SEBASTIANO CURONE",13,0,0,13,"2013","155"
"9407","SAN SEBASTIANO DA PO",264,0,0,264,"2013","253"
"9408","SAN SECONDO DI PINEROLO",439,69,69,577,"2013","254"
"9409","SAN SECONDO PARMENSE",9,1564,0,1573,"2013","033"
"9410","SAN SIRO",1,0,11,12,"2013","248"
"9411","SAN VENDEMIANO",76,180,2,258,"2013","076"
"9412","SAN VITO DI LEGUZZANO",431,122,0,553,"2013","096"
"9413","SAN VITTORE OLONA",33,28,0,61,"2013","201"
"9414","SAN ZENO DI MONTAGNA",121,280,59,460,"2013","079"
"9415","SAN ZENO NAVIGLIO",5,558,0,563,"2013","173"
"9416","SAN ZENONE AL LAMBRO",0,828,0,828,"2013","202"
"9417","SAN ZENONE DEGLI EZZELINI",2032,572,2,2606,"2013","077"
"9418","SANDIGLIANO",50,61,0,111,"2013","059"
"9419","SANDRIGO",814,1363,0,2177,"2013","091"
"9420","SANFRE'",737,71,0,808,"2013","208"
"9421","SANFRONT",2511,231,0,2742,"2013","209"
"9422","SANGANO",114,0,28,142,"2013","241"
"9423","SANGIANO",2,37,0,39,"2013","141"
"9424","SANGUINETTO",1,147,0,148,"2013","072"
"9425","SANNAZZARO DE' BURGONDI",3,49,0,52,"2013","138"
"9426","SANT'AGATA BOLOGNESE",11,585,0,596,"2013","056"
"9427","SANT'AGATA FELTRIA",139,26,4,169,"2013","026"
"9428","SANT'AGATA FOSSILI",48,0,0,48,"2013","156"
"9429","SANT'AGATA SUL SANTERNO",29,0,0,29,"2013","017"
"9430","SANT'ALBANO STURA",3998,630,243,4871,"2013","211"
"9431","SANT'ALESSIO CON VIALONE",1,0,0,1,"2013","141"
"9432","SANT'AMBROGIO DI TORINO",49,12,17,78,"2013","255"
"9433","SANT'AMBROGIO DI VALPOLICELLA",7,54,0,61,"2013","077"
"9434","SANT'ANGELO DI PIOVE DI SACCO",316,42,0,358,"2013","082"
"9435","SANT'ANGELO LODIGIANO",46,331,0,377,"2013","050"
"9436","SANT'ANGELO LOMELLINA",0,245,0,245,"2013","144"
"9437","SANT'ANNA D'ALFAEDO",213,1321,20,1554,"2013","078"
"9438","SANT'ANTONINO DI SUSA",14,42,38,94,"2013","256"
"9439","SANT'ELENA",55,0,0,55,"2013","083"
"9440","SANT'ILARIO D'ENZA",2,675,0,677,"2013","039"
"9441","SANT'OMOBONO TERME",44,49,0,93,"2013","192"
"9442","SANT'URBANO",880,0,2,882,"2013","084"
"9443","SANTA BRIGIDA",4,39,0,43,"2013","191"
"9444","SANTA CRISTINA E BISSONE",41,176,35,252,"2013","139"
"9445","SANTA GIULETTA",18,0,0,18,"2013","140"
"9446","SANTA GIUSTINA",174,111,0,285,"2013","048"
"9447","SANTA GIUSTINA IN COLLE",1030,427,0,1457,"2013","080"
"9448","SANTA LUCIA DI PIAVE",66,93,0,159,"2013","075"
"9449","SANTA MARGHERITA D'ADIGE",646,36,0,682,"2013","081"
"9450","SANTA MARGHERITA DI STAFFORA",64,0,0,64,"2013","142"
"9451","SANTA MARIA DELLA VERSA",3,0,0,3,"2013","143"
"9452","SANTA MARIA DI SALA",97,156,12,265,"2013","035"
"9453","SANTA MARIA HOE'",7,0,0,7,"2013","074"
"9454","SANTA MARIA MAGGIORE",46,0,18,64,"2013","062"
"9455","SANTA SOFIA",210,1,3,214,"2013","043"
"9456","SANTA VITTORIA D'ALBA",68,0,0,68,"2013","212"
"9457","SANTARCANGELO DI ROMAGNA",20,0,0,20,"2013","018"
"9458","SANTENA",543,0,0,543,"2013","257"
"9459","SANTHIA'",224,105,0,329,"2013","133"
"9460","SANTO STEFANO BELBO",15,0,0,15,"2013","213"
"9461","SANTO STEFANO DI CADORE",0,28,0,28,"2013","050"
"9462","SANTO STEFANO LODIGIANO",21,306,1,328,"2013","051"
"9463","SANTO STEFANO ROERO",106,0,0,106,"2013","214"
"9464","SANTO STEFANO TICINO",0,51,0,51,"2013","200"
"9465","SANTO STINO DI LIVENZA",3127,87,0,3214,"2013","036"
"9466","SANTORSO",305,216,0,521,"2013","095"
"9467","SAONARA",217,7,3,227,"2013","085"
"9468","SAPPADA",0,75,0,75,"2013","052"
"9469","SARCEDO",1562,369,0,1931,"2013","097"
"9470","SARDIGLIANO",2,0,0,2,"2013","157"
"9471","SAREGO",380,28,0,408,"2013","098"
"9472","SAREZZO",14,23,0,37,"2013","174"
"9473","SARMATO",9,188,0,197,"2013","042"
"9474","SARMEDE",70,90,0,160,"2013","078"
"9475","SARNICO",10,0,0,10,"2013","193"
"9476","SARONNO",1,0,0,1,"2013","119"
"9477","SARSINA",117,21,0,138,"2013","044"
"9478","SARTIRANA LOMELLINA",1,0,0,1,"2013","146"
"9479","SASSO MARCONI",39,5,0,44,"2013","057"
"9480","SASSUOLO",41,466,0,507,"2013","040"
"9481","SAUZE DI CESANA",12,0,0,12,"2013","258"
"9482","SAVIGLIANO",9043,4809,211,14063,"2013","215"
"9483","SAVIGNANO SUL PANARO",69,105,0,174,"2013","041"
"9484","SAVIGNANO SUL RUBICONE",86,0,0,86,"2013","045"
"9485","SAVIGNO",29,454,0,483,"2013","058"
"9486","SAVIORE DELL'ADAMELLO",3,40,2,45,"2013","175"
"9487","SCAGNELLO",149,0,0,149,"2013","216"
"9488","SCALDASOLE",0,89,0,89,"2013","147"
"9489","SCALENGHE",1282,1926,464,3672,"2013","260"
"9490","SCANDIANO",42,1620,4,1666,"2013","040"
"9491","SCANDOLARA RAVARA",0,633,0,633,"2013","092"
"9492","SCANDOLARA RIPA D'OGLIO",14,793,89,896,"2013","093"
"9493","SCANZOROSCIATE",50,10,0,60,"2013","194"
"9494","SCARMAGNO",9,0,0,9,"2013","261"
"9495","SCARNAFIGI",1297,1794,0,3091,"2013","217"
"9496","SCHIAVON",1966,1779,6,3751,"2013","099"
"9497","SCHIGNANO",0,3,12,15,"2013","211"
"9498","SCHILPARIO",1,45,0,46,"2013","195"
"9499","SCHIO",349,290,11,650,"2013","100"
"9500","SCHIVENOGLIA",0,19,0,19,"2013","060"
"9501","SCIOLZE",119,0,0,119,"2013","262"
"9502","SCOPA",2,10,0,12,"2013","134"
"9503","SCOPELLO",3,7,0,10,"2013","135"
"9504","SCORZE'",3370,107,1,3478,"2013","037"
"9505","SECUGNAGO",13,1158,0,1171,"2013","052"
"9506","SEDICO",1039,124,0,1163,"2013","053"
"9507","SEDRIANO",17,614,0,631,"2013","204"
"9508","SEDRINA",20,13,0,33,"2013","196"
"9509","SEGRATE",9,0,0,9,"2013","205"
"9510","SEGUSINO",6,87,0,93,"2013","079"
"9511","SELLERO",7,25,1,33,"2013","176"
"9512","SELVA DI CADORE",0,7,0,7,"2013","054"
"9513","SELVA DI PROGNO",62,669,63,794,"2013","080"
"9514","SELVAZZANO DENTRO",13,0,69,82,"2013","086"
"9515","SELVINO",6,0,0,6,"2013","197"
"9516","SEMIANA",3,0,0,3,"2013","148"
"9517","SENAGO",1,0,0,1,"2013",NA
"9518","SENIGA",2047,1691,0,3738,"2013","177"
"9519","SENNA COMASCO",27,188,19,234,"2013","212"
"9520","SENNA LODIGIANA",10,930,0,940,"2013","053"
"9521","SEREGNO",13,0,0,13,"2013",NA
"9522","SEREN DEL GRAPPA",69,59,166,294,"2013","055"
"9523","SERGNANO",4,1424,0,1428,"2013","094"
"9524","SERIATE",894,77,0,971,"2013","198"
"9525","SERINA",23,81,0,104,"2013","199"
"9526","SERLE",40,52,0,92,"2013","178"
"9527","SERMIDE",0,238,171,409,"2013","061"
"9528","SERNAGLIA DELLA BATTAGLIA",447,31,9,487,"2013","080"
"9529","SERNIO",4,0,0,4,"2013","059"
"9530","SEROLE",93,0,0,93,"2013","104"
"9531","SERRALUNGA D'ALBA",23,0,0,23,"2013","218"
"9532","SERRALUNGA DI CREA",11,0,0,11,"2013","159"
"9533","SERRAMAZZONI",47,1681,0,1728,"2013","042"
"9534","SERRAVALLE A PO",54,29,178,261,"2013","062"
"9535","SERRAVALLE LANGHE",170,0,0,170,"2013","219"
"9536","SERRAVALLE SCRIVIA",7,0,1,8,"2013","160"
"9537","SERRAVALLE SESIA",3,0,0,3,"2013","137"
"9538","SESTO CALENDE",37,0,0,37,"2013","120"
"9539","SESTO ED UNITI",1,1255,383,1639,"2013","095"
"9540","SESTOLA",74,404,14,492,"2013","043"
"9541","SETTALA",51,202,0,253,"2013","210"
"9542","SETTIME",220,0,0,220,"2013","106"
"9543","SETTIMO MILANESE",69,390,0,459,"2013","211"
"9544","SETTIMO ROTTARO",4,51,0,55,"2013","264"
"9545","SETTIMO TORINESE",425,222,165,812,"2013","265"
"9546","SETTIMO VITTONE",176,204,0,380,"2013","266"
"9547","SEVESO",4,0,0,4,"2013",NA
"9548","SEZZADIO",54,0,0,54,"2013","161"
"9549","SILEA",6,106,4,116,"2013","081"
"9550","SILLAVENGO",21,104,0,125,"2013","138"
"9551","SILVANO D'ORBA",7,0,0,7,"2013","162"
"9552","SINIO",15,3,0,18,"2013","220"
"9553","SIRONE",16,85,1,102,"2013","075"
"9554","SIRTORI",8,0,0,8,"2013","076"
"9555","SISSA",3,412,0,415,"2013","034"
"9556","SIZIANO",60,73,0,133,"2013","150"
"9557","SIZZANO",207,19,148,374,"2013","139"
"9558","SOAVE",126,0,0,126,"2013","081"
"9559","SOGLIANO AL RUBICONE",263,64,0,327,"2013","046"
"9560","SOIANO DEL LAGO",11,0,0,11,"2013","180"
"9561","SOLAGNA",0,17,0,17,"2013","101"
"9562","SOLARO",0,7,0,7,"2013","213"
"9563","SOLAROLO",3,0,0,3,"2013","018"
"9564","SOLAROLO RAINERIO",25,263,0,288,"2013","096"
"9565","SOLBIATE",6,43,61,110,"2013","215"
"9566","SOLERO",323,0,0,323,"2013","163"
"9567","SOLESINO",12,0,0,12,"2013","087"
"9568","SOLFERINO",620,177,204,1001,"2013","063"
"9569","SOLIERA",21,888,0,909,"2013","044"
"9570","SOLIGNANO",13,336,0,349,"2013","035"
"9571","SOLONGHELLO",104,0,0,104,"2013","164"
"9572","SOLTO COLLINA",25,0,0,25,"2013","200"
"9573","SOMAGLIA",13,1125,0,1138,"2013","054"
"9574","SOMANO",46,0,0,46,"2013","221"
"9575","SOMMA LOMBARDO",24,10,0,34,"2013","123"
"9576","SOMMACAMPAGNA",1937,424,93,2454,"2013","082"
"9577","SOMMARIVA DEL BOSCO",1883,663,4,2550,"2013","222"
"9578","SOMMARIVA PERNO",48,0,0,48,"2013","223"
"9579","SOMMO",40,0,0,40,"2013","151"
"9580","SONA",2831,639,1,3471,"2013","083"
"9581","SONCINO",706,4839,43,5588,"2013","097"
"9582","SONDALO",41,114,9,164,"2013","060"
"9583","SONDRIO",9,31,0,40,"2013","061"
"9584","SONGAVAZZO",2,0,0,2,"2013","201"
"9585","SONICO",4,100,10,114,"2013","181"
"9586","SORAGNA",11,1862,0,1873,"2013","036"
"9587","SORBOLO",1,1446,0,1447,"2013","037"
"9588","SORDEVOLO",123,23,5,151,"2013","063"
"9589","SORDIO",0,232,0,232,"2013","055"
"9590","SORESINA",38,1689,101,1828,"2013","098"
"9591","SORGA'",1737,53,0,1790,"2013","084"
"9592","SORICO",9,13,55,77,"2013","216"
"9593","SORISO",2,0,0,2,"2013","140"
"9594","SORISOLE",64,59,0,123,"2013","202"
"9595","SORMANO",19,0,1,20,"2013","217"
"9596","SOSPIRO",30,445,2,477,"2013","099"
"9597","SOSPIROLO",14,109,0,123,"2013","056"
"9598","SOSSANO",47,446,0,493,"2013","102"
"9599","SOSTEGNO",2,0,0,2,"2013","064"
"9600","SOTTO IL MONTE GIOVANNI XXIII",57,77,0,134,"2013","203"
"9601","SOVERE",68,60,0,128,"2013","204"
"9602","SOVERZENE",2,0,0,2,"2013","057"
"9603","SOVICO",2,0,0,2,"2013",NA
"9604","SOVIZZO",763,23,0,786,"2013","103"
"9605","SOVRAMONTE",22,60,17,99,"2013","058"
"9606","SOZZAGO",9,0,0,9,"2013","141"
"9607","SPARONE",42,50,0,92,"2013","267"
"9608","SPESSA",8,0,0,8,"2013","152"
"9609","SPIGNO MONFERRATO",123,35,71,229,"2013","165"
"9610","SPILAMBERTO",2177,1366,0,3543,"2013","045"
"9611","SPINEA",24,183,0,207,"2013","038"
"9612","SPINEDA",9,702,0,711,"2013","101"
"9613","SPINETO SCRIVIA",144,0,0,144,"2013","166"
"9614","SPINO D'ADDA",737,1932,0,2669,"2013","102"
"9615","SPINONE AL LAGO",10,0,0,10,"2013","205"
"9616","SPIRANO",20,1232,2,1254,"2013","206"
"9617","SPRESIANO",82,257,2,341,"2013","082"
"9618","STAGNO LOMBARDO",7,5710,218,5935,"2013","103"
"9619","STANGHELLA",393,0,0,393,"2013","088"
"9620","STAZZANO",21,0,4,25,"2013","167"
"9621","STAZZONA",13,5,13,31,"2013","218"
"9622","STEZZANO",191,267,181,639,"2013","207"
"9623","STIENTA",138,0,6,144,"2013","045"
"9624","STRA",2,0,3,5,"2013","039"
"9625","STRADELLA",51,41,0,92,"2013","153"
"9626","STRAMBINO",154,0,0,154,"2013","269"
"9627","STRESA",34,0,0,34,"2013","064"
"9628","STREVI",41,0,0,41,"2013","168"
"9629","STRONA",1,0,0,1,"2013","065"
"9630","STROPPO",5,0,0,5,"2013","224"
"9631","STROZZA",5,0,0,5,"2013","208"
"9632","SUARDI",7,0,0,7,"2013","154"
"9633","SUEGLIO",5,0,0,5,"2013","077"
"9634","SUELLO",5,0,5,10,"2013","078"
"9635","SUISIO",3,48,0,51,"2013","209"
"9636","SULBIATE",43,0,0,43,"2013",NA
"9637","SULZANO",34,196,0,230,"2013","182"
"9638","SUMIRAGO",41,69,0,110,"2013","124"
"9639","SUNO",51,374,0,425,"2013","143"
"9640","SUSA",73,44,0,117,"2013","270"
"9641","SUSEGANA",853,96,0,949,"2013","083"
"9642","SUSTINENTE",495,373,301,1169,"2013","064"
"9643","SUZZARA",2463,1715,740,4918,"2013","065"
"9644","TACENO",13,0,5,18,"2013","079"
"9645","TAGLIO DI PO",6732,0,0,6732,"2013","046"
"9646","TAGLIOLO MONFERRATO",59,0,0,59,"2013","169"
"9647","TAIBON AGORDINO",5,27,0,32,"2013","059"
"9648","TAINO",30,111,0,141,"2013","125"
"9649","TALAMELLO",2,0,0,2,"2013","027"
"9650","TALAMONA",14,150,0,164,"2013","063"
"9651","TALEGGIO",77,30,0,107,"2013","210"
"9652","TAMBRE",15,158,0,173,"2013","060"
"9653","TARANTASCA",2645,306,265,3216,"2013","225"
"9654","TARTANO",2,25,0,27,"2013","064"
"9655","TARZO",36,22,0,58,"2013","084"
"9656","TASSAROLO",3,0,0,3,"2013","170"
"9657","TAVAGNASCO",104,6,18,128,"2013","271"
"9658","TAVAZZANO CON VILLAVESCO",210,850,0,1060,"2013","056"
"9659","TAVERNOLA BERGAMASCA",5,16,0,21,"2013","211"
"9660","TAVERNOLE SUL MELLA",22,72,0,94,"2013","183"
"9661","TAVIGLIANO",24,0,0,24,"2013","066"
"9662","TEGLIO",27,241,39,307,"2013","065"
"9663","TELGATE",1612,271,0,1883,"2013","212"
"9664","TEMU'",6,16,0,22,"2013","184"
"9665","TEOLO",21,45,26,92,"2013","089"
"9666","TERDOBBIATE",10,134,0,144,"2013","144"
"9667","TERENZO",90,622,4,716,"2013","038"
"9668","TERNO D'ISOLA",8,46,0,54,"2013","213"
"9669","TERRANOVA DEI PASSERINI",35,675,0,710,"2013","057"
"9670","TERRASSA PADOVANA",1402,0,0,1402,"2013","090"
"9671","TERRAZZO",1,29,0,30,"2013","085"
"9672","TERRUGGIA",23,0,10,33,"2013","171"
"9673","TERZO",79,0,6,85,"2013","172"
"9674","TEZZE SUL BRENTA",90,343,0,433,"2013","104"
"9675","THIENE",260,435,1,696,"2013","105"
"9676","TICENGO",0,411,0,411,"2013","104"
"9677","TIGLIOLE",917,0,0,917,"2013","108"
"9678","TIGNALE",10,0,0,10,"2013","185"
"9679","TIRANO",26,7,5,38,"2013","066"
"9680","TIZZANO VAL PARMA",0,1053,0,1053,"2013","039"
"9681","TOANO",28,1583,11,1622,"2013","041"
"9682","TOCENO",15,10,11,36,"2013","065"
"9683","TOLLEGNO",3,8,0,11,"2013","068"
"9684","TOMBOLO",1135,67,0,1202,"2013","091"
"9685","TONCO",512,0,0,512,"2013","109"
"9686","TONENGO",96,0,0,96,"2013","110"
"9687","TORBOLE CASAGLIA",15,982,33,1030,"2013","186"
"9688","TORINO",178,0,0,178,"2013","272"
"9689","TORLINO VIMERCATI",0,457,0,457,"2013","105"
"9690","TORNATA",2,138,0,140,"2013","106"
"9691","TORNOLO",60,3,0,63,"2013","040"
"9692","TORRAZZA COSTE",14,0,0,14,"2013","155"
"9693","TORRAZZA PIEMONTE",183,28,0,211,"2013","273"
"9694","TORRAZZO",5,0,0,5,"2013","069"
"9695","TORRE BERETTI E CASTELLARO",14,350,0,364,"2013","156"
"9696","TORRE BOLDONE",11,0,0,11,"2013","214"
"9697","TORRE BORMIDA",0,4,0,4,"2013","226"
"9698","TORRE D'ARESE",4,0,0,4,"2013","157"
"9699","TORRE D'ISOLA",1,492,0,493,"2013","159"
"9700","TORRE DE' BUSI",12,0,1,13,"2013","080"
"9701","TORRE DE' NEGRI",11,17,89,117,"2013","158"
"9702","TORRE DE' PICENARDI",4,975,0,979,"2013","107"
"9703","TORRE DE' ROVERI",5,0,0,5,"2013","216"
"9704","TORRE DI MOSTO",24,533,0,557,"2013","041"
"9705","TORRE DI SANTA MARIA",21,3,0,24,"2013","067"
"9706","TORRE MONDOVI'",2,0,0,2,"2013","227"
"9707","TORRE PALLAVICINA",289,306,0,595,"2013","217"
"9708","TORRE PELLICE",77,0,0,77,"2013","275"
"9709","TORRE SAN GIORGIO",63,44,0,107,"2013","228"
"9710","TORREBELVICINO",755,20,0,775,"2013","107"
"9711","TORREGLIA",7,0,0,7,"2013","092"
"9712","TORRESINA",4,0,0,4,"2013","229"
"9713","TORREVECCHIA PIA",84,10,1,95,"2013","160"
"9714","TORRI DEL BENACO",2,0,0,2,"2013",NA
"9715","TORRI DI QUARTESOLO",95,151,45,291,"2013","108"
"9716","TORRIANA",276,0,0,276,"2013","019"
"9717","TORRILE",0,2197,0,2197,"2013","041"
"9718","TORTONA",2432,243,0,2675,"2013","174"
"9719","TOSCOLANO-MADERNO",13,0,0,13,"2013","187"
"9720","TOVO DI SANT'AGATA",0,57,2,59,"2013","068"
"9721","TRADATE",28,0,9,37,"2013","127"
"9722","TRANA",70,184,24,278,"2013","276"
"9723","TRAONA",57,90,104,251,"2013","069"
"9724","TRAREGO VIGGIONA",4,0,0,4,"2013","066"
"9725","TRASQUERA",10,0,4,14,"2013","067"
"9726","TRAUSELLA",17,26,0,43,"2013","277"
"9727","TRAVACO' SICCOMARIO",2,0,0,2,"2013","162"
"9728","TRAVAGLIATO",1098,489,1,1588,"2013","188"
"9729","TRAVEDONA-MONATE",24,28,0,52,"2013","128"
"9730","TRAVERSELLA",51,40,0,91,"2013","278"
"9731","TRAVERSETOLO",69,1092,0,1161,"2013","042"
"9732","TRAVES",1,0,0,1,"2013","279"
"9733","TRAVO",76,45,0,121,"2013","043"
"9734","TREBASELEGHE",5423,192,0,5615,"2013","093"
"9735","TRECASALI",0,582,0,582,"2013","043"
"9736","TRECATE",8,208,0,216,"2013","149"
"9737","TRECENTA",1238,196,4,1438,"2013","047"
"9738","TREDOZIO",126,0,0,126,"2013","049"
"9739","TREGNAGO",607,168,0,775,"2013","087"
"9740","TREMEZZO",4,16,28,48,"2013","225"
"9741","TREMOSINE",29,429,12,470,"2013","189"
"9742","TRENZANO",746,1402,73,2221,"2013","190"
"9743","TRESCORE BALNEARIO",40,59,37,136,"2013","218"
"9744","TRESCORE CREMASCO",82,359,0,441,"2013","109"
"9745","TRESIGALLO",15,0,0,15,"2013","024"
"9746","TRESIVIO",5,39,0,44,"2013","070"
"9747","TREVENZUOLO",643,768,22,1433,"2013","088"
"9748","TREVIGLIO",550,1450,2,2002,"2013","219"
"9749","TREVIGNANO",2306,192,0,2498,"2013","085"
"9750","TREVIOLO",47,212,0,259,"2013","220"
"9751","TREVISO",788,158,5,951,"2013","086"
"9752","TREVISO BRESCIANO",6,59,0,65,"2013","191"
"9753","TREZZANO SUL NAVIGLIO",0,269,0,269,"2013","220"
"9754","TREZZO SULL'ADDA",1,397,0,398,"2013","221"
"9755","TREZZO TINELLA",33,0,0,33,"2013","231"
"9756","TREZZONE",2,0,0,2,"2013","226"
"9757","TRIBANO",7,0,0,7,"2013","094"
"9758","TRIBIANO",0,45,0,45,"2013","222"
"9759","TRICHIANA",109,397,0,506,"2013","061"
"9760","TRIGOLO",6,1584,0,1590,"2013","110"
"9761","TRINITA'",2516,306,384,3206,"2013","232"
"9762","TRINO",2,153,0,155,"2013","148"
"9763","TRISOBBIO",129,0,0,129,"2013","176"
"9764","TRISSINO",53,382,0,435,"2013","110"
"9765","TRIUGGIO",88,287,5,380,"2013",NA
"9766","TRIVERO",9,29,0,38,"2013","070"
"9767","TROFARELLO",782,72,0,854,"2013","280"
"9768","TROMELLO",87,76,161,324,"2013","164"
"9769","TRONTANO",5,12,12,29,"2013","068"
"9770","TRONZANO LAGO MAGGIORE",2,0,0,2,"2013","129"
"9771","TRONZANO VERCELLESE",137,28,0,165,"2013","150"
"9772","TROVO",13,9,0,22,"2013","165"
"9773","TRUCCAZZANO",97,1649,0,1746,"2013","224"
"9774","TURANO LODIGIANO",54,1898,0,1952,"2013","058"
"9775","TURATE",185,0,3,188,"2013","227"
"9776","TURBIGO",2,70,0,72,"2013","226"
"9777","UBIALE CLANEZZO",10,0,0,10,"2013","221"
"9778","UBOLDO",12,0,0,12,"2013","130"
"9779","UGGIATE-TREVANO",5,62,35,102,"2013","228"
"9780","URAGO D'OGLIO",449,864,0,1313,"2013","192"
"9781","URBANA",845,0,0,845,"2013","095"
"9782","URGNANO",314,208,0,522,"2013","222"
"9783","USMATE VELATE",7,74,0,81,"2013",NA
"9784","USSEAUX",43,94,0,137,"2013","281"
"9785","USSEGLIO",28,0,0,28,"2013","282"
"9786","VAIANO CREMASCO",68,258,0,326,"2013","111"
"9787","VAIE",1,39,67,107,"2013","283"
"9788","VAILATE",5,430,0,435,"2013","112"
"9789","VAL DELLA TORRE",390,0,0,390,"2013","284"
"9790","VAL DI NIZZA",0,4,0,4,"2013","166"
"9791","VAL MASINO",9,0,0,9,"2013","074"
"9792","VAL REZZO",6,1,8,15,"2013","233"
"9793","VALBONDIONE",4,21,0,25,"2013","223"
"9794","VALBREMBO",56,1,0,57,"2013","224"
"9795","VALBRONA",8,0,2,10,"2013","229"
"9796","VALDAGNO",37,205,0,242,"2013","111"
"9797","VALDASTICO",1171,21,0,1192,"2013","112"
"9798","VALDENGO",32,66,0,98,"2013","071"
"9799","VALDIDENTRO",20,122,14,156,"2013","071"
"9800","VALDIERI",1,0,0,1,"2013","233"
"9801","VALDISOTTO",21,141,9,171,"2013","072"
"9802","VALDOBBIADENE",105,442,0,547,"2013","087"
"9803","VALDUGGIA",7,0,0,7,"2013","152"
"9804","VALEGGIO",46,0,0,46,"2013","167"
"9805","VALEGGIO SUL MINCIO",2177,2090,43,4310,"2013","089"
"9806","VALENZA",49,0,0,49,"2013","177"
"9807","VALERA FRATTA",137,198,0,335,"2013","059"
"9808","VALFENERA",913,101,161,1175,"2013","112"
"9809","VALFURVA",5,104,15,124,"2013","073"
"9810","VALGANNA",18,0,1,19,"2013","131"
"9811","VALGOGLIO",27,51,0,78,"2013","225"
"9812","VALGRANA",94,0,0,94,"2013","234"
"9813","VALGREGHENTINO",4,0,0,4,"2013","082"
"9814","VALLADA AGORDINA",2,4,0,6,"2013","062"
"9815","VALLE DI CADORE",2,0,0,2,"2013","063"
"9816","VALLE LOMELLINA",6,730,0,736,"2013","168"
"9817","VALLE MOSSO",2,0,0,2,"2013","073"
"9818","VALLE SALIMBENE",0,96,0,96,"2013","169"
"9819","VALLE SAN NICOLAO",4,0,0,4,"2013","074"
"9820","VALLEVE",0,15,0,15,"2013","226"
"9821","VALLI DEL PASUBIO",6,9,0,15,"2013","113"
"9822","VALLIO TERME",7,0,0,7,"2013","193"
"9823","VALLO TORINESE",15,0,0,15,"2013","286"
"9824","VALMADRERA",82,0,1,83,"2013","083"
"9825","VALMOREA",3,35,0,38,"2013","232"
"9826","VALMOZZOLA",39,17,0,56,"2013","044"
"9827","VALPERGA",127,253,0,380,"2013","287"
"9828","VALPRATO SOANA",30,0,0,30,"2013","288"
"9829","VALSECCA",45,0,0,45,"2013","228"
"9830","VALSOLDA",9,6,6,21,"2013","234"
"9831","VALSTAGNA",3,0,0,3,"2013","114"
"9832","VALSTRONA",28,0,0,28,"2013","069"
"9833","VALTORTA",23,20,0,43,"2013","229"
"9834","VALVERDE",22,0,0,22,"2013","170"
"9835","VALVESTINO",5,6,0,11,"2013","194"
"9836","VANZAGHELLO",1,0,0,1,"2013","249"
"9837","VANZAGO",30,0,19,49,"2013","229"
"9838","VAPRIO D'ADDA",7,330,0,337,"2013","230"
"9839","VARALLO",38,54,3,95,"2013","156"
"9840","VARALLO POMBIA",4,0,0,4,"2013","154"
"9841","VARANO BORGHI",3,0,0,3,"2013","132"
"9842","VARANO DE' MELEGARI",6,355,0,361,"2013","045"
"9843","VAREDO",4,0,0,4,"2013",NA
"9844","VARESE",75,91,0,166,"2013","133"
"9845","VARISELLA",16,33,0,49,"2013","289"
"9846","VARSI",16,425,0,441,"2013","046"
"9847","VARZI",97,9,0,106,"2013","171"
"9848","VARZO",11,16,7,34,"2013","071"
"9849","VAS",0,12,0,12,"2013","064"
"9850","VAUDA CANAVESE",25,0,0,25,"2013","290"
"9851","VAZZOLA",840,316,1,1157,"2013","088"
"9852","VEDANO OLONA",105,104,0,209,"2013","134"
"9853","VEDDASCA",0,0,12,12,"2013","135"
"9854","VEDELAGO",16966,439,88,17493,"2013","089"
"9855","VEDESETA",4,138,0,142,"2013","230"
"9856","VEGGIANO",81,144,58,283,"2013","096"
"9857","VEGLIO",34,0,0,34,"2013","075"
"9858","VELESO",2,0,13,15,"2013","236"
"9859","VELEZZO LOMELLINA",1,0,0,1,"2013","172"
"9860","VELLEZZO BELLINI",20,343,0,363,"2013","173"
"9861","VELO D'ASTICO",839,30,0,869,"2013","115"
"9862","VELO VERONESE",359,1895,0,2254,"2013","090"
"9863","VENARIA REALE",68,12,244,324,"2013","292"
"9864","VENASCA",95,5,0,100,"2013","237"
"9865","VENAUS",17,40,15,72,"2013","291"
"9866","VENDROGNO",10,18,1,29,"2013","085"
"9867","VENEGONO INFERIORE",0,92,1,93,"2013","136"
"9868","VENEGONO SUPERIORE",0,6,13,19,"2013","137"
"9869","VENEZIA",848,84,46,978,"2013","042"
"9870","VENIANO",43,103,0,146,"2013","238"
"9871","VERANO BRIANZA",15,0,0,15,"2013",NA
"9872","VERBANIA",55,0,2,57,"2013","072"
"9873","VERCANA",4,8,0,12,"2013","239"
"9874","VERCEIA",9,7,0,16,"2013","075"
"9875","VERCELLI",52,219,0,271,"2013","158"
"9876","VERDELLINO",2,71,0,73,"2013","232"
"9877","VERDELLO",293,118,0,411,"2013","233"
"9878","VERDERIO INFERIORE",3,0,0,3,"2013","087"
"9879","VERDERIO SUPERIORE",0,0,38,38,"2013","088"
"9880","VERDUNO",105,0,0,105,"2013","238"
"9881","VERGATO",47,0,15,62,"2013","059"
"9882","VERGHERETO",495,0,56,551,"2013","050"
"9883","VERGIATE",60,0,0,60,"2013","138"
"9884","VERMEZZO",0,448,0,448,"2013","235"
"9885","VERNANTE",297,46,0,343,"2013","239"
"9886","VERNASCA",80,75,0,155,"2013","044"
"9887","VERNATE",4,73,0,77,"2013","236"
"9888","VEROLANUOVA",1371,2147,183,3701,"2013","195"
"9889","VEROLAVECCHIA",112,3764,235,4111,"2013","196"
"9890","VEROLENGO",214,109,0,323,"2013","293"
"9891","VERONA",3305,1034,11,4350,"2013","091"
"9892","VERONELLA",5317,330,0,5647,"2013","092"
"9893","VERRONE",60,0,0,60,"2013","076"
"9894","VERRUA PO",1,0,0,1,"2013","175"
"9895","VERRUA SAVOIA",609,0,0,609,"2013","294"
"9896","VERTEMATE CON MINOPRIO",6,0,0,6,"2013","242"
"9897","VERTOVA",16,46,0,62,"2013","234"
"9898","VERUCCHIO",114,21,0,135,"2013","020"
"9899","VERUNO",3,0,0,3,"2013","157"
"9900","VERVIO",10,1,0,11,"2013","076"
"9901","VERZUOLO",24,23,0,47,"2013","240"
"9902","VESCOVANA",5,0,0,5,"2013","097"
"9903","VESCOVATO",2790,892,422,4104,"2013","113"
"9904","VESIME",517,0,0,517,"2013","113"
"9905","VESPOLATE",41,126,0,167,"2013","158"
"9906","VESTENANOVA",528,153,0,681,"2013","093"
"9907","VESTIGNE'",10,56,0,66,"2013","295"
"9908","VESTONE",9,0,0,9,"2013","197"
"9909","VESTRENO",1,0,0,1,"2013","089"
"9910","VETTO",32,377,21,430,"2013","042"
"9911","VEZZA D'ALBA",3,0,0,3,"2013","241"
"9912","VEZZA D'OGLIO",1,181,25,207,"2013","198"
"9913","VEZZANO SUL CROSTOLO",19,203,0,222,"2013","043"
"9914","VIADANA",431,1351,67,1849,"2013","066"
"9915","VIADANICA",21,35,0,56,"2013","235"
"9916","VIALE",267,0,0,267,"2013","114"
"9917","VIALFRE'",12,0,0,12,"2013","296"
"9918","VIANO",4,744,5,753,"2013","044"
"9919","VIARIGI",36,0,0,36,"2013","115"
"9920","VICENZA",299,1003,35,1337,"2013","116"
"9921","VICO CANAVESE",131,133,0,264,"2013","297"
"9922","VICOFORTE",503,0,0,503,"2013","242"
"9923","VIDIGULFO",22,363,0,385,"2013","176"
"9924","VIDOR",36,329,0,365,"2013","090"
"9925","VIGANELLA",1,0,0,1,"2013",NA
"9926","VIGANO SAN MARTINO",8,0,0,8,"2013","236"
"9927","VIGARANO MAINARDA",3,0,0,3,"2013","022"
"9928","VIGASIO",396,552,0,948,"2013","094"
"9929","VIGEVANO",80,52,144,276,"2013","177"
"9930","VIGGIU'",26,46,0,72,"2013","139"
"9931","VIGHIZZOLO D'ESTE",72,23,0,95,"2013","098"
"9932","VIGLIANO BIELLESE",0,38,0,38,"2013","077"
"9933","VIGLIANO D'ASTI",59,0,0,59,"2013","116"
"9934","VIGNALE MONFERRATO",175,0,0,175,"2013","179"
"9935","VIGNATE",6,537,0,543,"2013","237"
"9936","VIGNOLA",2,112,0,114,"2013","046"
"9937","VIGNOLE BORBERA",20,0,0,20,"2013","180"
"9938","VIGNOLO",968,0,0,968,"2013","243"
"9939","VIGNONE",2,0,0,2,"2013","074"
"9940","VIGO DI CADORE",8,5,5,18,"2013","065"
"9941","VIGODARZERE",309,122,0,431,"2013","099"
"9942","VIGOLO",23,164,0,187,"2013","237"
"9943","VIGOLZONE",80,489,0,569,"2013","045"
"9944","VIGONE",1658,1053,282,2993,"2013","299"
"9945","VIGONOVO",11,0,6,17,"2013","043"
"9946","VIGONZA",526,373,0,899,"2013","100"
"9947","VILLA BARTOLOMEA",34,0,0,34,"2013","095"
"9948","VILLA CARCINA",6,0,0,6,"2013","199"
"9949","VILLA CORTESE",105,0,0,105,"2013","248"
"9950","VILLA D'ADDA",10,0,0,10,"2013","238"
"9951","VILLA D'ALME'",61,21,3,85,"2013","239"
"9952","VILLA D'OGNA",3,71,0,74,"2013","241"
"9953","VILLA DEL BOSCO",2,0,0,2,"2013","078"
"9954","VILLA DEL CONTE",652,670,2,1324,"2013","101"
"9955","VILLA DI CHIAVENNA",3,5,0,8,"2013","077"
"9956","VILLA DI SERIO",5,0,0,5,"2013","240"
"9957","VILLA DI TIRANO",9,154,60,223,"2013","078"
"9958","VILLA ESTENSE",250,0,0,250,"2013","102"
"9959","VILLA GUARDIA",90,0,0,90,"2013","245"
"9960","VILLA MINOZZO",35,665,11,711,"2013","045"
"9961","VILLA POMA",0,643,94,737,"2013","067"
"9962","VILLA SAN SECONDO",10,0,0,10,"2013","119"
"9963","VILLACHIARA",427,1699,642,2768,"2013","200"
"9964","VILLADEATI",21,0,0,21,"2013","182"
"9965","VILLADOSE",755,0,85,840,"2013","048"
"9966","VILLADOSSOLA",10,0,0,10,"2013","075"
"9967","VILLAFALLETTO",1585,661,393,2639,"2013","244"
"9968","VILLAFRANCA D'ASTI",290,0,0,290,"2013","117"
"9969","VILLAFRANCA DI VERONA",8181,2883,182,11246,"2013","096"
"9970","VILLAFRANCA PADOVANA",721,1771,0,2492,"2013","103"
"9971","VILLAFRANCA PIEMONTE",2431,1864,538,4833,"2013","300"
"9972","VILLAGA",96,246,63,405,"2013","117"
"9973","VILLAMARZANA",47,78,0,125,"2013","049"
"9974","VILLAMIROGLIO",51,0,0,51,"2013","184"
"9975","VILLANOVA BIELLESE",263,0,0,263,"2013","079"
"9976","VILLANOVA CANAVESE",42,20,0,62,"2013","301"
"9977","VILLANOVA D'ARDENGHI",18,0,14,32,"2013","179"
"9978","VILLANOVA D'ASTI",3504,97,0,3601,"2013","118"
"9979","VILLANOVA DEL GHEBBO",18,0,0,18,"2013","050"
"9980","VILLANOVA DEL SILLARO",2,1273,6,1281,"2013","060"
"9981","VILLANOVA DI CAMPOSAMPIERO",34,49,5,88,"2013","104"
"9982","VILLANOVA MARCHESANA",0,76,0,76,"2013","051"
"9983","VILLANOVA MONDOVI'",2020,459,112,2591,"2013","245"
"9984","VILLANOVA MONFERRATO",5,84,0,89,"2013","185"
"9985","VILLANOVA SOLARO",262,488,0,750,"2013","246"
"9986","VILLANOVA SULL'ARDA",158,1281,0,1439,"2013","046"
"9987","VILLANTERIO",3,0,143,146,"2013","180"
"9988","VILLANUOVA SUL CLISI",7,0,0,7,"2013","201"
"9989","VILLAR DORA",31,0,31,62,"2013","303"
"9990","VILLAR FOCCHIARDO",30,55,40,125,"2013","305"
"9991","VILLAR PELLICE",216,32,15,263,"2013","306"
"9992","VILLAR PEROSA",11,0,13,24,"2013","307"
"9993","VILLAR SAN COSTANZO",348,176,86,610,"2013","247"
"9994","VILLARBASSE",234,22,0,256,"2013","302"
"9995","VILLARBOIT",2,0,0,2,"2013","163"
"9996","VILLAREGGIA",60,28,0,88,"2013","304"
"9997","VILLAROMAGNANO",38,0,0,38,"2013","186"
"9998","VILLASTELLONE",910,590,132,1632,"2013","308"
"9999","VILLATA",7,35,0,42,"2013","164"
"10000","VILLAVERLA",47,1022,0,1069,"2013","118"
"10001","VILLETTE",38,0,0,38,"2013","076"
"10002","VILLIMPENTA",440,82,33,555,"2013","068"
"10003","VILLONGO",11,0,0,11,"2013","242"
"10004","VILLORBA",111,22,0,133,"2013","091"
"10005","VILMINORE DI SCALVE",13,186,0,199,"2013","243"
"10006","VIMERCATE",5,41,0,46,"2013",NA
"10007","VINADIO",169,0,0,169,"2013","248"
"10008","VINCHIO",46,0,0,46,"2013","120"
"10009","VINOVO",218,144,0,362,"2013","309"
"10010","VINZAGLIO",16,44,0,60,"2013","164"
"10011","VIOLA",77,0,0,77,"2013","249"
"10012","VIONE",0,43,2,45,"2013","202"
"10013","VIRGILIO",36,1385,584,2005,"2013","069"
"10014","VIRLE PIEMONTE",372,250,142,764,"2013","310"
"10015","VISANO",1887,635,0,2522,"2013","203"
"10016","VISCHE",15,0,0,15,"2013","311"
"10017","VISONE",45,0,0,45,"2013","187"
"10018","VISTARINO",62,0,21,83,"2013","181"
"10019","VISTRORIO",8,0,0,8,"2013","312"
"10020","VITTORIO VENETO",276,181,17,474,"2013","092"
"10021","VITTUONE",7,160,0,167,"2013","243"
"10022","VIU'",67,37,34,138,"2013","313"
"10023","VIVERONE",45,0,0,45,"2013","080"
"10024","VIZZOLO PREDABISSI",25,0,0,25,"2013","244"
"10025","VO'",100,69,0,169,"2013","105"
"10026","VOBARNO",56,76,2,134,"2013","204"
"10027","VOCCA",0,13,0,13,"2013","166"
"10028","VODO CADORE",0,0,24,24,"2013","066"
"10029","VOGHERA",23,0,0,23,"2013","182"
"10030","VOGHIERA",3,0,0,3,"2013","023"
"10031","VOGOGNA",17,4,0,21,"2013","077"
"10032","VOLONGO",41,0,0,41,"2013","114"
"10033","VOLPAGO DEL MONTELLO",1001,609,19,1629,"2013","093"
"10034","VOLPEGLINO",3,0,0,3,"2013","189"
"10035","VOLPIANO",314,115,102,531,"2013","314"
"10036","VOLTA MANTOVANA",2085,1445,819,4349,"2013","070"
"10037","VOLTAGGIO",8,90,0,98,"2013","190"
"10038","VOLTIDO",2,313,0,315,"2013","115"
"10039","VOLVERA",1601,199,0,1800,"2013","315"
"10040","VOTTIGNASCO",2009,57,51,2117,"2013","250"
"10041","ZANDOBBIO",7,20,0,27,"2013","244"
"10042","ZANE'",315,146,0,461,"2013","119"
"10043","ZANICA",911,1177,0,2088,"2013","245"
"10044","ZAVATTARELLO",105,0,0,105,"2013","184"
"10045","ZECCONE",0,243,0,243,"2013","185"
"10046","ZELBIO",0,0,12,12,"2013","246"
"10047","ZELO BUON PERSICO",0,1071,23,1094,"2013","061"
"10048","ZELO SURRIGONE",0,186,0,186,"2013","246"
"10049","ZEME",47,30,0,77,"2013","186"
"10050","ZENEVREDO",5,0,0,5,"2013","187"
"10051","ZENSON DI PIAVE",7,0,0,7,"2013","094"
"10052","ZERBOLO'",0,235,0,235,"2013","189"
"10053","ZERMEGHEDO",0,64,0,64,"2013","120"
"10054","ZERO BRANCO",213,199,6,418,"2013","095"
"10055","ZEVIO",3317,753,71,4141,"2013","097"
"10056","ZIANO PIACENTINO",93,0,0,93,"2013","048"
"10057","ZIBELLO",5,1022,0,1027,"2013","048"
"10058","ZIBIDO SAN GIACOMO",75,459,0,534,"2013","247"
"10059","ZIMELLA",7259,481,67,7807,"2013","098"
"10060","ZINASCO",17,0,0,17,"2013","190"
"10061","ZOCCA",103,873,0,976,"2013","047"
"10062","ZOGNO",111,54,1,166,"2013","246"
"10063","ZOLA PREDOSA",23,141,0,164,"2013","060"
"10064","ZOLDO ALTO",15,0,0,15,"2013","068"
"10065","ZONE",6,31,0,37,"2013","205"
"10066","ZOVENCEDO",9,0,0,9,"2013","121"
"10067","ZUBIENA",36,5,22,63,"2013","082"
"10068","ZUGLIANO",328,167,15,510,"2013","122"
"10069","ZUMAGLIA",26,0,0,26,"2013","083"
"10070","ABANO TERME",23,87,44,154,"2014","001"
"10071","ABBADIA CERRETO",0,1077,0,1077,"2014","001"
"10072","ABBADIA LARIANA",13,20,2,35,"2014","001"
"10073","ABBIATEGRASSO",78,1560,4,1642,"2014","002"
"10074","ACCEGLIO",46,28,0,74,"2014","001"
"10075","ACQUAFREDDA",1515,168,0,1683,"2014","001"
"10076","ACQUANEGRA CREMONESE",3,107,673,783,"2014","001"
"10077","ACQUANEGRA SUL CHIESE",2212,712,123,3047,"2014","001"
"10078","ACQUI TERME",283,0,0,283,"2014","001"
"10079","ADRARA SAN MARTINO",41,39,0,80,"2014","001"
"10080","ADRARA SAN ROCCO",4,11,0,15,"2014","002"
"10081","ADRIA",2533,304,0,2837,"2014","001"
"10082","ADRO",531,24,0,555,"2014","002"
"10083","AFFI",2,8,0,10,"2014","001"
"10084","AGAZZANO",200,274,0,474,"2014","001"
"10085","AGLIANO TERME",74,0,0,74,"2014","001"
"10086","AGLIE'",185,35,1,221,"2014","001"
"10087","AGNA",392,0,0,392,"2014","002"
"10088","AGNADELLO",4,1338,107,1449,"2014","002"
"10089","AGNOSINE",16,44,0,60,"2014","003"
"10090","AGORDO",2,37,0,39,"2014","001"
"10091","AGRATE CONTURBIA",44,0,0,44,"2014","001"
"10092","AGUGLIARO",363,64,0,427,"2014","001"
"10093","AICURZIO",6,59,0,65,"2014",NA
"10094","AILOCHE",1,0,0,1,"2014","001"
"10095","AIRASCA",1055,308,103,1466,"2014","002"
"10096","AIRUNO",9,0,0,9,"2014","002"
"10097","AISONE",20,18,0,38,"2014","002"
"10098","ALA DI STURA",24,43,0,67,"2014","003"
"10099","ALAGNA",2,0,0,2,"2014",NA
"10100","ALAGNA VALSESIA",7,13,12,32,"2014","002"
"10101","ALANO DI PIAVE",417,55,0,472,"2014","002"
"10102","ALBA",838,0,0,838,"2014","003"
"10103","ALBAIRATE",28,646,0,674,"2014","005"
"10104","ALBANO SANT'ALESSANDRO",14,0,0,14,"2014","003"
"10105","ALBAREDO D'ADIGE",9161,213,0,9374,"2014","002"
"10106","ALBAREDO PER SAN MARCO",2,32,0,34,"2014","001"
"10107","ALBARETO",82,96,0,178,"2014","001"
"10108","ALBARETTO DELLA TORRE",32,0,0,32,"2014","004"
"10109","ALBAVILLA",5,0,0,5,"2014","003"
"10110","ALBERA LIGURE",22,0,0,22,"2014","002"
"10111","ALBESE CON CASSANO",0,0,5,5,"2014","004"
"10112","ALBETTONE",1688,615,2,2305,"2014","002"
"10113","ALBIANO D'IVREA",145,44,0,189,"2014","004"
"10114","ALBIATE",388,0,0,388,"2014",NA
"10115","ALBIGNASEGO",173,82,141,396,"2014","003"
"10116","ALBINEA",7,1280,0,1287,"2014","001"
"10117","ALBINO",81,38,0,119,"2014","004"
"10118","ALBIOLO",27,0,0,27,"2014","005"
"10119","ALBIZZATE",5,0,0,5,"2014","002"
"10120","ALBOSAGGIA",12,96,25,133,"2014","002"
"10121","ALBUGNANO",78,0,0,78,"2014","002"
"10122","ALBUZZANO",19,0,0,19,"2014","004"
"10123","ALESSANDRIA",11370,1999,0,13369,"2014","003"
"10124","ALFIANELLO",18,488,5,511,"2014","004"
"10125","ALFIANO NATTA",34,0,0,34,"2014","004"
"10126","ALFONSINE",40,0,0,40,"2014","001"
"10127","ALGUA",4,5,0,9,"2014","248"
"10128","ALICE BEL COLLE",2,0,0,2,"2014","005"
"10129","ALICE CASTELLO",660,28,0,688,"2014","004"
"10130","ALICE SUPERIORE",30,0,0,30,"2014","005"
"10131","ALLEGHE",10,0,0,10,"2014","003"
"10132","ALLUVIONI CAMBIO'",14,0,0,14,"2014","006"
"10133","ALME'",5,0,1,6,"2014","005"
"10134","ALMENNO SAN BARTOLOMEO",34,0,0,34,"2014","006"
"10135","ALMENNO SAN SALVATORE",7,0,0,7,"2014","007"
"10136","ALMESE",40,20,0,60,"2014","006"
"10137","ALONTE",527,16,0,543,"2014","003"
"10138","ALPETTE",0,19,0,19,"2014","007"
"10139","ALPIGNANO",288,165,37,490,"2014","008"
"10140","ALSENO",416,829,0,1245,"2014","002"
"10141","ALSERIO",6,0,0,6,"2014","006"
"10142","ALTAVILLA MONFERRATO",73,0,0,73,"2014","007"
"10143","ALTAVILLA VICENTINA",119,0,0,119,"2014","004"
"10144","ALTISSIMO",31,49,0,80,"2014","005"
"10145","ALTIVOLE",10982,75,30,11087,"2014","001"
"10146","ALZANO LOMBARDO",25,44,0,69,"2014","008"
"10147","ALZANO SCRIVIA",2,0,0,2,"2014","008"
"10148","ALZATE BRIANZA",7,182,0,189,"2014","007"
"10149","AMBIVERE",6,0,0,6,"2014","009"
"10150","AMENO",10,6,23,39,"2014","002"
"10151","ANDALO VALTELLINO",5,0,0,5,"2014",NA
"10152","ANDEZENO",427,0,0,427,"2014","009"
"10153","ANDORNO MICCA",14,0,25,39,"2014","002"
"10154","ANDRATE",31,0,0,31,"2014","010"
"10155","ANFO",0,21,0,21,"2014","005"
"10156","ANGERA",84,183,0,267,"2014","003"
"10157","ANGOLO TERME",5,62,0,67,"2014","006"
"10158","ANGROGNA",84,0,8,92,"2014","011"
"10159","ANGUILLARA VENETA",12,0,0,12,"2014","004"
"10160","ANNICCO",43,794,166,1003,"2014","003"
"10161","ANNONE DI BRIANZA",20,24,0,44,"2014","003"
"10162","ANNONE VENETO",33,72,0,105,"2014","001"
"10163","ANTEGNATE",1011,1189,32,2232,"2014","010"
"10164","ANTIGNANO",79,0,0,79,"2014","003"
"10165","ANTRONA SCHIERANCO",12,0,0,12,"2014","001"
"10166","ANZANO DEL PARCO",0,139,0,139,"2014","009"
"10167","ANZOLA D'OSSOLA",4,116,0,120,"2014","002"
"10168","ANZOLA DELL'EMILIA",39,847,0,886,"2014","001"
"10169","APPIANO GENTILE",46,319,33,398,"2014","010"
"10170","APRICA",0,9,0,9,"2014","004"
"10171","ARAMENGO",202,0,0,202,"2014","004"
"10172","ARCADE",919,116,0,1035,"2014","002"
"10173","ARCENE",6,336,0,342,"2014","011"
"10174","ARCISATE",56,794,0,850,"2014","004"
"10175","ARCOLE",758,172,0,930,"2014","004"
"10176","ARCONATE",48,87,0,135,"2014","007"
"10177","ARCORE",19,23,0,42,"2014",NA
"10178","ARCUGNANO",97,5,0,102,"2014","006"
"10179","ARDENNO",56,57,0,113,"2014","005"
"10180","ARDESIO",71,43,0,114,"2014","012"
"10181","ARENA PO",141,211,65,417,"2014","005"
"10182","ARESE",0,127,0,127,"2014","009"
"10183","ARGELATO",87,60,0,147,"2014","002"
"10184","ARGENTA",1807,28,0,1835,"2014","001"
"10185","ARGUELLO",84,0,0,84,"2014","007"
"10186","ARIANO NEL POLESINE",913,198,0,1111,"2014","002"
"10187","ARIGNANO",547,0,0,547,"2014","012"
"10188","ARLUNO",54,197,12,263,"2014","010"
"10189","ARMENO",55,79,0,134,"2014","006"
"10190","AROLA",6,0,8,14,"2014","004"
"10191","ARONA",4,0,0,4,"2014","008"
"10192","AROSIO",2,1,0,3,"2014","012"
"10193","ARQUA' PETRARCA",2,0,0,2,"2014","005"
"10194","ARQUA' POLESINE",889,5,0,894,"2014","003"
"10195","ARQUATA SCRIVIA",8,0,0,8,"2014","009"
"10196","ARRE",5,15,0,20,"2014","006"
"10197","ARSAGO SEPRIO",10,0,0,10,"2014","005"
"10198","ARSIE'",16,5,338,359,"2014","004"
"10199","ARSIERO",10,17,0,27,"2014","007"
"10200","ARTOGNE",13,452,10,475,"2014","007"
"10201","ARZAGO D'ADDA",329,822,0,1151,"2014","013"
"10202","ARZERGRANDE",287,146,11,444,"2014","007"
"10203","ARZIGNANO",251,243,0,494,"2014","008"
"10204","ASIAGO",77,1199,0,1276,"2014","009"
"10205","ASIGLIANO VENETO",63,0,0,63,"2014","010"
"10206","ASIGLIANO VERCELLESE",20,0,0,20,"2014","007"
"10207","ASOLA",7937,1669,1403,11009,"2014","002"
"10208","ASOLO",8790,425,0,9215,"2014","003"
"10209","ASSAGO",0,0,5,5,"2014","011"
"10210","ASSO",18,0,0,18,"2014","013"
"10211","ASTI",2638,14,0,2652,"2014","005"
"10212","AURANO",5,0,0,5,"2014","005"
"10213","AURONZO DI CADORE",11,4,0,15,"2014","005"
"10214","AVERARA",3,0,0,3,"2014","014"
"10215","AVIATICO",1,20,0,21,"2014","015"
"10216","AVIGLIANA",197,43,11,251,"2014","013"
"10217","AVOLASCA",133,0,0,133,"2014","010"
"10218","AZEGLIO",58,106,0,164,"2014","014"
"10219","AZZANELLO",4,358,0,362,"2014","004"
"10220","AZZANO MELLA",325,830,21,1176,"2014","008"
"10221","AZZANO SAN PAOLO",25,124,0,149,"2014","016"
"10222","AZZATE",24,21,0,45,"2014","006"
"10223","AZZIO",14,94,0,108,"2014","007"
"10224","AZZONE",1,5,0,6,"2014","017"
"10225","BACENO",10,26,7,43,"2014","006"
"10226","BADIA CALAVENA",752,341,29,1122,"2014","005"
"10227","BADIA PAVESE",37,0,0,37,"2014","006"
"10228","BADIA POLESINE",199,0,0,199,"2014","004"
"10229","BAGNACAVALLO",41,0,0,41,"2014","002"
"10230","BAGNARA DI ROMAGNA",4,0,0,4,"2014","003"
"10231","BAGNARIA",19,0,0,19,"2014","007"
"10232","BAGNASCO",127,0,0,127,"2014","008"
"10233","BAGNATICA",7,162,0,169,"2014","018"
"10234","BAGNO DI ROMAGNA",747,19,0,766,"2014","001"
"10235","BAGNOLI DI SOPRA",994,9,0,1003,"2014","008"
"10236","BAGNOLO CREMASCO",5,1672,0,1677,"2014","005"
"10237","BAGNOLO IN PIANO",3,591,0,594,"2014","002"
"10238","BAGNOLO MELLA",433,2831,312,3576,"2014","009"
"10239","BAGNOLO PIEMONTE",956,86,0,1042,"2014","009"
"10240","BAGNOLO SAN VITO",102,2264,1287,3653,"2014","003"
"10241","BAGOLINO",2,317,7,326,"2014","010"
"10242","BAIRO",60,93,0,153,"2014","015"
"10243","BAISO",8,920,2,930,"2014","003"
"10244","BALANGERO",172,108,32,312,"2014","016"
"10245","BALDICHIERI D'ASTI",76,0,0,76,"2014","007"
"10246","BALDISSERO CANAVESE",0,79,0,79,"2014","017"
"10247","BALDISSERO D'ALBA",722,0,0,722,"2014","010"
"10248","BALDISSERO TORINESE",181,0,0,181,"2014","018"
"10249","BALLABIO",16,75,0,91,"2014","004"
"10250","BALME",15,0,0,15,"2014","019"
"10251","BALOCCO",52,25,0,77,"2014","009"
"10252","BANCHETTE",4,0,0,4,"2014","020"
"10253","BANNIO ANZINO",36,0,2,38,"2014","007"
"10254","BAONE",26,0,0,26,"2014","009"
"10255","BARASSO",1,0,0,1,"2014",NA
"10256","BARBANIA",36,189,70,295,"2014","021"
"10257","BARBARANO VICENTINO",263,288,0,551,"2014","011"
"10258","BARBARESCO",35,0,0,35,"2014","011"
"10259","BARBARIGA",179,1200,0,1379,"2014","011"
"10260","BARBATA",47,1015,0,1062,"2014","019"
"10261","BARBIANELLO",126,11,0,137,"2014","008"
"10262","BARBONA",235,5,0,240,"2014","010"
"10263","BARDELLO",16,0,0,16,"2014","009"
"10264","BARDI",46,663,0,709,"2014","002"
"10265","BARDOLINO",23,104,0,127,"2014","006"
"10266","BARDONECCHIA",28,38,0,66,"2014","022"
"10267","BAREGGIO",82,294,0,376,"2014","012"
"10268","BARENGO",8,108,0,116,"2014","012"
"10269","BARGE",4375,1937,217,6529,"2014","012"
"10270","BARGHE",4,12,0,16,"2014","012"
"10271","BARIANO",0,366,0,366,"2014","020"
"10272","BARNI",10,3,6,19,"2014","015"
"10273","BAROLO",45,0,0,45,"2014","013"
"10274","BARONE CANAVESE",4,43,0,47,"2014","023"
"10275","BARZAGO",282,20,0,302,"2014","005"
"10276","BARZANA",1,0,0,1,"2014",NA
"10277","BARZANO'",15,0,0,15,"2014","006"
"10278","BARZIO",9,56,15,80,"2014","007"
"10279","BASALUZZO",81,0,0,81,"2014","012"
"10280","BASCAPE'",78,661,0,739,"2014","009"
"10281","BASIGLIO",0,58,0,58,"2014","015"
"10282","BASSANO BRESCIANO",1,98,0,99,"2014","013"
"10283","BASSANO DEL GRAPPA",272,188,9,469,"2014","012"
"10284","BASSIGNANA",3,0,0,3,"2014","013"
"10285","BASTIA MONDOVI'",691,0,0,691,"2014","014"
"10286","BASTIDA PANCARANA",3,0,0,3,"2014","011"
"10287","BASTIGLIA",125,0,0,125,"2014","001"
"10288","BATTAGLIA TERME",2,0,0,2,"2014","011"
"10289","BEDERO VALCUVIA",22,0,0,22,"2014","010"
"10290","BEDIZZOLE",4119,1302,0,5421,"2014","014"
"10291","BEDONIA",198,134,0,332,"2014","003"
"10292","BEDULITA",13,5,0,18,"2014","022"
"10293","BEE",1,0,0,1,"2014","009"
"10294","BEINASCO",25,0,0,25,"2014","024"
"10295","BEINETTE",723,315,14,1052,"2014","016"
"10296","BELFIORE",2124,0,0,2124,"2014","007"
"10297","BELGIOIOSO",2,133,0,135,"2014","013"
"10298","BELLAGIO",8,72,20,100,"2014","019"
"10299","BELLANO",4,0,0,4,"2014","008"
"10300","BELLARIA-IGEA MARINA",14,0,0,14,"2014","001"
"10301","BELLINO",84,0,0,84,"2014","017"
"10302","BELLINZAGO LOMBARDO",45,1279,0,1324,"2014","016"
"10303","BELLINZAGO NOVARESE",506,543,0,1049,"2014","016"
"10304","BELLUNO",573,387,17,977,"2014","006"
"10305","BELVEDERE LANGHE",170,0,57,227,"2014","018"
"10306","BEMA",0,6,0,6,"2014","006"
"10307","BENE LARIO",3,14,63,80,"2014","021"
"10308","BENE VAGIENNA",1682,412,0,2094,"2014","019"
"10309","BENEVELLO",215,0,0,215,"2014","020"
"10310","BENNA",11,10,23,44,"2014","003"
"10311","BENTIVOGLIO",32,283,0,315,"2014","005"
"10312","BERBENNO",15,37,0,52,"2014","023"
"10313","BERBENNO DI VALTELLINA",38,108,1,147,"2014","007"
"10314","BERCETO",36,89,0,125,"2014","004"
"10315","BEREGAZZO CON FIGLIARO",21,0,0,21,"2014","022"
"10316","BEREGUARDO",5,685,52,742,"2014","014"
"10317","BERGAMASCO",88,0,0,88,"2014","015"
"10318","BERGAMO",149,113,0,262,"2014","024"
"10319","BERGOLO",3,0,0,3,"2014","021"
"10320","BERLINGO",3097,318,0,3415,"2014","015"
"10321","BERNAREGGIO",1,11,0,12,"2014",NA
"10322","BERNATE TICINO",42,133,0,175,"2014","019"
"10323","BERNEZZO",295,65,0,360,"2014","022"
"10324","BERRA",1491,66,0,1557,"2014","002"
"10325","BERTINORO",152,11,0,163,"2014","003"
"10326","BERTONICO",40,2679,0,2719,"2014","002"
"10327","BERZANO DI SAN PIETRO",9,0,0,9,"2014","009"
"10328","BERZO DEMO",10,60,9,79,"2014","016"
"10329","BERZO INFERIORE",8,125,1,134,"2014","017"
"10330","BERZO SAN FERMO",452,74,68,594,"2014","025"
"10331","BESANA IN BRIANZA",1053,48,49,1150,"2014",NA
"10332","BESANO",30,11,0,41,"2014","011"
"10333","BESATE",207,0,0,207,"2014","022"
"10334","BESENZONE",1044,1461,0,2505,"2014","003"
"10335","BESNATE",3,170,0,173,"2014","012"
"10336","BESOZZO",19,58,0,77,"2014","013"
"10337","BETTOLA",237,129,0,366,"2014","004"
"10338","BEURA-CARDEZZA",7,10,0,17,"2014","011"
"10339","BEVILACQUA",84,56,0,140,"2014","008"
"10340","BIANDRONNO",23,0,0,23,"2014","014"
"10341","BIANZANO",5,14,0,19,"2014","026"
"10342","BIANZE'",89,224,0,313,"2014","011"
"10343","BIANZONE",2,16,0,18,"2014","008"
"10344","BIASSONO",7,0,2,9,"2014",NA
"10345","BIBBIANO",9,2218,0,2227,"2014","004"
"10346","BIBIANA",559,0,10,569,"2014","025"
"10347","BIELLA",109,33,162,304,"2014","004"
"10348","BIENNO",1,77,1,79,"2014","018"
"10349","BIGARELLO",2043,206,654,2903,"2014","004"
"10350","BINAGO",24,81,65,170,"2014","023"
"10351","BIOGLIO",10,0,0,10,"2014","005"
"10352","BIONE",14,7,0,21,"2014","019"
"10353","BISTAGNO",21,0,0,21,"2014","017"
"10354","BISUSCHIO",2,0,0,2,"2014","015"
"10355","BIZZARONE",7,20,0,27,"2014","024"
"10356","BLELLO",18,27,0,45,"2014","027"
"10357","BLESSAGNO",0,0,8,8,"2014","025"
"10358","BOARA PISANI",3,0,0,3,"2014","012"
"10359","BOBBIO",149,73,0,222,"2014","005"
"10360","BOBBIO PELLICE",47,9,128,184,"2014","026"
"10361","BOCA",6,0,0,6,"2014","019"
"10362","BOCCIOLETO",6,2,0,8,"2014","014"
"10363","BOFFALORA D'ADDA",88,280,7,375,"2014","003"
"10364","BOFFALORA SOPRA TICINO",97,178,0,275,"2014","026"
"10365","BOGOGNO",1,0,0,1,"2014",NA
"10366","BOLGARE",67,276,0,343,"2014","028"
"10367","BOLLATE",0,220,7,227,"2014","027"
"10368","BOLLENGO",79,16,0,95,"2014","027"
"10369","BOLOGNA",16,10,5,31,"2014","006"
"10370","BOLTIERE",19,88,0,107,"2014","029"
"10371","BOLZANO NOVARESE",0,15,0,15,"2014","022"
"10372","BOLZANO VICENTINO",183,1406,11,1600,"2014","013"
"10373","BOMPORTO",1367,101,0,1468,"2014","002"
"10374","BONATE SOPRA",176,11,0,187,"2014","030"
"10375","BONATE SOTTO",77,0,0,77,"2014","031"
"10376","BONAVIGO",3065,35,0,3100,"2014","009"
"10377","BONDENO",662,383,0,1045,"2014","003"
"10378","BONEMERSE",30,166,0,196,"2014","006"
"10379","BORCA DI CADORE",4,0,0,4,"2014",NA
"10380","BORDOLANO",26,568,0,594,"2014","007"
"10381","BORE",167,18,0,185,"2014","005"
"10382","BORETTO",2,264,0,266,"2014","005"
"10383","BORGARELLO",0,0,1,1,"2014","015"
"10384","BORGARO TORINESE",69,87,20,176,"2014","028"
"10385","BORGHETTO DI BORBERA",151,4,0,155,"2014","018"
"10386","BORGHETTO LODIGIANO",12,1464,33,1509,"2014","004"
"10387","BORGHI",1114,0,0,1114,"2014","004"
"10388","BORGIALLO",3,36,0,39,"2014","029"
"10389","BORGO D'ALE",99,0,123,222,"2014","015"
"10390","BORGO DI TERZO",4,0,0,4,"2014","032"
"10391","BORGO PRIOLO",12,0,0,12,"2014","016"
"10392","BORGO SAN DALMAZZO",308,101,67,476,"2014","025"
"10393","BORGO SAN GIACOMO",1886,3472,12,5370,"2014","020"
"10394","BORGO SAN GIOVANNI",6,807,0,813,"2014","005"
"10395","BORGO SAN SIRO",3,565,0,568,"2014","018"
"10396","BORGO TICINO",29,0,0,29,"2014","025"
"10397","BORGO TOSSIGNANO",7,0,0,7,"2014","007"
"10398","BORGO VAL DI TARO",108,240,3,351,"2014","006"
"10399","BORGO VERCELLI",0,13,0,13,"2014","017"
"10400","BORGO VIRGILIO",54,4014,1883,5951,"2014",NA
"10401","BORGOFRANCO D'IVREA",207,16,0,223,"2014","030"
"10402","BORGOFRANCO SUL PO",1,17,59,77,"2014","006"
"10403","BORGOLAVEZZARO",6,0,0,6,"2014","023"
"10404","BORGOMALE",105,0,0,105,"2014","024"
"10405","BORGOMANERO",122,25,0,147,"2014","024"
"10406","BORGOMASINO",95,0,0,95,"2014","031"
"10407","BORGONE SUSA",23,24,0,47,"2014","032"
"10408","BORGONOVO VAL TIDONE",501,1699,0,2200,"2014","006"
"10409","BORGORATTO ALESSANDRINO",30,0,0,30,"2014","019"
"10410","BORGORATTO MORMOROLO",30,0,0,30,"2014","017"
"10411","BORGORICCO",109,41,0,150,"2014","013"
"10412","BORGOSATOLLO",13,598,22,633,"2014","021"
"10413","BORGOSESIA",61,42,0,103,"2014","016"
"10414","BORMIO",23,339,25,387,"2014","009"
"10415","BORNASCO",141,550,0,691,"2014","019"
"10416","BORNO",5,126,36,167,"2014","022"
"10417","BORRIANA",80,29,30,139,"2014","006"
"10418","BORSO DEL GRAPPA",141,193,9,343,"2014","004"
"10419","BOSARO",4,0,0,4,"2014","007"
"10420","BOSCHI SANT'ANNA",4,21,0,25,"2014","010"
"10421","BOSCO CHIESANUOVA",127,1327,0,1454,"2014","011"
"10422","BOSCO MARENGO",85,31,0,116,"2014","021"
"10423","BOSCONERO",73,36,0,109,"2014","033"
"10424","BOSIA",396,0,0,396,"2014","026"
"10425","BOSIO",29,0,4,33,"2014","022"
"10426","BOSISIO PARINI",2,116,1,119,"2014","009"
"10427","BOSSICO",26,95,0,121,"2014","033"
"10428","BOSSOLASCO",67,96,0,163,"2014","027"
"10429","BOTTANUCO",21,172,448,641,"2014","034"
"10430","BOTTICINO",36,0,0,36,"2014","023"
"10431","BOVEGNO",92,96,6,194,"2014","024"
"10432","BOVES",807,573,313,1693,"2014","028"
"10433","BOVEZZO",1,0,0,1,"2014","025"
"10434","BOVOLENTA",2954,383,0,3337,"2014","014"
"10435","BOVOLONE",3079,357,0,3436,"2014","012"
"10436","BOZZOLO",93,996,6,1095,"2014","007"
"10437","BRA",3891,1331,0,5222,"2014","029"
"10438","BRACCA",2,0,0,2,"2014","035"
"10439","BRALLO DI PREGOLA",15,15,0,30,"2014","021"
"10440","BRANDICO",1,335,0,336,"2014","026"
"10441","BRANDIZZO",2,0,83,85,"2014","034"
"10442","BRANZI",1,42,4,47,"2014","036"
"10443","BRAONE",0,38,0,38,"2014","027"
"10444","BREBBIA",28,0,2,30,"2014","017"
"10445","BREDA DI PIAVE",73,371,7,451,"2014","005"
"10446","BREGANO",4,0,0,4,"2014","018"
"10447","BREGANZE",150,863,161,1174,"2014","014"
"10448","BREGNANO",8,114,0,122,"2014","028"
"10449","BREIA",4,0,0,4,"2014","019"
"10450","BREMBATE",56,0,194,250,"2014","037"
"10451","BREMBATE DI SOPRA",6,193,0,199,"2014","038"
"10452","BREMBIO",58,1575,101,1734,"2014","006"
"10453","BREME",28,0,0,28,"2014","022"
"10454","BRENDOLA",252,122,0,374,"2014","015"
"10455","BRENO",4,251,5,260,"2014","028"
"10456","BRENTA",7,0,0,7,"2014","019"
"10457","BRENTINO BELLUNO",3,0,0,3,"2014","013"
"10458","BRENZONE",13,0,0,13,"2014","014"
"10459","BRESCELLO",17,33,11,61,"2014","006"
"10460","BRESCIA",87,562,0,649,"2014","029"
"10461","BRESSANA BOTTARONE",3,0,0,3,"2014","023"
"10462","BRESSANVIDO",57,1399,0,1456,"2014","016"
"10463","BRESSO",13,0,0,13,"2014",NA
"10464","BREZZO DI BEDERO",7,0,0,7,"2014","020"
"10465","BRIAGLIA",77,0,0,77,"2014","030"
"10466","BRICHERASIO",1035,57,28,1120,"2014","035"
"10467","BRIGA NOVARESE",10,74,0,84,"2014","026"
"10468","BRIGNANO GERA D'ADDA",181,1630,0,1811,"2014","040"
"10469","BRIGNANO-FRASCATA",7,0,0,7,"2014","024"
"10470","BRINZIO",5,0,0,5,"2014","021"
"10471","BRIONA",10,1534,0,1544,"2014","027"
"10472","BRIONE",13,0,0,13,"2014","030"
"10473","BRIOSCO",8,0,0,8,"2014",NA
"10474","BRISIGHELLA",317,64,0,381,"2014","004"
"10475","BRISSAGO-VALTRAVAGLIA",4,0,0,4,"2014","022"
"10476","BRIVIO",33,71,0,104,"2014","010"
"10477","BROGLIANO",39,36,0,75,"2014","017"
"10478","BRONDELLO",7,0,0,7,"2014","032"
"10479","BRONI",83,0,0,83,"2014","024"
"10480","BROSSASCO",64,0,0,64,"2014","033"
"10481","BROSSO",33,29,0,62,"2014","036"
"10482","BROVELLO-CARPUGNINO",21,0,6,27,"2014","013"
"10483","BROZOLO",61,0,0,61,"2014","037"
"10484","BRUGHERIO",2,261,0,263,"2014",NA
"10485","BRUGINE",3601,101,51,3753,"2014","015"
"10486","BRUINO",193,0,0,193,"2014","038"
"10487","BRUMANO",11,19,0,30,"2014","041"
"10488","BRUNELLO",17,0,0,17,"2014","023"
"10489","BRUNO",14,0,0,14,"2014","010"
"10490","BRUSAPORTO",22,0,30,52,"2014","042"
"10491","BRUSASCO",109,0,0,109,"2014","039"
"10492","BRUSNENGO",16,0,0,16,"2014","007"
"10493","BRUZOLO",85,14,9,108,"2014","040"
"10494","BUBBIANO",0,26,0,26,"2014","035"
"10495","BUBBIO",83,0,0,83,"2014","011"
"10496","BUCCINASCO",13,452,0,465,"2014","036"
"10497","BUDRIO",287,374,0,661,"2014","008"
"10498","BUGLIO IN MONTE",21,250,46,317,"2014","010"
"10499","BUGUGGIATE",4,0,0,4,"2014","025"
"10500","BULCIAGO",12,0,182,194,"2014","011"
"10501","BULGAROGRASSO",41,278,5,324,"2014","034"
"10502","BURIASCO",1139,769,207,2115,"2014","041"
"10503","BUROLO",2,0,0,2,"2014","042"
"10504","BURONZO",4,17,0,21,"2014","021"
"10505","BUSANA",0,28,0,28,"2014","007"
"10506","BUSANO",14,43,0,57,"2014","043"
"10507","BUSCA",4235,1196,722,6153,"2014","034"
"10508","BUSCATE",71,0,0,71,"2014","038"
"10509","BUSNAGO",8,3,0,11,"2014",NA
"10510","BUSSERO",1,643,0,644,"2014","040"
"10511","BUSSETO",8,3439,8,3455,"2014","007"
"10512","BUSSOLENGO",1041,119,54,1214,"2014","015"
"10513","BUSSOLENO",39,228,0,267,"2014","044"
"10514","BUSTO ARSIZIO",28,254,37,319,"2014","026"
"10515","BUSTO GAROLFO",76,209,0,285,"2014","041"
"10516","BUTTAPIETRA",18,240,0,258,"2014","016"
"10517","BUTTIGLIERA ALTA",89,48,0,137,"2014","045"
"10518","BUTTIGLIERA D'ASTI",1676,102,60,1838,"2014","012"
"10519","CA' D'ANDREA",8,1257,0,1265,"2014","008"
"10520","CABELLA LIGURE",88,0,0,88,"2014","025"
"10521","CADEGLIANO-VICONAGO",9,0,0,9,"2014","027"
"10522","CADELBOSCO DI SOPRA",1,1794,14,1809,"2014","008"
"10523","CADEO",77,2368,0,2445,"2014","007"
"10524","CADONEGHE",10,0,21,31,"2014","016"
"10525","CADORAGO",5,1,68,74,"2014","036"
"10526","CADREZZATE",5,0,0,5,"2014","028"
"10527","CAERANO DI SAN MARCO",242,98,5,345,"2014","006"
"10528","CAFASSE",80,16,0,96,"2014","046"
"10529","CAGLIO",14,0,0,14,"2014","037"
"10530","CAGNO",1,33,0,34,"2014","038"
"10531","CAINO",5,0,0,5,"2014","031"
"10532","CAIOLO",5,95,0,100,"2014","011"
"10533","CAIRATE",3,0,1,4,"2014","029"
"10534","CALALZO DI CADORE",1,0,0,1,"2014",NA
"10535","CALAMANDRANA",114,0,0,114,"2014","013"
"10536","CALASCA-CASTIGLIONE",18,0,0,18,"2014","014"
"10537","CALCINATE",252,209,0,461,"2014","043"
"10538","CALCINATO",3542,1935,916,6393,"2014","032"
"10539","CALCIO",191,1307,3,1501,"2014","044"
"10540","CALCO",19,161,0,180,"2014","012"
"10541","CALDERARA DI RENO",58,91,0,149,"2014","009"
"10542","CALDIERO",1,0,0,1,"2014","017"
"10543","CALDOGNO",320,359,0,679,"2014","018"
"10544","CALENDASCO",124,397,0,521,"2014","008"
"10545","CALESTANO",2,475,0,477,"2014","008"
"10546","CALLABIANA",16,0,0,16,"2014","008"
"10547","CALLIANO",223,0,0,223,"2014","014"
"10548","CALOLZIOCORTE",14,0,11,25,"2014","013"
"10549","CALOSSO",7,0,0,7,"2014","015"
"10550","CALTIGNAGA",878,190,0,1068,"2014","030"
"10551","CALTO",17,0,0,17,"2014","008"
"10552","CALTRANO",1356,1,0,1357,"2014","019"
"10553","CALUSCO D'ADDA",14,0,0,14,"2014","046"
"10554","CALUSO",746,200,0,946,"2014","047"
"10555","CALVAGESE DELLA RIVIERA",96,215,0,311,"2014","033"
"10556","CALVATONE",27,122,0,149,"2014","009"
"10557","CALVENE",1,70,0,71,"2014","020"
"10558","CALVENZANO",109,483,0,592,"2014","047"
"10559","CALVIGNASCO",1,36,0,37,"2014","042"
"10560","CALVISANO",12115,4463,40,16618,"2014","034"
"10561","CAMAGNA MONFERRATO",33,0,0,33,"2014","026"
"10562","CAMAIRAGO",0,1240,0,1240,"2014","007"
"10563","CAMANDONA",8,0,0,8,"2014","009"
"10564","CAMBIAGO",12,94,0,106,"2014","044"
"10565","CAMBIANO",350,0,0,350,"2014","048"
"10566","CAMBIASCA",2,0,0,2,"2014","015"
"10567","CAMBURZANO",92,0,14,106,"2014","010"
"10568","CAMERANA",302,0,0,302,"2014","035"
"10569","CAMERANO CASASCO",23,0,0,23,"2014","016"
"10570","CAMERATA CORNELLO",5,61,0,66,"2014","048"
"10571","CAMERI",119,605,44,768,"2014","032"
"10572","CAMINATA",18,0,0,18,"2014","009"
"10573","CAMISANO",255,2686,0,2941,"2014","010"
"10574","CAMISANO VICENTINO",301,1511,11,1823,"2014","021"
"10575","CAMPAGNA LUPIA",117,87,0,204,"2014","002"
"10576","CAMPAGNOLA CREMASCA",26,456,93,575,"2014","011"
"10577","CAMPAGNOLA EMILIA",10,708,0,718,"2014","009"
"10578","CAMPEGINE",3,1111,0,1114,"2014","010"
"10579","CAMPERTOGNO",140,32,32,204,"2014","025"
"10580","CAMPIGLIA CERVO",0,0,7,7,"2014","011"
"10581","CAMPIGLIA DEI BERICI",712,140,0,852,"2014","022"
"10582","CAMPIGLIONE-FENILE",706,3,73,782,"2014","049"
"10583","CAMPO SAN MARTINO",87,126,0,213,"2014","020"
"10584","CAMPODARSEGO",601,60,3,664,"2014","017"
"10585","CAMPODORO",62,273,0,335,"2014","018"
"10586","CAMPOGALLIANO",1,482,0,483,"2014","003"
"10587","CAMPOLONGO MAGGIORE",47,70,0,117,"2014","003"
"10588","CAMPOLONGO SUL BRENTA",30,0,0,30,"2014","023"
"10589","CAMPONOGARA",130,55,18,203,"2014","004"
"10590","CAMPOSAMPIERO",235,119,0,354,"2014","019"
"10591","CAMUGNANO",185,135,0,320,"2014","010"
"10592","CANALE",679,0,0,679,"2014","037"
"10593","CANARO",295,28,0,323,"2014","009"
"10594","CANDA",15,0,0,15,"2014","010"
"10595","CANDELO",46,86,66,198,"2014","012"
"10596","CANDIA CANAVESE",30,0,0,30,"2014","050"
"10597","CANDIANA",10313,209,0,10522,"2014","021"
"10598","CANDIOLO",93,534,54,681,"2014","051"
"10599","CANEGRATE",2,0,0,2,"2014","046"
"10600","CANELLI",7,0,0,7,"2014","017"
"10601","CANEVINO",13,0,0,13,"2014","028"
"10602","CANISCHIO",8,0,0,8,"2014","052"
"10603","CANNERO RIVIERA",1,0,0,1,"2014","016"
"10604","CANNETO SULL'OGLIO",1667,1402,1122,4191,"2014","008"
"10605","CANNOBIO",12,0,0,12,"2014","017"
"10606","CANONICA D'ADDA",24,397,0,421,"2014","049"
"10607","CANOSIO",13,0,31,44,"2014","038"
"10608","CANOSSA",30,310,0,340,"2014","018"
"10609","CANTALUPA",103,0,0,103,"2014","053"
"10610","CANTALUPO LIGURE",8,0,0,8,"2014","028"
"10611","CANTARANA",90,0,0,90,"2014","018"
"10612","CANTELLO",94,153,0,247,"2014","030"
"10613","CANTOIRA",59,15,16,90,"2014","054"
"10614","CANTU'",253,215,36,504,"2014","041"
"10615","CANZO",0,0,9,9,"2014","042"
"10616","CAORLE",778,58,0,836,"2014","005"
"10617","CAORSO",6,451,0,457,"2014","010"
"10618","CAPERGNANICA",379,1045,0,1424,"2014","012"
"10619","CAPIAGO INTIMIANO",6,30,1,37,"2014","043"
"10620","CAPIZZONE",11,21,0,32,"2014","050"
"10621","CAPO DI PONTE",25,152,1,178,"2014","035"
"10622","CAPONAGO",78,0,0,78,"2014",NA
"10623","CAPOVALLE",25,9,1,35,"2014","036"
"10624","CAPPELLA CANTONE",0,366,0,366,"2014","013"
"10625","CAPPELLA DE' PICENARDI",24,349,0,373,"2014","014"
"10626","CAPPELLA MAGGIORE",24,21,1,46,"2014","007"
"10627","CAPRALBA",1,1647,1,1649,"2014","015"
"10628","CAPRAUNA",5,0,0,5,"2014","039"
"10629","CAPRIANO DEL COLLE",13,963,0,976,"2014","037"
"10630","CAPRIATA D'ORBA",42,0,0,42,"2014","029"
"10631","CAPRIE",24,0,0,24,"2014","055"
"10632","CAPRIGLIO",3,0,0,3,"2014","019"
"10633","CAPRILE",27,2,0,29,"2014","013"
"10634","CAPRINO BERGAMASCO",22,23,0,45,"2014","052"
"10635","CAPRINO VERONESE",94,759,48,901,"2014","018"
"10636","CAPRIOLO",219,38,49,306,"2014","038"
"10637","CARAGLIO",3146,778,388,4312,"2014","040"
"10638","CARAMAGNA PIEMONTE",1246,646,0,1892,"2014","041"
"10639","CARATE BRIANZA",2,0,0,2,"2014",NA
"10640","CARAVAGGIO",481,2797,54,3332,"2014","053"
"10641","CARAVATE",2,107,0,109,"2014","031"
"10642","CARAVINO",3,0,0,3,"2014","056"
"10643","CARBONARA AL TICINO",0,194,0,194,"2014","030"
"10644","CARBONARA DI PO",0,271,263,534,"2014","009"
"10645","CARBONARA SCRIVIA",45,0,0,45,"2014","030"
"10646","CARBONATE",104,33,15,152,"2014","045"
"10647","CARBONERA",90,389,0,479,"2014","008"
"10648","CARCERI",659,0,0,659,"2014","022"
"10649","CARCOFORO",0,6,0,6,"2014","029"
"10650","CARDANO AL CAMPO",10,0,0,10,"2014","032"
"10651","CARDE'",2646,1787,0,4433,"2014","042"
"10652","CAREMA",81,22,2,105,"2014","057"
"10653","CARENNO",25,0,7,32,"2014","014"
"10654","CARENTINO",102,593,0,695,"2014","031"
"10655","CARESANA",4,0,0,4,"2014","030"
"10656","CAREZZANO",5,0,0,5,"2014","032"
"10657","CARIGNANO",3058,1589,266,4913,"2014","058"
"10658","CARISIO",39,0,0,39,"2014","032"
"10659","CARLAZZO",18,51,26,95,"2014","047"
"10660","CARMAGNOLA",6524,2741,142,9407,"2014","059"
"10661","CARMIGNANO DI BRENTA",220,1621,1,1842,"2014","023"
"10662","CARNAGO",16,44,0,60,"2014","033"
"10663","CAROBBIO DEGLI ANGELI",107,27,0,134,"2014","055"
"10664","CARONNO PERTUSELLA",3,0,0,3,"2014","034"
"10665","CARONNO VARESINO",20,0,0,20,"2014","035"
"10666","CARPANETO PIACENTINO",137,3981,0,4118,"2014","011"
"10667","CARPENEDOLO",1673,3873,2,5548,"2014","039"
"10668","CARPENETO",132,0,0,132,"2014","033"
"10669","CARPI",6,1921,0,1927,"2014","005"
"10670","CARPIANO",133,1391,0,1524,"2014","050"
"10671","CARPIGNANO SESIA",139,5,0,144,"2014","036"
"10672","CARPINETI",118,1436,11,1565,"2014","011"
"10673","CARRE'",396,143,0,539,"2014","024"
"10674","CARREGA LIGURE",51,0,0,51,"2014","034"
"10675","CARROSIO",1,0,0,1,"2014","035"
"10676","CARRU'",756,31,0,787,"2014","043"
"10677","CARTIGLIANO",18,47,0,65,"2014","025"
"10678","CARTIGNANO",205,58,0,263,"2014","044"
"10679","CARTOSIO",48,0,0,48,"2014","036"
"10680","CARTURA",449,29,0,478,"2014","026"
"10681","CARUGATE",0,97,0,97,"2014","051"
"10682","CARUGO",7,0,0,7,"2014","048"
"10683","CARVICO",16,0,0,16,"2014","057"
"10684","CASAL CERMELLI",5,0,0,5,"2014","037"
"10685","CASALBELTRAME",1,0,133,134,"2014","037"
"10686","CASALBORGONE",75,0,0,75,"2014","060"
"10687","CASALBUTTANO ED UNITI",15,1101,0,1116,"2014","016"
"10688","CASALE CORTE CERRO",10,0,0,10,"2014","019"
"10689","CASALE CREMASCO-VIDOLASCO",62,1471,0,1533,"2014","017"
"10690","CASALE DI SCODOSIA",568,0,0,568,"2014","027"
"10691","CASALE LITTA",23,139,9,171,"2014","036"
"10692","CASALE MONFERRATO",138,185,0,323,"2014","039"
"10693","CASALE SUL SILE",128,144,0,272,"2014","009"
"10694","CASALECCHIO DI RENO",1,0,0,1,"2014","011"
"10695","CASALEGGIO BOIRO",13,0,0,13,"2014","038"
"10696","CASALEONE",279,0,0,279,"2014","019"
"10697","CASALETTO CEREDANO",9,21,0,30,"2014","018"
"10698","CASALETTO DI SOPRA",8,328,0,336,"2014","019"
"10699","CASALETTO LODIGIANO",3,362,29,394,"2014","008"
"10700","CASALETTO VAPRIO",104,710,0,814,"2014","020"
"10701","CASALFIUMANESE",375,163,0,538,"2014","012"
"10702","CASALGRANDE",10,1201,0,1211,"2014","012"
"10703","CASALGRASSO",194,452,0,646,"2014","045"
"10704","CASALINO",4,470,0,474,"2014","040"
"10705","CASALMAGGIORE",15,738,0,753,"2014","021"
"10706","CASALMAIOCCO",75,537,0,612,"2014","009"
"10707","CASALMORANO",93,1716,0,1809,"2014","022"
"10708","CASALMORO",863,237,297,1397,"2014","010"
"10709","CASALNOCETO",10,0,0,10,"2014","040"
"10710","CASALOLDO",935,1069,852,2856,"2014","011"
"10711","CASALPUSTERLENGO",96,1175,0,1271,"2014","010"
"10712","CASALROMANO",248,266,199,713,"2014","012"
"10713","CASALSERUGO",110,10,45,165,"2014","028"
"10714","CASALVOLONE",9,62,0,71,"2014","041"
"10715","CASALZUIGNO",4,99,0,103,"2014","037"
"10716","CASARGO",6,8,0,14,"2014","015"
"10717","CASARILE",44,24,0,68,"2014","055"
"10718","CASATENOVO",322,17,0,339,"2014","016"
"10719","CASAZZA",7,10,8,25,"2014","058"
"10720","CASCIAGO",40,25,0,65,"2014","038"
"10721","CASEI GEROLA",568,0,0,568,"2014","033"
"10722","CASELETTE",109,356,25,490,"2014","062"
"10723","CASELLE LANDI",345,484,0,829,"2014","011"
"10724","CASELLE LURANI",115,226,0,341,"2014","012"
"10725","CASELLE TORINESE",264,1310,0,1574,"2014","063"
"10726","CASIER",10,112,0,122,"2014","010"
"10727","CASINA",92,1034,53,1179,"2014","013"
"10728","CASIRATE D'ADDA",183,270,0,453,"2014","059"
"10729","CASLINO D'ERBA",0,12,0,12,"2014","052"
"10730","CASNATE CON BERNATE",67,0,0,67,"2014","053"
"10731","CASNIGO",55,156,0,211,"2014","060"
"10732","CASOLA VALSENIO",160,83,0,243,"2014","005"
"10733","CASORATE PRIMO",21,102,0,123,"2014","034"
"10734","CASORATE SEMPIONE",2,0,0,2,"2014","039"
"10735","CASOREZZO",4,329,0,333,"2014","058"
"10736","CASORZO",1,0,0,1,"2014","020"
"10737","CASPOGGIO",0,36,0,36,"2014","013"
"10738","CASSAGO BRIANZA",4,42,1,47,"2014","017"
"10739","CASSANO D'ADDA",165,225,0,390,"2014","059"
"10740","CASSANO MAGNAGO",29,110,13,152,"2014","040"
"10741","CASSANO SPINOLA",261,0,0,261,"2014","042"
"10742","CASSINA DE' PECCHI",0,470,0,470,"2014","060"
"10743","CASSINA VALSASSINA",5,70,0,75,"2014","018"
"10744","CASSINASCO",45,21,0,66,"2014","021"
"10745","CASSINE",160,0,0,160,"2014","043"
"10746","CASSINELLE",2,0,0,2,"2014","044"
"10747","CASSINETTA DI LUGAGNANO",5,170,0,175,"2014","061"
"10748","CASSOLA",500,23,0,523,"2014","026"
"10749","CASSOLNOVO",31,50,0,81,"2014","035"
"10750","CASTAGNARO",386,0,0,386,"2014","020"
"10751","CASTAGNETO PO",56,0,0,56,"2014","064"
"10752","CASTAGNITO",225,0,0,225,"2014","046"
"10753","CASTAGNOLE DELLE LANZE",256,0,0,256,"2014","022"
"10754","CASTAGNOLE MONFERRATO",69,0,0,69,"2014","023"
"10755","CASTAGNOLE PIEMONTE",1286,999,0,2285,"2014","065"
"10756","CASTANA",1,0,0,1,"2014","036"
"10757","CASTANO PRIMO",74,0,0,74,"2014","062"
"10758","CASTEGGIO",30,0,0,30,"2014","037"
"10759","CASTEGNATO",4,1081,31,1116,"2014","040"
"10760","CASTEGNERO",81,70,1,152,"2014","027"
"10761","CASTEL BOGLIONE",16,0,0,16,"2014","024"
"10762","CASTEL BOLOGNESE",35,0,0,35,"2014","006"
"10763","CASTEL D'AIANO",18,567,23,608,"2014","013"
"10764","CASTEL D'ARIO",0,275,504,779,"2014","014"
"10765","CASTEL D'AZZANO",1410,137,0,1547,"2014","021"
"10766","CASTEL DEL RIO",9,4,0,13,"2014","014"
"10767","CASTEL DI CASIO",68,23,0,91,"2014","015"
"10768","CASTEL GABBIANO",0,1487,0,1487,"2014","024"
"10769","CASTEL GOFFREDO",1895,539,609,3043,"2014","015"
"10770","CASTEL GUELFO DI BOLOGNA",129,266,0,395,"2014","016"
"10771","CASTEL MAGGIORE",4,0,0,4,"2014","019"
"10772","CASTEL MELLA",4,352,0,356,"2014","042"
"10773","CASTEL ROCCHERO",9,0,0,9,"2014","032"
"10774","CASTEL ROZZONE",7,35,0,42,"2014","063"
"10775","CASTEL SAN GIOVANNI",173,975,0,1148,"2014","013"
"10776","CASTEL SAN PIETRO TERME",361,285,0,646,"2014","020"
"10777","CASTELBELFORTE",1183,47,0,1230,"2014","013"
"10778","CASTELCOVATI",16,285,0,301,"2014","041"
"10779","CASTELCUCCO",42,212,0,254,"2014","011"
"10780","CASTELDELCI",149,0,0,149,"2014","021"
"10781","CASTELDELFINO",55,0,0,55,"2014","047"
"10782","CASTELDIDONE",63,0,0,63,"2014","023"
"10783","CASTELFRANCO EMILIA",953,2426,0,3379,"2014","006"
"10784","CASTELFRANCO VENETO",4855,188,5,5048,"2014","012"
"10785","CASTELGOMBERTO",426,472,0,898,"2014","028"
"10786","CASTELGUGLIELMO",471,0,0,471,"2014","011"
"10787","CASTELL'ALFERO",387,0,0,387,"2014","025"
"10788","CASTELL'ARQUATO",72,749,0,821,"2014","012"
"10789","CASTELLAMONTE",363,301,0,664,"2014","066"
"10790","CASTELLAR",9,0,0,9,"2014","048"
"10791","CASTELLARANO",18,310,0,328,"2014","014"
"10792","CASTELLAZZO BORMIDA",119,26,0,145,"2014","047"
"10793","CASTELLAZZO NOVARESE",4,0,0,4,"2014","042"
"10794","CASTELLEONE",536,3562,16,4114,"2014","025"
"10795","CASTELLERO",1,0,0,1,"2014","026"
"10796","CASTELLETTO CERVO",21,0,0,21,"2014","015"
"10797","CASTELLETTO D'ERRO",1,0,0,1,"2014",NA
"10798","CASTELLETTO D'ORBA",13,0,0,13,"2014","049"
"10799","CASTELLETTO DI BRANDUZZO",10,0,0,10,"2014","038"
"10800","CASTELLETTO MERLI",76,0,0,76,"2014","050"
"10801","CASTELLETTO MONFERRATO",146,0,0,146,"2014","051"
"10802","CASTELLETTO SOPRA TICINO",121,55,0,176,"2014","043"
"10803","CASTELLETTO STURA",1271,49,89,1409,"2014","049"
"10804","CASTELLETTO UZZONE",27,0,0,27,"2014","050"
"10805","CASTELLI CALEPIO",43,318,0,361,"2014","062"
"10806","CASTELLINALDO",793,0,0,793,"2014","051"
"10807","CASTELLINO TANARO",137,0,0,137,"2014","052"
"10808","CASTELLO CABIAGLIO",15,0,0,15,"2014","043"
"10809","CASTELLO D'ARGILE",46,71,0,117,"2014","017"
"10810","CASTELLO DELL'ACQUA",10,16,0,26,"2014","014"
"10811","CASTELLO DI ANNONE",159,0,0,159,"2014","028"
"10812","CASTELLO DI BRIANZA",12,0,0,12,"2014","019"
"10813","CASTELLO DI GODEGO",5216,159,18,5393,"2014","013"
"10814","CASTELLUCCHIO",976,1559,1395,3930,"2014","016"
"10815","CASTELMAGNO",62,37,3,102,"2014","053"
"10816","CASTELMARTE",11,0,0,11,"2014","058"
"10817","CASTELMASSA",4,125,0,129,"2014","012"
"10818","CASTELNOVETTO",2,0,0,2,"2014","040"
"10819","CASTELNOVO BARIANO",1596,46,0,1642,"2014","013"
"10820","CASTELNOVO DI SOTTO",9,1120,13,1142,"2014","015"
"10821","CASTELNOVO NE' MONTI",73,1330,25,1428,"2014","016"
"10822","CASTELNUOVO BELBO",9,0,0,9,"2014","029"
"10823","CASTELNUOVO BOCCA D'ADDA",3035,117,0,3152,"2014","013"
"10824","CASTELNUOVO BORMIDA",20,0,0,20,"2014","052"
"10825","CASTELNUOVO BOZZENTE",7,20,0,27,"2014","059"
"10826","CASTELNUOVO CALCEA",1,0,0,1,"2014","030"
"10827","CASTELNUOVO DEL GARDA",2969,272,0,3241,"2014","022"
"10828","CASTELNUOVO DON BOSCO",200,0,0,200,"2014","031"
"10829","CASTELNUOVO NIGRA",39,0,2,41,"2014","067"
"10830","CASTELNUOVO RANGONE",0,803,0,803,"2014","007"
"10831","CASTELNUOVO SCRIVIA",184,0,22,206,"2014","053"
"10832","CASTELSEPRIO",3,0,1,4,"2014","044"
"10833","CASTELSPINA",9,0,0,9,"2014","054"
"10834","CASTELVECCANA",8,0,3,11,"2014","045"
"10835","CASTELVERDE",354,3079,76,3509,"2014","026"
"10836","CASTELVETRO DI MODENA",31,1332,0,1363,"2014","008"
"10837","CASTELVETRO PIACENTINO",610,882,0,1492,"2014","014"
"10838","CASTELVISCONTI",9,1577,0,1586,"2014","027"
"10839","CASTENASO",63,238,0,301,"2014","021"
"10840","CASTENEDOLO",856,1379,0,2235,"2014","043"
"10841","CASTIGLIONE D'ADDA",5,463,0,468,"2014","014"
"10842","CASTIGLIONE D'INTELVI",4,20,2,26,"2014","060"
"10843","CASTIGLIONE DEI PEPOLI",95,73,0,168,"2014","022"
"10844","CASTIGLIONE DELLE STIVIERE",3504,1503,1378,6385,"2014","017"
"10845","CASTIGLIONE FALLETTO",25,0,0,25,"2014","055"
"10846","CASTIGLIONE OLONA",3,13,9,25,"2014","046"
"10847","CASTIGLIONE TINELLA",31,0,0,31,"2014","056"
"10848","CASTIGLIONE TORINESE",15,0,0,15,"2014","068"
"10849","CASTINO",179,0,0,179,"2014","057"
"10850","CASTIONE ANDEVENNO",22,40,2,64,"2014","015"
"10851","CASTIONE DELLA PRESOLANA",25,8,0,33,"2014","064"
"10852","CASTIRAGA VIDARDO",6,278,0,284,"2014","015"
"10853","CASTO",26,21,2,49,"2014","044"
"10854","CASTREZZATO",372,1196,0,1568,"2014","045"
"10855","CASTRO",2,0,0,2,"2014","065"
"10856","CASTROCARO TERME E TERRA DEL SOLE",14,6,1,21,"2014","005"
"10857","CASTRONNO",1,0,0,1,"2014","047"
"10858","CAVA MANARA",2,0,3,5,"2014","041"
"10859","CAVACURTA",40,431,0,471,"2014","016"
"10860","CAVAGLIA'",1243,190,15,1448,"2014","016"
"10861","CAVAGLIETTO",0,180,0,180,"2014","044"
"10862","CAVAGNOLO",29,0,0,29,"2014","069"
"10863","CAVAION VERONESE",7,0,0,7,"2014","023"
"10864","CAVALLASCA",0,0,13,13,"2014","061"
"10865","CAVALLERLEONE",422,1018,75,1515,"2014","058"
"10866","CAVALLERMAGGIORE",2266,2235,38,4539,"2014","059"
"10867","CAVALLINO-TREPORTI",29,0,0,29,"2014","044"
"10868","CAVARGNA",0,0,10,10,"2014","062"
"10869","CAVARIA CON PREMEZZO",3,0,4,7,"2014","048"
"10870","CAVARZERE",5724,6,0,5730,"2014","006"
"10871","CAVASO DEL TOMBA",98,94,0,192,"2014","014"
"10872","CAVATORE",3,0,0,3,"2014","055"
"10873","CAVENAGO D'ADDA",6,837,156,999,"2014","017"
"10874","CAVERNAGO",2,0,0,2,"2014","066"
"10875","CAVEZZO",0,314,0,314,"2014","009"
"10876","CAVOUR",2952,270,1043,4265,"2014","070"
"10877","CAVRIAGO",9,634,0,643,"2014","017"
"10878","CAVRIANA",1774,1754,433,3961,"2014","018"
"10879","CAZZAGO SAN MARTINO",3180,238,149,3567,"2014","046"
"10880","CAZZANO DI TRAMIGNA",12,0,0,12,"2014","024"
"10881","CAZZANO SANT'ANDREA",303,0,0,303,"2014","067"
"10882","CECIMA",19,0,0,19,"2014","042"
"10883","CEDEGOLO",2,22,5,29,"2014","047"
"10884","CEDRASCO",0,53,0,53,"2014","016"
"10885","CEGGIA",10,2,0,12,"2014","007"
"10886","CELLA DATI",13,203,30,246,"2014","028"
"10887","CELLA MONTE",178,0,0,178,"2014","056"
"10888","CELLARENGO",339,95,117,551,"2014","033"
"10889","CELLATICA",4,47,0,51,"2014","048"
"10890","CELLE DI MACRA",95,6,0,101,"2014","060"
"10891","CELLE ENOMONDO",197,0,0,197,"2014","034"
"10892","CELLIO",8,0,0,8,"2014","038"
"10893","CENATE SOPRA",9,0,5,14,"2014","068"
"10894","CENATE SOTTO",30,0,0,30,"2014","069"
"10895","CENCENIGHE AGORDINO",0,5,0,5,"2014","010"
"10896","CENE",20,56,0,76,"2014","070"
"10897","CENESELLI",0,221,13,234,"2014","014"
"10898","CENTALLO",5282,575,338,6195,"2014","061"
"10899","CEPPO MORELLI",15,0,0,15,"2014","021"
"10900","CERANO",93,0,0,93,"2014","049"
"10901","CERANO D'INTELVI",11,0,21,32,"2014","063"
"10902","CERANOVA",0,676,0,676,"2014","043"
"10903","CERCENASCO",157,207,0,364,"2014","071"
"10904","CERCINO",27,45,0,72,"2014","017"
"10905","CEREA",1455,210,0,1665,"2014","025"
"10906","CEREGNANO",4,0,0,4,"2014","015"
"10907","CERES",8,0,0,8,"2014","072"
"10908","CERESARA",1350,435,93,1878,"2014","019"
"10909","CERESETO",95,0,0,95,"2014","057"
"10910","CERESOLE ALBA",3269,658,0,3927,"2014","062"
"10911","CERESOLE REALE",0,30,0,30,"2014","073"
"10912","CERETE",14,167,0,181,"2014","071"
"10913","CERIANO LAGHETTO",0,43,0,43,"2014",NA
"10914","CERIGNALE",25,0,0,25,"2014","015"
"10915","CERMENATE",1,212,5,218,"2014","064"
"10916","CERNOBBIO",1,0,0,1,"2014",NA
"10917","CERNUSCO LOMBARDONE",6,0,0,6,"2014","020"
"10918","CERNUSCO SUL NAVIGLIO",2,151,0,153,"2014","070"
"10919","CERRETO CASTELLO",22,59,0,81,"2014","017"
"10920","CERRETO D'ASTI",3,0,0,3,"2014","035"
"10921","CERRETO GRUE",22,0,0,22,"2014","058"
"10922","CERRETTO LANGHE",20,0,0,20,"2014","063"
"10923","CERRINA MONFERRATO",34,0,0,34,"2014","059"
"10924","CERRIONE",84,362,0,446,"2014","018"
"10925","CERRO AL LAMBRO",1,739,0,740,"2014","071"
"10926","CERRO MAGGIORE",6,73,0,79,"2014","072"
"10927","CERRO TANARO",234,0,0,234,"2014","036"
"10928","CERRO VERONESE",5,134,0,139,"2014","026"
"10929","CERTOSA DI PAVIA",19,0,0,19,"2014","046"
"10930","CERVARESE SANTA CROCE",32,144,89,265,"2014","030"
"10931","CERVASCA",875,291,35,1201,"2014","064"
"10932","CERVATTO",9,0,0,9,"2014",NA
"10933","CERVENO",5,20,0,25,"2014","049"
"10934","CERVERE",1606,248,176,2030,"2014","065"
"10935","CERVIA",6,0,0,6,"2014","007"
"10936","CERVIGNANO D'ADDA",0,855,0,855,"2014","018"
"10937","CESANA BRIANZA",5,27,0,32,"2014","021"
"10938","CESANA TORINESE",23,0,27,50,"2014","074"
"10939","CESANO BOSCONE",0,84,0,84,"2014","074"
"10940","CESANO MADERNO",1,0,0,1,"2014",NA
"10941","CESARA",5,0,0,5,"2014","022"
"10942","CESENA",97,23,0,120,"2014","007"
"10943","CESENATICO",7,96,0,103,"2014","008"
"10944","CESIOMAGGIORE",291,99,0,390,"2014","011"
"10945","CESSALTO",39,114,22,175,"2014","015"
"10946","CESSOLE",165,0,0,165,"2014","037"
"10947","CETO",8,45,1,54,"2014","050"
"10948","CEVA",879,0,0,879,"2014","066"
"10949","CEVO",32,6,0,38,"2014","051"
"10950","CHERASCO",4435,1009,0,5444,"2014","067"
"10951","CHIALAMBERTO",22,53,0,75,"2014","075"
"10952","CHIAMPO",44,91,0,135,"2014","029"
"10953","CHIANOCCO",95,0,0,95,"2014","076"
"10954","CHIARANO",17,527,0,544,"2014","016"
"10955","CHIARI",1231,5053,133,6417,"2014","052"
"10956","CHIAVENNA",5,23,0,28,"2014","018"
"10957","CHIAVERANO",35,0,0,35,"2014","077"
"10958","CHIERI",2716,451,64,3231,"2014","078"
"10959","CHIES D'ALPAGO",19,0,0,19,"2014","012"
"10960","CHIESA IN VALMALENCO",16,60,0,76,"2014","019"
"10961","CHIESANUOVA",39,85,0,124,"2014","079"
"10962","CHIEVE",114,946,0,1060,"2014","029"
"10963","CHIGNOLO D'ISOLA",65,294,0,359,"2014","072"
"10964","CHIGNOLO PO",20,81,0,101,"2014","048"
"10965","CHIOGGIA",2434,0,0,2434,"2014","008"
"10966","CHIOMONTE",2,18,0,20,"2014","080"
"10967","CHIUDUNO",55,2,0,57,"2014","073"
"10968","CHIUPPANO",17,36,0,53,"2014","030"
"10969","CHIURO",0,92,0,92,"2014","020"
"10970","CHIUSA DI PESIO",1408,299,250,1957,"2014","068"
"10971","CHIUSA DI SAN MICHELE",0,0,56,56,"2014","081"
"10972","CHIUSANO D'ASTI",36,0,0,36,"2014","038"
"10973","CHIVASSO",1357,275,0,1632,"2014","082"
"10974","CICOGNOLO",0,749,0,749,"2014","030"
"10975","CICONIO",85,89,0,174,"2014","083"
"10976","CIGLIANO",295,73,32,400,"2014","042"
"10977","CIGLIE'",467,0,0,467,"2014","069"
"10978","CIGOGNOLA",1,0,0,1,"2014","049"
"10979","CIGOLE",1026,1140,0,2166,"2014","053"
"10980","CILAVEGNA",16,31,0,47,"2014","050"
"10981","CIMADOLMO",19,130,0,149,"2014","017"
"10982","CIMBERGO",2,0,0,2,"2014","054"
"10983","CINAGLIO",674,0,0,674,"2014","039"
"10984","CINGIA DE' BOTTI",0,895,0,895,"2014","031"
"10985","CINO",4,8,0,12,"2014","021"
"10986","CINTANO",24,3,0,27,"2014","084"
"10987","CINTO CAOMAGGIORE",463,9,27,499,"2014","009"
"10988","CINTO EUGANEO",95,33,0,128,"2014","031"
"10989","CINZANO",14,0,0,14,"2014","085"
"10990","CIRIE'",292,318,0,610,"2014","086"
"10991","CIRIMIDO",2,36,0,38,"2014","068"
"10992","CISANO BERGAMASCO",21,0,0,21,"2014","074"
"10993","CISERANO",16,49,4,69,"2014","075"
"10994","CISLAGO",7,0,0,7,"2014","050"
"10995","CISLIANO",189,450,0,639,"2014","078"
"10996","CISMON DEL GRAPPA",2,27,0,29,"2014","031"
"10997","CISON DI VALMARINO",84,47,0,131,"2014","018"
"10998","CISSONE",7,0,0,7,"2014","070"
"10999","CISTERNA D'ASTI",68,0,0,68,"2014","040"
"11000","CITTADELLA",2326,1173,100,3599,"2014","032"
"11001","CITTIGLIO",13,17,0,30,"2014","051"
"11002","CIVATE",11,0,0,11,"2014","022"
"11003","CIVIASCO",3,5,0,8,"2014","043"
"11004","CIVIDATE AL PIANO",697,629,0,1326,"2014","076"
"11005","CIVIDATE CAMUNO",6,0,0,6,"2014","055"
"11006","CIVITELLA DI ROMAGNA",381,0,14,395,"2014","009"
"11007","CIVO",4,36,0,40,"2014","022"
"11008","CLAINO CON OSTENO",1,0,6,7,"2014","071"
"11009","CLAVESANA",380,0,0,380,"2014","071"
"11010","CLIVIO",23,47,0,70,"2014","052"
"11011","CLUSONE",65,213,0,278,"2014","077"
"11012","COASSOLO TORINESE",37,38,1,76,"2014","088"
"11013","COAZZE",18,0,14,32,"2014","089"
"11014","COAZZOLO",37,0,0,37,"2014","041"
"11015","COCCAGLIO",377,750,10,1137,"2014","056"
"11016","COCCONATO",116,0,0,116,"2014","042"
"11017","COCQUIO-TREVISAGO",30,0,0,30,"2014","053"
"11018","CODEVIGO",485,142,6,633,"2014","033"
"11019","CODEVILLA",2,0,0,2,"2014","051"
"11020","CODIGORO",4123,214,0,4337,"2014","005"
"11021","CODOGNE'",58,209,2,269,"2014","019"
"11022","CODOGNO",32,868,0,900,"2014","019"
"11023","COGGIOLA",5,0,0,5,"2014","019"
"11024","COGLIATE",81,0,0,81,"2014",NA
"11025","COGOLLO DEL CENGIO",349,122,0,471,"2014","032"
"11026","COLERE",5,0,0,5,"2014","078"
"11027","COLI",45,0,0,45,"2014","016"
"11028","COLICO",94,128,52,274,"2014","023"
"11029","COLLAGNA",7,60,0,67,"2014","019"
"11030","COLLE BRIANZA",15,0,1,16,"2014","024"
"11031","COLLE SANTA LUCIA",0,20,0,20,"2014","014"
"11032","COLLE UMBERTO",35,185,0,220,"2014","020"
"11033","COLLECCHIO",12,2547,0,2559,"2014","009"
"11034","COLLEGNO",105,285,4,394,"2014","090"
"11035","COLLERETTO CASTELNUOVO",4,36,0,40,"2014","091"
"11036","COLLERETTO GIACOSA",22,0,0,22,"2014","092"
"11037","COLLIO",52,85,1,138,"2014","058"
"11038","COLLOBIANO",2,0,0,2,"2014",NA
"11039","COLOGNA VENETA",9036,198,0,9234,"2014","027"
"11040","COLOGNE",411,529,10,950,"2014","059"
"11041","COLOGNO AL SERIO",53,929,10,992,"2014","079"
"11042","COLOGNO MONZESE",6,0,0,6,"2014","081"
"11043","COLOGNOLA AI COLLI",7,0,0,7,"2014","028"
"11044","COLORINA",39,412,0,451,"2014","023"
"11045","COLORNO",5,1675,0,1680,"2014","010"
"11046","COLTURANO",0,68,0,68,"2014","082"
"11047","COLVERDE",30,92,14,136,"2014",NA
"11048","COLZATE",15,12,0,27,"2014","080"
"11049","COMACCHIO",667,188,0,855,"2014","006"
"11050","COMAZZO",44,776,11,831,"2014","020"
"11051","COMELICO SUPERIORE",23,149,0,172,"2014","015"
"11052","COMERIO",4,0,0,4,"2014","055"
"11053","COMEZZANO-CIZZAGO",153,1787,0,1940,"2014","060"
"11054","COMMESSAGGIO",4,13,17,34,"2014","020"
"11055","COMO",8,59,8,75,"2014","075"
"11056","COMPIANO",6,17,0,23,"2014","011"
"11057","COMUN NUOVO",56,31,0,87,"2014","081"
"11058","CONA",11567,0,0,11567,"2014","010"
"11059","CONCAMARISE",1,248,0,249,"2014","029"
"11060","CONCESIO",20,19,0,39,"2014","061"
"11061","CONCO",40,291,8,339,"2014","033"
"11062","CONCORDIA SAGITTARIA",1099,0,0,1099,"2014","011"
"11063","CONCORDIA SULLA SECCHIA",20,389,0,409,"2014","010"
"11064","CONCOREZZO",11,28,0,39,"2014",NA
"11065","CONDOVE",131,23,46,200,"2014","093"
"11066","CONEGLIANO",42,109,11,162,"2014","021"
"11067","CONFIENZA",35,17,47,99,"2014","052"
"11068","CONIOLO",183,0,0,183,"2014","060"
"11069","CONSELICE",498,215,0,713,"2014","008"
"11070","CONSELVE",1078,40,0,1118,"2014","034"
"11071","CONZANO",144,0,0,144,"2014","061"
"11072","COPPARO",67,0,0,67,"2014","007"
"11073","CORBETTA",1032,56,0,1088,"2014","085"
"11074","CORBOLA",18,165,0,183,"2014","017"
"11075","CORDIGNANO",100,336,0,436,"2014","022"
"11076","CORIANO",41,236,0,277,"2014","003"
"11077","CORIO",147,24,0,171,"2014","094"
"11078","CORNA IMAGNA",24,44,0,68,"2014","082"
"11079","CORNALBA",2,7,0,9,"2014","249"
"11080","CORNAREDO",25,178,6,209,"2014","087"
"11081","CORNATE D'ADDA",25,87,0,112,"2014",NA
"11082","CORNEDO VICENTINO",7,168,0,175,"2014","034"
"11083","CORNEGLIANO LAUDENSE",0,235,0,235,"2014","021"
"11084","CORNELIANO D'ALBA",141,0,0,141,"2014","072"
"11085","CORNIGLIO",29,464,0,493,"2014","012"
"11086","CORNO GIOVINE",144,72,0,216,"2014","022"
"11087","CORNOVECCHIO",133,0,0,133,"2014","023"
"11088","CORNUDA",958,379,0,1337,"2014","023"
"11089","CORREGGIO",3,1791,0,1794,"2014","020"
"11090","CORREZZANA",18,52,0,70,"2014",NA
"11091","CORREZZOLA",4733,21,0,4754,"2014","035"
"11092","CORRIDO",20,5,3,28,"2014","077"
"11093","CORSIONE",8,0,0,8,"2014","044"
"11094","CORTANZE",72,0,0,72,"2014","046"
"11095","CORTAZZONE",8,0,0,8,"2014","047"
"11096","CORTE BRUGNATELLA",91,13,0,104,"2014","017"
"11097","CORTE DE' CORTESI CON CIGNONE",5,110,168,283,"2014","032"
"11098","CORTE DE' FRATI",20,869,0,889,"2014","033"
"11099","CORTE FRANCA",90,86,0,176,"2014","062"
"11100","CORTE PALASIO",7,1659,11,1677,"2014","024"
"11101","CORTEMAGGIORE",193,1655,0,1848,"2014","018"
"11102","CORTEMILIA",254,0,0,254,"2014","073"
"11103","CORTENO GOLGI",12,104,5,121,"2014","063"
"11104","CORTENOVA",6,32,0,38,"2014","025"
"11105","CORTENUOVA",177,1358,0,1535,"2014","083"
"11106","CORTEOLONA",8,0,0,8,"2014","056"
"11107","CORTIGLIONE",2,0,0,2,"2014","048"
"11108","CORTINA D'AMPEZZO",43,44,0,87,"2014","016"
"11109","CORVINO SAN QUIRICO",3,0,0,3,"2014","057"
"11110","CORZANO",110,232,0,342,"2014","064"
"11111","COSIO VALTELLINO",26,721,0,747,"2014","024"
"11112","COSSANO BELBO",425,0,0,425,"2014","074"
"11113","COSSATO",263,133,0,396,"2014","020"
"11114","COSSOGNO",2,0,0,2,"2014","023"
"11115","COSTA DE' NOBILI",88,28,3,119,"2014","058"
"11116","COSTA DI MEZZATE",10,0,0,10,"2014","084"
"11117","COSTA DI ROVIGO",2,297,0,299,"2014","018"
"11118","COSTA MASNAGA",17,8,0,25,"2014","026"
"11119","COSTA SERINA",15,4,0,19,"2014","247"
"11120","COSTA VALLE IMAGNA",5,0,0,5,"2014","085"
"11121","COSTA VESCOVATO",0,0,3,3,"2014","062"
"11122","COSTA VOLPINO",24,29,0,53,"2014","086"
"11123","COSTABISSARA",43,54,0,97,"2014","035"
"11124","COSTERMANO",21,29,0,50,"2014","030"
"11125","COSTIGLIOLE D'ASTI",497,0,0,497,"2014","050"
"11126","COSTIGLIOLE SALUZZO",506,76,0,582,"2014","075"
"11127","COTIGNOLA",81,0,0,81,"2014","009"
"11128","COVO",947,1298,0,2245,"2014","087"
"11129","CRANDOLA VALSASSINA",5,1,0,6,"2014","027"
"11130","CRAVAGLIANA",4,14,0,18,"2014","048"
"11131","CRAVANZANA",2,0,0,2,"2014","076"
"11132","CRAVEGGIA",20,0,0,20,"2014","024"
"11133","CREAZZO",7,21,0,28,"2014","036"
"11134","CREDARO",5,167,0,172,"2014","088"
"11135","CREDERA RUBBIANO",1,1437,98,1536,"2014","034"
"11136","CREMA",491,2162,137,2790,"2014","035"
"11137","CREMELLA",7,0,0,7,"2014","028"
"11138","CREMENO",1,31,42,74,"2014","029"
"11139","CREMIA",5,6,4,15,"2014","083"
"11140","CREMOLINO",91,0,0,91,"2014","063"
"11141","CREMONA",94,1815,0,1909,"2014","036"
"11142","CREMOSANO",18,523,45,586,"2014","037"
"11143","CRESCENTINO",81,0,29,110,"2014","049"
"11144","CRESPADORO",44,73,0,117,"2014","037"
"11145","CRESPANO DEL GRAPPA",1407,727,0,2134,"2014","024"
"11146","CRESPIATICA",0,409,0,409,"2014","025"
"11147","CRESPINO",2034,0,0,2034,"2014","019"
"11148","CRESSA",28,209,0,237,"2014","055"
"11149","CREVACUORE",5,0,0,5,"2014","021"
"11150","CREVALCORE",411,28,0,439,"2014","024"
"11151","CREVOLADOSSOLA",86,54,0,140,"2014","025"
"11152","CRISSOLO",0,15,0,15,"2014",NA
"11153","CROCETTA DEL MONTELLO",71,58,5,134,"2014","025"
"11154","CRODO",28,117,11,156,"2014","026"
"11155","CROSIO DELLA VALLE",1,0,0,1,"2014","057"
"11156","CROTTA D'ADDA",4,505,0,509,"2014","038"
"11157","CROVA",3,0,0,3,"2014","052"
"11158","CUASSO AL MONTE",17,0,0,17,"2014","058"
"11159","CUCCARO MONFERRATO",20,0,0,20,"2014","064"
"11160","CUCCIAGO",4,0,0,4,"2014","084"
"11161","CUCEGLIO",49,0,0,49,"2014","096"
"11162","CUGGIONO",461,42,0,503,"2014","096"
"11163","CUMIANA",1327,569,63,1959,"2014","097"
"11164","CUMIGNANO SUL NAVIGLIO",0,1366,0,1366,"2014","039"
"11165","CUNARDO",4,0,0,4,"2014","060"
"11166","CUNEO",8048,597,1694,10339,"2014","078"
"11167","CUNICO",1647,0,0,1647,"2014","051"
"11168","CUORGNE'",143,95,0,238,"2014","098"
"11169","CURA CARPIGNANO",63,135,3,201,"2014","060"
"11170","CUREGGIO",24,41,3,68,"2014","058"
"11171","CURIGLIA CON MONTEVIASCO",1,2,2,5,"2014","061"
"11172","CURINO",7,0,0,7,"2014","023"
"11173","CURNO",53,91,0,144,"2014","089"
"11174","CURSOLO-ORASSO",16,0,0,16,"2014","027"
"11175","CURTAROLO",141,180,0,321,"2014","036"
"11176","CURTATONE",3671,1201,1527,6399,"2014","021"
"11177","CUSAGO",121,333,1,455,"2014","097"
"11178","CUSINO",4,0,6,10,"2014","085"
"11179","CUSIO",1,0,0,1,"2014","090"
"11180","CUVEGLIO",4,0,0,4,"2014","062"
"11181","CUVIO",4,80,0,84,"2014","063"
"11182","DAIRAGO",21,38,0,59,"2014","099"
"11183","DALMINE",114,119,0,233,"2014","091"
"11184","DARFO BOARIO TERME",9,297,8,314,"2014","065"
"11185","DAVERIO",2,0,0,2,"2014","064"
"11186","DAZIO",0,15,0,15,"2014","025"
"11187","DELEBIO",45,182,0,227,"2014","026"
"11188","DELLO",693,1722,7,2422,"2014","066"
"11189","DEMONTE",707,132,2,841,"2014","079"
"11190","DENICE",6,0,0,6,"2014","065"
"11191","DERNICE",3,2,0,5,"2014","066"
"11192","DEROVERE",17,184,0,201,"2014","040"
"11193","DESANA",52,0,0,52,"2014","054"
"11194","DESENZANO DEL GARDA",182,1626,317,2125,"2014","067"
"11195","DESIO",24,0,0,24,"2014",NA
"11196","DIANO D'ALBA",124,0,0,124,"2014","080"
"11197","DIVIGNANO",65,0,0,65,"2014","060"
"11198","DIZZASCO",0,0,3,3,"2014","087"
"11199","DOGLIANI",1746,0,0,1746,"2014","081"
"11200","DOLO",411,239,0,650,"2014","012"
"11201","DOMASO",6,4,2,12,"2014","089"
"11202","DOMEGGE DI CADORE",1,2,0,3,"2014","018"
"11203","DOMODOSSOLA",35,15,9,59,"2014","028"
"11204","DONATO",158,0,35,193,"2014","024"
"11205","DONGO",9,9,1,19,"2014","090"
"11206","DORIO",7,0,0,7,"2014","032"
"11207","DORMELLETTO",3,0,0,3,"2014","062"
"11208","DORNO",5,129,0,134,"2014","061"
"11209","DOSOLO",27,335,153,515,"2014","022"
"11210","DOSSENA",20,65,0,85,"2014","092"
"11211","DOSSO DEL LIRO",1,5,3,9,"2014","092"
"11212","DOVADOLA",125,0,0,125,"2014","011"
"11213","DOVERA",30,1215,0,1245,"2014","041"
"11214","DOZZA",3,31,0,34,"2014","025"
"11215","DRESANO",4,0,0,4,"2014","101"
"11216","DRIZZONA",3,479,0,482,"2014","042"
"11217","DRONERO",1807,281,33,2121,"2014","082"
"11218","DRUENTO",806,41,78,925,"2014","099"
"11219","DRUOGNO",16,4,0,20,"2014","029"
"11220","DUBINO",27,663,2,692,"2014","027"
"11221","DUE CARRARE",152,0,0,152,"2014","106"
"11222","DUEVILLE",441,709,0,1150,"2014","038"
"11223","DUMENZA",3,0,6,9,"2014","065"
"11224","DUSINO SAN MICHELE",379,43,0,422,"2014","052"
"11225","EDOLO",10,60,3,73,"2014","068"
"11226","ELLO",2,0,0,2,"2014","033"
"11227","ELVA",11,0,7,18,"2014","083"
"11228","ENDINE GAIANO",53,108,0,161,"2014","093"
"11229","ENEGO",25,236,6,267,"2014","039"
"11230","ENTRACQUE",101,0,0,101,"2014","084"
"11231","ENTRATICO",52,10,0,62,"2014","094"
"11232","ENVIE",1695,572,64,2331,"2014","085"
"11233","ERACLEA",3835,256,0,4091,"2014","013"
"11234","ERBA",48,356,1,405,"2014","095"
"11235","ERBE'",204,35,0,239,"2014","032"
"11236","ERBEZZO",42,701,0,743,"2014","033"
"11237","ERBUSCO",194,57,0,251,"2014","069"
"11238","ERVE",4,0,0,4,"2014","034"
"11239","ESINE",1,192,7,200,"2014","070"
"11240","ESINO LARIO",15,0,0,15,"2014","035"
"11241","ESTE",845,68,0,913,"2014","037"
"11242","EUPILIO",19,44,9,72,"2014","097"
"11243","EXILLES",2,0,0,2,"2014",NA
"11244","FABBRICA CURONE",13,23,0,36,"2014","067"
"11245","FABBRICO",2,293,0,295,"2014","021"
"11246","FAEDO VALTELLINO",4,16,0,20,"2014","028"
"11247","FAENZA",259,113,0,372,"2014","010"
"11248","FAGGETO LARIO",5,0,2,7,"2014","098"
"11249","FAGNANO OLONA",16,91,0,107,"2014","067"
"11250","FALCADE",8,22,0,30,"2014","019"
"11251","FALOPPIO",12,0,3,15,"2014","099"
"11252","FANANO",76,418,0,494,"2014","011"
"11253","FARA GERA D'ADDA",114,608,0,722,"2014","096"
"11254","FARA NOVARESE",6,0,0,6,"2014","065"
"11255","FARA OLIVANA CON SOLA",180,307,0,487,"2014","097"
"11256","FARA VICENTINO",757,520,147,1424,"2014","040"
"11257","FARIGLIANO",540,0,0,540,"2014","086"
"11258","FARINI",92,114,0,206,"2014","019"
"11259","FARRA D'ALPAGO",7,130,0,137,"2014","020"
"11260","FARRA DI SOLIGO",85,45,0,130,"2014","026"
"11261","FAULE",32,77,22,131,"2014","087"
"11262","FAVRIA",328,615,0,943,"2014","101"
"11263","FEISOGLIO",78,0,0,78,"2014","088"
"11264","FELETTO",37,18,0,55,"2014","102"
"11265","FELINO",18,1150,0,1168,"2014","013"
"11266","FELIZZANO",41,0,0,41,"2014","068"
"11267","FELTRE",174,1245,0,1419,"2014","021"
"11268","FENEGRO'",41,6,24,71,"2014","100"
"11269","FENESTRELLE",19,0,0,19,"2014","103"
"11270","FERNO",1,59,0,60,"2014","068"
"11271","FERRARA",337,220,0,557,"2014","008"
"11272","FERRARA DI MONTE BALDO",0,37,18,55,"2014","034"
"11273","FERRERA DI VARESE",5,0,0,5,"2014","069"
"11274","FERRERA ERBOGNONE",53,0,0,53,"2014","062"
"11275","FERRERE",873,0,0,873,"2014","053"
"11276","FERRIERE",133,4,0,137,"2014","020"
"11277","FIANO",9,0,0,9,"2014","104"
"11278","FICAROLO",28,0,0,28,"2014","021"
"11279","FIDENZA",590,3558,12,4160,"2014","014"
"11280","FIESCO",13,541,0,554,"2014","043"
"11281","FIESSE",761,438,215,1414,"2014","071"
"11282","FIESSO D'ARTICO",16,35,0,51,"2014","014"
"11283","FIESSO UMBERTIANO",123,33,0,156,"2014","022"
"11284","FIGINO SERENZA",36,93,0,129,"2014","101"
"11285","FILAGO",41,0,0,41,"2014","098"
"11286","FILIGHERA",1,159,0,160,"2014","063"
"11287","FINALE EMILIA",37,76,0,113,"2014","012"
"11288","FINO DEL MONTE",2,18,0,20,"2014","099"
"11289","FINO MORNASCO",13,0,0,13,"2014","102"
"11290","FIORANO AL SERIO",5,19,0,24,"2014","100"
"11291","FIORANO CANAVESE",10,0,0,10,"2014","105"
"11292","FIORANO MODENESE",22,70,0,92,"2014","013"
"11293","FIORENZUOLA D'ARDA",33,2045,0,2078,"2014","021"
"11294","FISCAGLIA",2328,92,0,2420,"2014",NA
"11295","FIUMALBO",114,101,0,215,"2014","014"
"11296","FLERO",216,369,0,585,"2014","072"
"11297","FOBELLO",11,0,1,12,"2014","057"
"11298","FOGLIZZO",165,0,0,165,"2014","106"
"11299","FOLLINA",371,100,0,471,"2014","027"
"11300","FOMBIO",235,239,25,499,"2014","026"
"11301","FONTANELICE",235,152,0,387,"2014","026"
"11302","FONTANELLA",3105,2361,0,5466,"2014","101"
"11303","FONTANELLATO",79,2404,0,2483,"2014","015"
"11304","FONTANELLE",70,752,13,835,"2014","028"
"11305","FONTANETO D'AGOGNA",13,47,0,60,"2014","066"
"11306","FONTANETTO PO",5,0,0,5,"2014","058"
"11307","FONTANILE",3,0,0,3,"2014","054"
"11308","FONTANIVA",294,348,0,642,"2014","038"
"11309","FONTE",868,625,0,1493,"2014","029"
"11310","FONTENO",14,0,0,14,"2014","102"
"11311","FONTEVIVO",1,1351,0,1352,"2014","016"
"11312","FONZASO",44,76,0,120,"2014","022"
"11313","FOPPOLO",0,14,0,14,"2014","103"
"11314","FORCOLA",8,164,0,172,"2014","029"
"11315","FORESTO SPARSO",16,94,4,114,"2014","104"
"11316","FORLI'",463,226,0,689,"2014","012"
"11317","FORLIMPOPOLI",6,16,0,22,"2014","013"
"11318","FORMAZZA",0,24,18,42,"2014","031"
"11319","FORMIGARA",0,1060,199,1259,"2014","044"
"11320","FORMIGINE",12,1827,0,1839,"2014","015"
"11321","FORMIGLIANA",23,0,0,23,"2014","059"
"11322","FORMIGNANA",11,0,0,11,"2014","009"
"11323","FORNO CANAVESE",64,0,0,64,"2014","107"
"11324","FORNO DI ZOLDO",17,2,0,19,"2014","024"
"11325","FORNOVO DI TARO",10,450,2,462,"2014","017"
"11326","FORNOVO SAN GIOVANNI",13,714,0,727,"2014","105"
"11327","FORTUNAGO",26,0,0,26,"2014","064"
"11328","FOSSALTA DI PIAVE",7,0,0,7,"2014","015"
"11329","FOSSALTA DI PORTOGRUARO",0,879,0,879,"2014","016"
"11330","FOSSANO",17287,4104,1172,22563,"2014","089"
"11331","FOSSO'",111,26,0,137,"2014","017"
"11332","FOZA",46,44,12,102,"2014","041"
"11333","FRABOSA SOPRANA",179,220,0,399,"2014","090"
"11334","FRABOSA SOTTANA",441,0,37,478,"2014","091"
"11335","FRACONALTO",29,0,0,29,"2014","069"
"11336","FRASCARO",0,7,0,7,"2014","071"
"11337","FRASCAROLO",158,70,0,228,"2014","065"
"11338","FRASSINELLE POLESINE",257,0,0,257,"2014","023"
"11339","FRASSINELLO MONFERRATO",72,0,0,72,"2014","072"
"11340","FRASSINETO PO",35,0,0,35,"2014","073"
"11341","FRASSINETTO",114,24,0,138,"2014","108"
"11342","FRASSINO",54,1,0,55,"2014","092"
"11343","FRASSINORO",140,108,0,248,"2014","016"
"11344","FRATTA POLESINE",32,74,22,128,"2014","024"
"11345","FREGONA",16,30,14,60,"2014","030"
"11346","FRESONARA",17,0,0,17,"2014","074"
"11347","FRINCO",257,0,0,257,"2014","055"
"11348","FRONT",116,0,0,116,"2014","109"
"11349","FROSSASCO",2152,0,84,2236,"2014","110"
"11350","FRUGAROLO",160,180,0,340,"2014","075"
"11351","FUBINE",750,0,0,750,"2014","076"
"11352","FUIPIANO VALLE IMAGNA",12,36,0,48,"2014","106"
"11353","FUMANE",17,28,14,59,"2014","035"
"11354","FUSIGNANO",1,0,0,1,"2014","011"
"11355","FUSINE",6,28,0,34,"2014","030"
"11356","GABBIONETA-BINANUOVA",128,537,0,665,"2014","045"
"11357","GABIANO",49,0,0,49,"2014","077"
"11358","GADESCO-PIEVE DELMONA",38,353,67,458,"2014","046"
"11359","GAGGIANO",65,461,0,526,"2014","103"
"11360","GAGGIO MONTANO",211,369,0,580,"2014","027"
"11361","GAGLIANICO",6,0,0,6,"2014","026"
"11362","GAIARINE",771,0,1,772,"2014","031"
"11363","GAIBA",16,0,0,16,"2014","025"
"11364","GAIOLA",4,3,0,7,"2014","093"
"11365","GALBIATE",55,13,0,68,"2014","036"
"11366","GALEATA",202,0,30,232,"2014","014"
"11367","GALGAGNANO",0,816,0,816,"2014","027"
"11368","GALLARATE",7,30,0,37,"2014","070"
"11369","GALLIATE",32,15,0,47,"2014","068"
"11370","GALLIATE LOMBARDO",9,0,0,9,"2014","071"
"11371","GALLIERA",0,50,0,50,"2014","028"
"11372","GALLIERA VENETA",2785,136,0,2921,"2014","039"
"11373","GALLIO",10,232,0,242,"2014","042"
"11374","GALZIGNANO TERME",18,0,0,18,"2014","040"
"11375","GAMALERO",29,0,0,29,"2014","078"
"11376","GAMBARA",4106,1916,439,6461,"2014","073"
"11377","GAMBASCA",7,0,0,7,"2014","094"
"11378","GAMBOLO'",97,131,0,228,"2014","068"
"11379","GAMBUGLIANO",3,39,0,42,"2014","044"
"11380","GANDELLINO",20,0,0,20,"2014","107"
"11381","GANDINO",50,174,0,224,"2014","108"
"11382","GANDOSSO",3,31,0,34,"2014","109"
"11383","GARBAGNA",105,0,0,105,"2014","079"
"11384","GARBAGNA NOVARESE",2,0,0,2,"2014","069"
"11385","GARBAGNATE MILANESE",4,0,0,4,"2014",NA
"11386","GARBAGNATE MONASTERO",4,0,0,4,"2014","037"
"11387","GARDA",2,0,0,2,"2014","036"
"11388","GARDONE RIVIERA",10,0,0,10,"2014","074"
"11389","GARDONE VAL TROMPIA",34,0,0,34,"2014","075"
"11390","GARESSIO",176,0,1,177,"2014","095"
"11391","GARGALLO",8,0,0,8,"2014","070"
"11392","GARGNANO",34,0,49,83,"2014","076"
"11393","GARLASCO",8,0,0,8,"2014","069"
"11394","GARLATE",3,0,0,3,"2014","038"
"11395","GARZENO",12,12,10,34,"2014","106"
"11396","GARZIGLIANA",302,0,40,342,"2014","111"
"11397","GASSINO TORINESE",33,5,0,38,"2014","112"
"11398","GATTATICO",8,2395,0,2403,"2014","022"
"11399","GATTEO",3,0,0,3,"2014","016"
"11400","GATTICO",21,120,147,288,"2014","071"
"11401","GATTINARA",43,0,0,43,"2014","061"
"11402","GAVARDO",83,492,0,575,"2014","077"
"11403","GAVELLO",38,0,0,38,"2014",NA
"11404","GAVERINA TERME",23,39,0,62,"2014","110"
"11405","GAVI",52,0,0,52,"2014","081"
"11406","GAVIRATE",56,0,0,56,"2014","072"
"11407","GAZOLDO DEGLI IPPOLITI",388,85,2,475,"2014","024"
"11408","GAZZADA SCHIANNO",9,13,0,22,"2014","073"
"11409","GAZZANIGA",20,61,0,81,"2014","111"
"11410","GAZZO",52,3260,0,3312,"2014","041"
"11411","GAZZO VERONESE",927,291,0,1218,"2014","037"
"11412","GAZZOLA",149,1371,0,1520,"2014","022"
"11413","GAZZUOLO",774,42,14,830,"2014","025"
"11414","GEMMANO",26,50,0,76,"2014","004"
"11415","GEMONIO",2,0,2,4,"2014","074"
"11416","GENIVOLTA",101,1998,0,2099,"2014","047"
"11417","GENOLA",1841,1384,125,3350,"2014","096"
"11418","GENZONE",232,57,0,289,"2014","070"
"11419","GERA LARIO",71,226,0,297,"2014","107"
"11420","GERENZAGO",18,0,0,18,"2014","071"
"11421","GERENZANO",90,89,0,179,"2014","075"
"11422","GERMAGNANO",15,3,0,18,"2014","113"
"11423","GERMIGNAGA",7,60,0,67,"2014","076"
"11424","GEROLA ALTA",1,0,0,1,"2014","031"
"11425","GERRE DE' CAPRIOLI",0,346,0,346,"2014","048"
"11426","GESSATE",37,432,0,469,"2014","106"
"11427","GHEDI",3778,6327,54,10159,"2014","078"
"11428","GHEMME",7,0,1,8,"2014","073"
"11429","GHIFFA",2,0,0,2,"2014","033"
"11430","GHISALBA",10,754,0,764,"2014","113"
"11431","GHISLARENGO",21,0,0,21,"2014","062"
"11432","GIACCIANO CON BARUCHELLA",1,0,8,9,"2014","027"
"11433","GIAGLIONE",18,0,0,18,"2014","114"
"11434","GIANICO",121,173,115,409,"2014","079"
"11435","GIAVENO",174,423,133,730,"2014","115"
"11436","GIAVERA DEL MONTELLO",605,139,0,744,"2014","032"
"11437","GIFFLENGA",1,0,0,1,"2014","027"
"11438","GIGNESE",2,0,0,2,"2014","034"
"11439","GIUSSAGO",42,178,0,220,"2014","072"
"11440","GIUSSANO",5,0,0,5,"2014",NA
"11441","GIVOLETTO",27,0,0,27,"2014","116"
"11442","GODEGA DI SANT'URBANO",66,109,0,175,"2014","033"
"11443","GODIASCO",12,0,0,12,"2014","073"
"11444","GOITO",3384,4715,1384,9483,"2014","026"
"11445","GOLASECCA",28,35,0,63,"2014","077"
"11446","GOLFERENZO",0,0,8,8,"2014","074"
"11447","GOMBITO",9,820,0,829,"2014","049"
"11448","GONZAGA",17397,3098,4095,24590,"2014","027"
"11449","GORDONA",87,130,7,224,"2014","032"
"11450","GORGO AL MONTICANO",88,350,0,438,"2014","034"
"11451","GORGONZOLA",10,302,0,312,"2014","108"
"11452","GORLA MAGGIORE",5,0,183,188,"2014","078"
"11453","GORLA MINORE",75,0,0,75,"2014","079"
"11454","GORLAGO",57,267,2,326,"2014","114"
"11455","GORLE",2,0,0,2,"2014","115"
"11456","GORNATE-OLONA",16,0,0,16,"2014","080"
"11457","GORNO",23,62,0,85,"2014","116"
"11458","GORZEGNO",34,0,0,34,"2014","097"
"11459","GOSSOLENGO",35,488,0,523,"2014","023"
"11460","GOTTASECCA",48,0,0,48,"2014","098"
"11461","GOTTOLENGO",12351,1334,162,13847,"2014","080"
"11462","GOVONE",309,0,0,309,"2014","099"
"11463","GOZZANO",8,0,0,8,"2014","076"
"11464","GRAFFIGNANA",55,185,94,334,"2014","028"
"11465","GRAGLIA",141,8,91,240,"2014","028"
"11466","GRAGNANO TREBBIENSE",25,2121,0,2146,"2014","024"
"11467","GRANA",42,0,0,42,"2014","056"
"11468","GRANAGLIONE",12,0,0,12,"2014","029"
"11469","GRANAROLO DELL'EMILIA",18,214,51,283,"2014","030"
"11470","GRANCONA",43,141,0,184,"2014","045"
"11471","GRANDOLA ED UNITI",4,33,22,59,"2014","111"
"11472","GRANOZZO CON MONTICELLO",6,54,0,60,"2014","077"
"11473","GRANTOLA",65,0,0,65,"2014","081"
"11474","GRANTORTO",75,987,0,1062,"2014","042"
"11475","GRANZE",883,0,0,883,"2014","043"
"11476","GRASSOBBIO",17,176,0,193,"2014","117"
"11477","GRAVEDONA ED UNITI",13,22,92,127,"2014","249"
"11478","GRAVELLONA LOMELLINA",14,17,0,31,"2014","075"
"11479","GRAVELLONA TOCE",18,0,0,18,"2014","035"
"11480","GRAZZANO BADOGLIO",543,0,0,543,"2014","057"
"11481","GREMIASCO",30,0,0,30,"2014","083"
"11482","GREZZAGO",6,0,0,6,"2014","110"
"11483","GREZZANA",147,687,0,834,"2014","038"
"11484","GRIANTE",1,0,4,5,"2014","113"
"11485","GRIGNASCO",7,57,0,64,"2014","079"
"11486","GRINZANE CAVOUR",44,0,0,44,"2014","100"
"11487","GRISIGNANO DI ZOCCO",55,482,11,548,"2014","046"
"11488","GRIZZANA MORANDI",54,0,0,54,"2014","031"
"11489","GROMO",37,88,2,127,"2014","118"
"11490","GRONDONA",15,0,0,15,"2014","085"
"11491","GRONE",16,33,0,49,"2014","119"
"11492","GRONTARDO",0,1650,98,1748,"2014","050"
"11493","GROPELLO CAIROLI",51,0,0,51,"2014","076"
"11494","GROPPARELLO",103,20,0,123,"2014","025"
"11495","GROSCAVALLO",19,0,22,41,"2014","118"
"11496","GROSIO",29,188,10,227,"2014","033"
"11497","GROSOTTO",15,60,0,75,"2014","034"
"11498","GROSSO",74,0,0,74,"2014","119"
"11499","GRUARO",13,178,0,191,"2014","018"
"11500","GRUGLIASCO",108,32,45,185,"2014","120"
"11501","GRUMELLO CREMONESE ED UNITI",19,1313,230,1562,"2014","051"
"11502","GRUMELLO DEL MONTE",199,129,0,328,"2014","120"
"11503","GRUMOLO DELLE ABBADESSE",48,273,0,321,"2014","047"
"11504","GUALTIERI",992,646,6,1644,"2014","023"
"11505","GUANZATE",19,0,1,20,"2014","114"
"11506","GUARDA VENETA",644,0,0,644,"2014","028"
"11507","GUARDABOSONE",39,8,0,47,"2014","066"
"11508","GUARDAMIGLIO",8,311,0,319,"2014","029"
"11509","GUARENE",273,0,0,273,"2014","101"
"11510","GUASTALLA",42,1179,0,1221,"2014","024"
"11511","GUDO VISCONTI",17,0,0,17,"2014","112"
"11512","GUIDIZZOLO",1034,814,182,2030,"2014","028"
"11513","GUIGLIA",49,560,0,609,"2014","017"
"11514","GUSSAGO",145,845,0,990,"2014","081"
"11515","GUSSOLA",5,42,4,51,"2014","052"
"11516","IDRO",5,0,0,5,"2014","082"
"11517","IESOLO",21,40,6,67,"2014","019"
"11518","IGLIANO",56,0,23,79,"2014","102"
"11519","ILLASI",1,62,0,63,"2014","039"
"11520","IMBERSAGO",3,0,0,3,"2014","039"
"11521","IMOLA",75,26,0,101,"2014","032"
"11522","INARZO",8,0,0,8,"2014","082"
"11523","INCISA SCAPACCINO",44,0,0,44,"2014","058"
"11524","INCUDINE",1,1,0,2,"2014","083"
"11525","INDUNO OLONA",26,67,0,93,"2014","083"
"11526","INTRAGNA",1,0,0,1,"2014","037"
"11527","INTROBIO",51,21,0,72,"2014","040"
"11528","INTROZZO",1,0,0,1,"2014","041"
"11529","INVERIGO",136,0,0,136,"2014","118"
"11530","INVERNO E MONTELEONE",89,173,0,262,"2014","077"
"11531","INVERSO PINASCA",27,0,0,27,"2014","122"
"11532","INVERUNO",23,143,0,166,"2014","113"
"11533","INVORIO",35,105,0,140,"2014","082"
"11534","INZAGO",242,723,0,965,"2014","114"
"11535","IRMA",11,0,0,11,"2014","084"
"11536","ISASCA",7,0,0,7,"2014","103"
"11537","ISEO",38,34,0,72,"2014","085"
"11538","ISOLA D'ASTI",346,0,0,346,"2014","059"
"11539","ISOLA DELLA SCALA",4236,280,0,4516,"2014","040"
"11540","ISOLA DI FONDRA",2,36,0,38,"2014","121"
"11541","ISOLA DOVARESE",0,659,0,659,"2014","053"
"11542","ISOLA RIZZA",2365,381,0,2746,"2014","041"
"11543","ISOLA SANT'ANTONIO",1,0,0,1,"2014","087"
"11544","ISOLA VICENTINA",1977,716,28,2721,"2014","048"
"11545","ISOLABELLA",85,448,0,533,"2014","123"
"11546","ISORELLA",10388,676,69,11133,"2014","086"
"11547","ISPRA",87,128,0,215,"2014","084"
"11548","ISSIGLIO",64,19,0,83,"2014","124"
"11549","ISSO",7,1211,0,1218,"2014","122"
"11550","ISTRANA",2835,357,101,3293,"2014","035"
"11551","IVREA",205,215,0,420,"2014","125"
"11552","IZANO",5,939,0,944,"2014","054"
"11553","JERAGO CON ORAGO",2,0,0,2,"2014","085"
"11554","JOLANDA DI SAVOIA",51,0,0,51,"2014","010"
"11555","LA CASSA",2,0,278,280,"2014","126"
"11556","LA LOGGIA",236,0,70,306,"2014","127"
"11557","LA MORRA",113,0,0,113,"2014","105"
"11558","LA VALLE AGORDINA",13,36,0,49,"2014","027"
"11559","LACCHIARELLA",29,58,0,87,"2014","115"
"11560","LAGLIO",0,0,1,1,"2014",NA
"11561","LAGNASCO",30,40,0,70,"2014","104"
"11562","LAGOSANTO",36,0,0,36,"2014","011"
"11563","LAINATE",11,0,16,27,"2014","116"
"11564","LAINO",1,1,0,2,"2014","120"
"11565","LAMA MOCOGNO",91,470,0,561,"2014","018"
"11566","LAMBRUGO",0,83,0,83,"2014","121"
"11567","LAMON",19,36,0,55,"2014","026"
"11568","LAMPORO",24,0,0,24,"2014","067"
"11569","LANDRIANO",18,237,0,255,"2014","078"
"11570","LANGHIRANO",3,845,0,848,"2014","018"
"11571","LANGOSCO",6,0,0,6,"2014","079"
"11572","LANZADA",18,75,0,93,"2014","036"
"11573","LANZO D'INTELVI",8,0,3,11,"2014","122"
"11574","LANZO TORINESE",157,0,6,163,"2014","128"
"11575","LASNIGO",7,29,0,36,"2014","123"
"11576","LAURIANO",14,0,0,14,"2014","129"
"11577","LAVAGNO",2,0,0,2,"2014",NA
"11578","LAVENA PONTE TRESA",10,0,0,10,"2014","086"
"11579","LAVENO-MOMBELLO",10,0,0,10,"2014","087"
"11580","LAVENONE",19,2,0,21,"2014","087"
"11581","LAZISE",33,122,0,155,"2014","043"
"11582","LAZZATE",11,0,0,11,"2014",NA
"11583","LECCO",16,47,2,65,"2014","042"
"11584","LEFFE",14,83,0,97,"2014","124"
"11585","LEGGIUNO",3,0,0,3,"2014","088"
"11586","LEGNAGO",114,47,0,161,"2014","044"
"11587","LEGNANO",0,57,0,57,"2014","118"
"11588","LEGNARO",176,41,73,290,"2014","044"
"11589","LEINI'",563,645,87,1295,"2014","130"
"11590","LEMIE",11,73,0,84,"2014","131"
"11591","LENDINARA",602,152,0,754,"2014","029"
"11592","LENNA",12,0,0,12,"2014","125"
"11593","LENO",5589,6915,854,13358,"2014","088"
"11594","LENTA",3,13,0,16,"2014","068"
"11595","LENTATE SUL SEVESO",3,209,0,212,"2014",NA
"11596","LENTIAI",131,133,0,264,"2014","028"
"11597","LEQUIO BERRIA",32,0,0,32,"2014","106"
"11598","LEQUIO TANARO",1544,45,0,1589,"2014","107"
"11599","LERMA",31,0,0,31,"2014","088"
"11600","LESA",6,0,0,6,"2014","084"
"11601","LESEGNO",875,0,0,875,"2014","108"
"11602","LESIGNANO DE' BAGNI",29,1110,0,1139,"2014","019"
"11603","LESMO",2,173,0,175,"2014",NA
"11604","LESSOLO",126,5,0,131,"2014","132"
"11605","LESSONA",4,12,0,16,"2014","029"
"11606","LEVATE",0,14,0,14,"2014","126"
"11607","LEVICE",104,0,0,104,"2014","109"
"11608","LEZZENO",1,0,1,2,"2014","126"
"11609","LIERNA",8,0,0,8,"2014","043"
"11610","LIGNANA",1,0,0,1,"2014","070"
"11611","LIGONCHIO",52,104,0,156,"2014","025"
"11612","LIMANA",41,143,0,184,"2014","029"
"11613","LIMBIATE",10,0,17,27,"2014",NA
"11614","LIMENA",695,698,102,1495,"2014","045"
"11615","LIMIDO COMASCO",5,32,1,38,"2014","128"
"11616","LIMONE PIEMONTE",84,0,0,84,"2014","110"
"11617","LINAROLO",9,413,0,422,"2014","081"
"11618","LIRIO",42,0,0,42,"2014","082"
"11619","LISCATE",14,0,0,14,"2014","122"
"11620","LISIO",66,0,0,66,"2014","111"
"11621","LISSONE",203,0,0,203,"2014",NA
"11622","LIVIGNO",70,297,10,377,"2014","037"
"11623","LIVINALLONGO DEL COL DI LANA",4,71,0,75,"2014","030"
"11624","LIVO",4,0,4,8,"2014","130"
"11625","LIVORNO FERRARIS",2,51,0,53,"2014","071"
"11626","LIVRAGA",37,1133,10,1180,"2014","030"
"11627","LIZZANO IN BELVEDERE",45,65,16,126,"2014","033"
"11628","LOAZZOLO",13,0,1,14,"2014","060"
"11629","LOCANA",138,151,1,290,"2014","134"
"11630","LOCATE DI TRIULZI",0,1086,0,1086,"2014","125"
"11631","LOCATE VARESINO",10,0,0,10,"2014","131"
"11632","LOCATELLO",46,20,0,66,"2014","127"
"11633","LODI",584,1350,53,1987,"2014","031"
"11634","LODI VECCHIO",2,1041,0,1043,"2014","032"
"11635","LODRINO",8,8,0,16,"2014","090"
"11636","LOGRATO",1053,832,0,1885,"2014","091"
"11637","LOIANO",14,321,0,335,"2014","034"
"11638","LOMAGNA",1,0,0,1,"2014","044"
"11639","LOMBARDORE",18,0,0,18,"2014","135"
"11640","LOMBRIASCO",85,109,0,194,"2014","136"
"11641","LOMELLO",3,94,0,97,"2014","083"
"11642","LONATE CEPPINO",6,249,0,255,"2014","089"
"11643","LONATE POZZOLO",29,0,4,33,"2014","090"
"11644","LONATO",2792,4707,106,7605,"2014","092"
"11645","LONGARE",57,239,0,296,"2014","051"
"11646","LONGARONE",6,0,0,6,"2014","031"
"11647","LONGHENA",0,314,0,314,"2014","093"
"11648","LONGIANO",19,0,0,19,"2014","018"
"11649","LONIGO",5453,483,0,5936,"2014","052"
"11650","LORANZE'",11,14,4,29,"2014","137"
"11651","LOREGGIA",274,530,0,804,"2014","046"
"11652","LOREGLIA",9,0,0,9,"2014","038"
"11653","LORENZAGO DI CADORE",3,0,0,3,"2014","032"
"11654","LOREO",572,130,0,702,"2014","030"
"11655","LORIA",5744,23,3,5770,"2014","036"
"11656","LOSINE",0,37,0,37,"2014","094"
"11657","LOVERE",20,17,0,37,"2014","128"
"11658","LOVERO",3,8,0,11,"2014","038"
"11659","LOZIO",0,2,0,2,"2014","095"
"11660","LOZZA",0,125,0,125,"2014","091"
"11661","LOZZO ATESTINO",1603,5,2,1610,"2014","047"
"11662","LOZZO DI CADORE",4,0,0,4,"2014","033"
"11663","LOZZOLO",19,0,0,19,"2014","072"
"11664","LU",68,0,0,68,"2014","089"
"11665","LUGAGNANO VAL D'ARDA",47,220,0,267,"2014","026"
"11666","LUGNACCO",0,1,0,1,"2014","138"
"11667","LUGO",467,111,0,578,"2014","012"
"11668","LUGO DI VICENZA",15,156,0,171,"2014","053"
"11669","LUINO",22,26,0,48,"2014","092"
"11670","LUISAGO",9,0,0,9,"2014","135"
"11671","LUMEZZANE",37,0,0,37,"2014","096"
"11672","LURAGO D'ERBA",10,0,1,11,"2014","136"
"11673","LURAGO MARINONE",0,108,0,108,"2014","137"
"11674","LURANO",27,0,0,27,"2014","129"
"11675","LURATE CACCIVIO",14,0,77,91,"2014","138"
"11676","LUSERNA SAN GIOVANNI",406,69,55,530,"2014","139"
"11677","LUSERNETTA",85,0,0,85,"2014","140"
"11678","LUSIA",22,0,0,22,"2014","031"
"11679","LUSIANA",24,97,0,121,"2014","054"
"11680","LUSIGLIE'",90,0,0,90,"2014","141"
"11681","LUVINATE",1,0,0,1,"2014","093"
"11682","LUZZANA",15,0,0,15,"2014","130"
"11683","LUZZARA",1419,1490,6,2915,"2014","026"
"11684","MACCAGNO CON PINO E VEDDASCA",0,8,14,22,"2014",NA
"11685","MACCASTORNA",565,27,0,592,"2014","033"
"11686","MACELLO",1459,246,383,2088,"2014","142"
"11687","MACHERIO",1,0,0,1,"2014",NA
"11688","MACLODIO",115,291,0,406,"2014","097"
"11689","MACUGNAGA",4,12,0,16,"2014","039"
"11690","MADESIMO",3,2,0,5,"2014","035"
"11691","MADIGNANO",72,646,0,718,"2014","055"
"11692","MADONE",16,0,0,16,"2014","131"
"11693","MADONNA DEL SASSO",17,0,0,17,"2014","040"
"11694","MAGASA",7,15,0,22,"2014","098"
"11695","MAGENTA",28,658,0,686,"2014","130"
"11696","MAGGIORA",113,46,0,159,"2014","088"
"11697","MAGHERNO",0,96,0,96,"2014","085"
"11698","MAGLIANO ALFIERI",535,0,0,535,"2014","113"
"11699","MAGLIANO ALPI",497,108,0,605,"2014","114"
"11700","MAGNACAVALLO",50,264,402,716,"2014","029"
"11701","MAGNAGO",50,0,0,50,"2014","131"
"11702","MAGNANO",11,9,0,20,"2014","030"
"11703","MAIOLO",99,9,0,108,"2014","022"
"11704","MAIRAGO",9,447,0,456,"2014","034"
"11705","MAIRANO",236,626,7,869,"2014","099"
"11706","MALAGNINO",148,687,0,835,"2014","056"
"11707","MALCESINE",24,89,0,113,"2014","045"
"11708","MALEGNO",10,42,6,58,"2014","100"
"11709","MALEO",167,1197,0,1364,"2014","035"
"11710","MALESCO",12,0,14,26,"2014","041"
"11711","MALGESSO",63,0,0,63,"2014","095"
"11712","MALNATE",66,41,0,107,"2014","096"
"11713","MALO",2175,390,0,2565,"2014","055"
"11714","MALONNO",13,265,4,282,"2014","101"
"11715","MALVICINO",7,3,0,10,"2014","090"
"11716","MANDELLO DEL LARIO",15,0,0,15,"2014","046"
"11717","MANDELLO VITTA",2,0,0,2,"2014","090"
"11718","MANERBA DEL GARDA",25,0,8,33,"2014","102"
"11719","MANERBIO",1010,1629,0,2639,"2014","103"
"11720","MANGO",30,0,0,30,"2014","115"
"11721","MANSUE'",74,371,19,464,"2014","037"
"11722","MANTA",4,0,0,4,"2014","116"
"11723","MANTELLO",8,104,0,112,"2014","039"
"11724","MANTOVA",748,848,163,1759,"2014","030"
"11725","MAPELLO",10,17,0,27,"2014","132"
"11726","MARANELLO",98,557,0,655,"2014","019"
"11727","MARANO DI VALPOLICELLA",51,90,5,146,"2014","046"
"11728","MARANO SUL PANARO",70,742,0,812,"2014","020"
"11729","MARANO TICINO",3,251,0,254,"2014","091"
"11730","MARANO VICENTINO",190,342,0,532,"2014","056"
"11731","MARCALLO CON CASONE",2,242,0,244,"2014","134"
"11732","MARCARIA",1606,3376,585,5567,"2014","031"
"11733","MARCHENO",12,10,0,22,"2014","104"
"11734","MARCHIROLO",3,0,0,3,"2014","097"
"11735","MARCIGNAGO",44,0,0,44,"2014","086"
"11736","MARCON",161,15,71,247,"2014","020"
"11737","MARENE",3231,2094,146,5471,"2014","117"
"11738","MARENO DI PIAVE",1436,237,0,1673,"2014","038"
"11739","MARENTINO",129,0,0,129,"2014","144"
"11740","MARETTO",149,0,0,149,"2014","062"
"11741","MARGARITA",793,0,0,793,"2014","118"
"11742","MARGNO",5,7,0,12,"2014","047"
"11743","MARIANA MANTOVANA",25,352,50,427,"2014","032"
"11744","MARIANO COMENSE",636,77,0,713,"2014","143"
"11745","MARMENTINO",15,18,2,35,"2014","105"
"11746","MARMIROLO",3646,2283,2919,8848,"2014","033"
"11747","MARMORA",38,85,8,131,"2014","119"
"11748","MARONE",49,53,0,102,"2014","106"
"11749","MAROSTICA",211,719,0,930,"2014","057"
"11750","MARSAGLIA",185,0,0,185,"2014","120"
"11751","MARTELLAGO",46,0,0,46,"2014","021"
"11752","MARTIGNANA DI PO",1,0,0,1,"2014","057"
"11753","MARTINENGO",323,2607,0,2930,"2014","133"
"11754","MARTINIANA PO",119,82,0,201,"2014","121"
"11755","MARUDO",0,302,0,302,"2014","036"
"11756","MARZABOTTO",6,87,0,93,"2014","036"
"11757","MARZANO",5,276,18,299,"2014","087"
"11758","MARZIO",4,0,2,6,"2014","099"
"11759","MASATE",0,0,160,160,"2014","136"
"11760","MASCIAGO PRIMO",40,0,0,40,"2014","100"
"11761","MASER",3657,57,0,3714,"2014","039"
"11762","MASERA",16,35,4,55,"2014","042"
"11763","MASERA' DI PADOVA",264,104,114,482,"2014","048"
"11764","MASERADA SUL PIAVE",2486,121,0,2607,"2014","040"
"11765","MASI",80,0,0,80,"2014","049"
"11766","MASI TORELLO",2,70,0,72,"2014","012"
"11767","MASIO",740,0,0,740,"2014","091"
"11768","MASLIANICO",0,0,1,1,"2014","144"
"11769","MASON VICENTINO",124,528,0,652,"2014","058"
"11770","MASSA LOMBARDA",9,0,0,9,"2014","013"
"11771","MASSALENGO",0,166,0,166,"2014","037"
"11772","MASSANZAGO",676,169,0,845,"2014","050"
"11773","MASSAZZA",33,10,0,43,"2014","031"
"11774","MASSELLO",6,0,0,6,"2014","145"
"11775","MASSERANO",43,0,0,43,"2014","032"
"11776","MASSINO VISCONTI",14,3,1,18,"2014","093"
"11777","MATHI",63,0,0,63,"2014","146"
"11778","MATTIE",18,0,0,18,"2014","147"
"11779","MAZZANO",60,751,11,822,"2014","107"
"11780","MAZZE'",1398,0,0,1398,"2014","148"
"11781","MAZZO DI VALTELLINA",16,12,4,32,"2014","040"
"11782","MEANA DI SUSA",6,0,0,6,"2014","149"
"11783","MEDA",1,0,0,1,"2014",NA
"11784","MEDE",19,54,0,73,"2014","088"
"11785","MEDESANO",63,1287,0,1350,"2014","020"
"11786","MEDICINA",237,158,0,395,"2014","037"
"11787","MEDIGLIA",19,1149,64,1232,"2014","139"
"11788","MEDOLAGO",14,0,0,14,"2014","250"
"11789","MEDOLE",519,461,644,1624,"2014","034"
"11790","MEDOLLA",0,549,0,549,"2014","021"
"11791","MEDUNA DI LIVENZA",13,21,0,34,"2014","041"
"11792","MEGLIADINO SAN FIDENZIO",963,0,0,963,"2014","051"
"11793","MEGLIADINO SAN VITALE",1531,0,0,1531,"2014","052"
"11794","MEINA",2,0,0,2,"2014","095"
"11795","MEL",65,368,7,440,"2014","034"
"11796","MELARA",61,0,0,61,"2014","032"
"11797","MELAZZO",239,0,0,239,"2014","092"
"11798","MELDOLA",162,76,0,238,"2014","019"
"11799","MELEGNANO",2,126,0,128,"2014","140"
"11800","MELETI",43,418,0,461,"2014","038"
"11801","MELLE",49,36,0,85,"2014","122"
"11802","MELLO",24,47,0,71,"2014","041"
"11803","MELZO",19,267,0,286,"2014","142"
"11804","MENAGGIO",2,0,0,2,"2014","145"
"11805","MENCONICO",20,0,0,20,"2014","089"
"11806","MEOLO",61,123,0,184,"2014","022"
"11807","MERANA",22,0,0,22,"2014","093"
"11808","MERATE",122,315,27,464,"2014","048"
"11809","MERCATO SARACENO",204,24,1,229,"2014","020"
"11810","MERCENASCO",317,0,0,317,"2014","150"
"11811","MERGOZZO",26,0,0,26,"2014","044"
"11812","MERLARA",538,13,0,551,"2014","053"
"11813","MERLINO",1,952,0,953,"2014","039"
"11814","MERONE",34,71,10,115,"2014","147"
"11815","MESE",22,43,0,65,"2014","043"
"11816","MESENZANA",0,28,0,28,"2014","102"
"11817","MESERO",0,58,0,58,"2014","144"
"11818","MESOLA",1544,250,0,1794,"2014","014"
"11819","MESTRINO",53,155,25,233,"2014","054"
"11820","MEUGLIANO",7,0,0,7,"2014","151"
"11821","MEZZANA BIGLI",127,0,0,127,"2014","090"
"11822","MEZZANE DI SOTTO",4,21,0,25,"2014","047"
"11823","MEZZANI",4,343,0,347,"2014","021"
"11824","MEZZANINO",3,0,0,3,"2014","092"
"11825","MEZZENILE",42,42,0,84,"2014","152"
"11826","MEZZOLDO",1,9,0,10,"2014","134"
"11827","MEZZOMERICO",6,0,0,6,"2014","097"
"11828","MIAGLIANO",7,0,0,7,"2014","034"
"11829","MIANE",14,8,0,22,"2014","042"
"11830","MIASINO",0,0,30,30,"2014","098"
"11831","MIAZZINA",1,0,0,1,"2014","045"
"11832","MILANO",364,59,0,423,"2014","146"
"11833","MILZANO",3,875,0,878,"2014","108"
"11834","MINERBE",1993,209,1,2203,"2014","048"
"11835","MINERBIO",55,0,0,55,"2014","038"
"11836","MIRA",1712,613,34,2359,"2014","023"
"11837","MIRABELLO MONFERRATO",81,0,0,81,"2014","094"
"11838","MIRADOLO TERME",32,62,14,108,"2014","093"
"11839","MIRANDOLA",217,1200,0,1417,"2014","022"
"11840","MIRANO",833,712,16,1561,"2014","024"
"11841","MISANO ADRIATICO",18,0,0,18,"2014","005"
"11842","MISANO DI GERA D'ADDA",12,225,16,253,"2014","135"
"11843","MISSAGLIA",18,214,222,454,"2014","049"
"11844","MODENA",380,2399,0,2779,"2014","023"
"11845","MODIGLIANA",80,0,3,83,"2014","022"
"11846","MOGLIA",3669,730,1329,5728,"2014","035"
"11847","MOGLIANO VENETO",1081,438,110,1629,"2014","043"
"11848","MOIO DE' CALVI",4,4,0,8,"2014","136"
"11849","MOIOLA",0,2,0,2,"2014","123"
"11850","MOLARE",4,0,0,4,"2014","095"
"11851","MOLINELLA",2173,248,0,2421,"2014","039"
"11852","MOLLIA",3,0,0,3,"2014","078"
"11853","MOLTENO",25,57,0,82,"2014","051"
"11854","MOLVENA",14,6,0,20,"2014","059"
"11855","MOMBALDONE",65,0,4,69,"2014","064"
"11856","MOMBARCARO",113,0,0,113,"2014","124"
"11857","MOMBARUZZO",5,0,0,5,"2014","065"
"11858","MOMBASIGLIO",123,0,0,123,"2014","125"
"11859","MOMBELLO DI TORINO",38,0,0,38,"2014","153"
"11860","MOMBELLO MONFERRATO",29,0,0,29,"2014","097"
"11861","MOMBERCELLI",58,0,0,58,"2014","066"
"11862","MOMO",163,756,0,919,"2014","100"
"11863","MOMPANTERO",1,0,0,1,"2014","154"
"11864","MOMPERONE",5,0,0,5,"2014","098"
"11865","MONALE",39,0,0,39,"2014","067"
"11866","MONASTERO BORMIDA",403,0,0,403,"2014","068"
"11867","MONASTERO DI LANZO",13,69,0,82,"2014","155"
"11868","MONASTERO DI VASCO",446,10,32,488,"2014","126"
"11869","MONASTEROLO CASOTTO",45,0,0,45,"2014","127"
"11870","MONASTEROLO DEL CASTELLO",5,14,0,19,"2014","137"
"11871","MONASTEROLO DI SAVIGLIANO",431,263,69,763,"2014","128"
"11872","MONASTIER DI TREVISO",1811,394,0,2205,"2014","044"
"11873","MONCALIERI",321,370,0,691,"2014","156"
"11874","MONCALVO",121,0,0,121,"2014","069"
"11875","MONCENISIO",5,0,0,5,"2014","157"
"11876","MONCESTINO",10,0,0,10,"2014","099"
"11877","MONCHIERO",249,0,0,249,"2014","129"
"11878","MONCHIO DELLE CORTI",29,173,0,202,"2014","022"
"11879","MONCRIVELLO",113,252,0,365,"2014","079"
"11880","MONCUCCO TORINESE",34,0,0,34,"2014","070"
"11881","MONDAINO",10,0,0,10,"2014","006"
"11882","MONDOVI'",5421,375,26,5822,"2014","130"
"11883","MONESIGLIO",113,0,0,113,"2014","131"
"11884","MONFORTE D'ALBA",252,0,0,252,"2014","132"
"11885","MONFUMO",48,214,0,262,"2014","045"
"11886","MONGARDINO",24,0,0,24,"2014","071"
"11887","MONGHIDORO",20,74,43,137,"2014","040"
"11888","MONGIARDINO LIGURE",12,0,21,33,"2014","100"
"11889","MONGRANDO",112,123,7,242,"2014","035"
"11890","MONGUZZO",17,0,0,17,"2014","153"
"11891","MONIGA DEL GARDA",0,13,0,13,"2014","109"
"11892","MONNO",4,38,0,42,"2014","110"
"11893","MONSELICE",462,60,0,522,"2014","055"
"11894","MONTA'",112,0,0,112,"2014","133"
"11895","MONTABONE",98,0,0,98,"2014","072"
"11896","MONTACUTO",17,0,0,17,"2014","102"
"11897","MONTAFIA",49,0,0,49,"2014","073"
"11898","MONTAGNA IN VALTELLINA",7,95,1,103,"2014","044"
"11899","MONTAGNANA",1573,106,0,1679,"2014","056"
"11900","MONTALDO BORMIDA",1,0,0,1,"2014","104"
"11901","MONTALDO DI MONDOVI'",98,5,0,103,"2014","134"
"11902","MONTALDO ROERO",29,0,0,29,"2014","135"
"11903","MONTALDO SCARAMPI",16,0,0,16,"2014","074"
"11904","MONTALDO TORINESE",476,0,0,476,"2014","158"
"11905","MONTALENGHE",5,0,0,5,"2014","159"
"11906","MONTALTO DORA",25,0,0,25,"2014","160"
"11907","MONTALTO PAVESE",87,0,0,87,"2014","094"
"11908","MONTANARO",151,156,23,330,"2014","161"
"11909","MONTANASO LOMBARDO",180,527,0,707,"2014","040"
"11910","MONTANERA",1792,805,123,2720,"2014","136"
"11911","MONTANO LUCINO",9,18,7,34,"2014","154"
"11912","MONTE COLOMBO",94,0,0,94,"2014","007"
"11913","MONTE CREMASCO",456,187,0,643,"2014","058"
"11914","MONTE DI MALO",210,193,0,403,"2014","063"
"11915","MONTE ISOLA",22,0,0,22,"2014","111"
"11916","MONTE MARENZO",7,0,0,7,"2014","052"
"11917","MONTE SAN PIETRO",102,202,0,304,"2014","042"
"11918","MONTEBELLO DELLA BATTAGLIA",3,34,0,37,"2014","095"
"11919","MONTEBELLO VICENTINO",89,0,157,246,"2014","060"
"11920","MONTEBELLUNA",4121,661,32,4814,"2014","046"
"11921","MONTECALVO VERSIGGIA",3,0,0,3,"2014",NA
"11922","MONTECASTELLO",61,0,0,61,"2014","105"
"11923","MONTECCHIA DI CROSARA",847,0,0,847,"2014","049"
"11924","MONTECCHIO EMILIA",20,1306,0,1326,"2014","027"
"11925","MONTECCHIO MAGGIORE",184,41,0,225,"2014","061"
"11926","MONTECCHIO PRECALCINO",276,172,32,480,"2014","062"
"11927","MONTECHIARO D'ACQUI",46,0,0,46,"2014","106"
"11928","MONTECHIARO D'ASTI",226,0,0,226,"2014","075"
"11929","MONTECHIARUGOLO",8,3507,0,3515,"2014","023"
"11930","MONTECRESTESE",27,38,0,65,"2014","046"
"11931","MONTECRETO",9,446,0,455,"2014","024"
"11932","MONTEFIORE CONCA",32,8,0,40,"2014","008"
"11933","MONTEFIORINO",13,316,0,329,"2014","025"
"11934","MONTEFORTE D'ALPONE",818,41,0,859,"2014","050"
"11935","MONTEGALDA",187,228,0,415,"2014","064"
"11936","MONTEGALDELLA",126,254,20,400,"2014","065"
"11937","MONTEGIOCO",38,0,0,38,"2014","107"
"11938","MONTEGRIDOLFO",2,0,0,2,"2014","009"
"11939","MONTEGRINO VALTRAVAGLIA",11,0,0,11,"2014","103"
"11940","MONTEGROSSO D'ASTI",24,0,0,24,"2014","076"
"11941","MONTEGROTTO TERME",19,0,52,71,"2014","057"
"11942","MONTELLO",2,0,0,2,"2014","139"
"11943","MONTELUPO ALBESE",81,0,0,81,"2014","137"
"11944","MONTEMAGNO",112,0,0,112,"2014","077"
"11945","MONTEMALE DI CUNEO",29,0,0,29,"2014","138"
"11946","MONTEMARZINO",2,0,0,2,"2014","108"
"11947","MONTEMEZZO",1,0,1,2,"2014","155"
"11948","MONTERENZIO",332,165,0,497,"2014","041"
"11949","MONTEROSSO GRANA",6,133,10,149,"2014","139"
"11950","MONTESCANO",1,0,0,1,"2014","097"
"11951","MONTESCHENO",4,0,0,4,"2014","047"
"11952","MONTESCUDO",169,0,0,169,"2014","010"
"11953","MONTESE",106,1257,0,1363,"2014","026"
"11954","MONTESEGALE",13,0,0,13,"2014","098"
"11955","MONTEU DA PO",117,0,0,117,"2014","162"
"11956","MONTEU ROERO",525,0,0,525,"2014","140"
"11957","MONTEVECCHIA",13,3,0,16,"2014","053"
"11958","MONTEVIALE",59,10,0,69,"2014","066"
"11959","MONTEZEMOLO",175,0,0,175,"2014","141"
"11960","MONTICELLI BRUSATI",9,245,2,256,"2014","112"
"11961","MONTICELLI D'ONGINA",404,617,0,1021,"2014","027"
"11962","MONTICELLI PAVESE",1121,366,0,1487,"2014","099"
"11963","MONTICELLO BRIANZA",10,0,295,305,"2014","054"
"11964","MONTICELLO CONTE OTTO",87,848,0,935,"2014","067"
"11965","MONTICELLO D'ALBA",104,0,0,104,"2014","142"
"11966","MONTICHIARI",10289,6740,536,17565,"2014","113"
"11967","MONTIGLIO MONFERRATO",270,0,0,270,"2014","121"
"11968","MONTIRONE",4229,446,0,4675,"2014","114"
"11969","MONTODINE",1,1106,0,1107,"2014","059"
"11970","MONTORFANO",15,0,0,15,"2014","157"
"11971","MONTORSO VICENTINO",643,158,0,801,"2014","068"
"11972","MONTU' BECCARIA",3,0,0,3,"2014","100"
"11973","MONVALLE",10,39,0,49,"2014","104"
"11974","MONZA",2,58,42,102,"2014",NA
"11975","MONZAMBANO",1235,677,716,2628,"2014","036"
"11976","MONZUNO",100,76,0,176,"2014","044"
"11977","MORANO SUL PO",2,0,0,2,"2014","109"
"11978","MORANSENGO",123,0,0,123,"2014","079"
"11979","MORAZZONE",15,107,0,122,"2014","105"
"11980","MORBEGNO",14,108,1,123,"2014","045"
"11981","MORBELLO",4,0,0,4,"2014","110"
"11982","MORDANO",1,0,0,1,"2014","045"
"11983","MORENGO",51,56,0,107,"2014","140"
"11984","MORETTA",947,630,207,1784,"2014","143"
"11985","MORFASSO",93,12,0,105,"2014","028"
"11986","MORGANO",1940,13,0,1953,"2014","047"
"11987","MORIAGO DELLA BATTAGLIA",2315,66,0,2381,"2014","048"
"11988","MORIMONDO",30,1441,0,1471,"2014","150"
"11989","MORIONDO TORINESE",278,0,0,278,"2014","163"
"11990","MORNAGO",31,0,0,31,"2014","106"
"11991","MORNESE",21,0,0,21,"2014","111"
"11992","MORNICO AL SERIO",1532,365,88,1985,"2014","141"
"11993","MORNICO LOSANA",29,0,0,29,"2014","101"
"11994","MOROZZO",2077,622,363,3062,"2014","144"
"11995","MORSASCO",142,0,0,142,"2014","112"
"11996","MORTARA",57,0,0,57,"2014","102"
"11997","MORTERONE",18,0,0,18,"2014","055"
"11998","MOSCAZZANO",3,1130,330,1463,"2014","060"
"11999","MOSSANO",565,77,0,642,"2014","069"
"12000","MOSSO",35,16,10,61,"2014","084"
"12001","MOTTA BALUFFI",6,97,0,103,"2014","061"
"12002","MOTTA DI LIVENZA",44,34,1,79,"2014","049"
"12003","MOTTA VISCONTI",10,0,0,10,"2014","151"
"12004","MOTTALCIATA",69,69,0,138,"2014","037"
"12005","MOTTEGGIANA",662,1171,594,2427,"2014","037"
"12006","MOZZANICA",200,683,0,883,"2014","142"
"12007","MOZZATE",27,96,0,123,"2014","159"
"12008","MOZZECANE",3460,792,0,4252,"2014","051"
"12009","MUGGIÒ",3,0,0,3,"2014",NA
"12010","MULAZZANO",8,1054,0,1062,"2014","041"
"12011","MURA",19,23,8,50,"2014","115"
"12012","MURAZZANO",344,0,55,399,"2014","145"
"12013","MURELLO",468,1271,225,1964,"2014","146"
"12014","MURISENGO",344,0,0,344,"2014","113"
"12015","MUSCOLINE",68,409,9,486,"2014","116"
"12016","MUSILE DI PIAVE",22,44,0,66,"2014","025"
"12017","MUSSO",4,7,3,14,"2014","160"
"12018","MUSSOLENTE",146,257,103,506,"2014","070"
"12019","MUZZANO",28,0,0,28,"2014","038"
"12020","NANTO",257,183,0,440,"2014","071"
"12021","NARZOLE",915,172,0,1087,"2014","147"
"12022","NAVE",48,120,0,168,"2014","117"
"12023","NEBBIUNO",42,9,21,72,"2014","103"
"12024","NEGRAR",17,130,0,147,"2014","052"
"12025","NEIVE",27,0,0,27,"2014","148"
"12026","NEMBRO",37,0,0,37,"2014","144"
"12027","NERVESA DELLA BATTAGLIA",608,277,0,885,"2014","050"
"12028","NERVIANO",40,132,0,172,"2014","154"
"12029","NESSO",0,12,0,12,"2014","161"
"12030","NETRO",108,58,0,166,"2014","039"
"12031","NEVIANO DEGLI ARDUINI",20,1865,0,1885,"2014","024"
"12032","NEVIGLIE",3,0,0,3,"2014","149"
"12033","NIARDO",1,159,10,170,"2014","118"
"12034","NIBBIANO",191,0,0,191,"2014","029"
"12035","NIBIONNO",3,12,0,15,"2014","056"
"12036","NICHELINO",60,0,0,60,"2014","164"
"12037","NICORVO",11,0,0,11,"2014","103"
"12038","NIELLA BELBO",48,109,0,157,"2014","150"
"12039","NIELLA TANARO",299,0,0,299,"2014","151"
"12040","NIZZA MONFERRATO",103,0,0,103,"2014","080"
"12041","NOALE",464,66,12,542,"2014","026"
"12042","NOASCA",14,22,37,73,"2014","165"
"12043","NOCETO",43,3016,11,3070,"2014","025"
"12044","NOGARA",2047,457,43,2547,"2014","053"
"12045","NOGAROLE ROCCA",542,303,0,845,"2014","054"
"12046","NOGAROLE VICENTINO",12,33,0,45,"2014","072"
"12047","NOLE",214,136,0,350,"2014","166"
"12048","NONANTOLA",9,203,0,212,"2014","027"
"12049","NONE",909,1039,200,2148,"2014","168"
"12050","NOSATE",17,29,0,46,"2014","155"
"12051","NOVA MILANESE",1,52,0,53,"2014",NA
"12052","NOVAFELTRIA",1174,171,0,1345,"2014","023"
"12053","NOVALESA",31,15,0,46,"2014","169"
"12054","NOVARA",52,314,0,366,"2014","106"
"12055","NOVATE MEZZOLA",10,33,0,43,"2014","046"
"12056","NOVATE MILANESE",2,0,0,2,"2014",NA
"12057","NOVE",24,296,0,320,"2014","073"
"12058","NOVEDRATE",950,0,0,950,"2014","163"
"12059","NOVELLARA",2791,2062,16,4869,"2014","028"
"12060","NOVELLO",1127,0,0,1127,"2014","152"
"12061","NOVENTA DI PIAVE",6,14,0,20,"2014","027"
"12062","NOVENTA PADOVANA",7,0,0,7,"2014","058"
"12063","NOVENTA VICENTINA",4074,0,0,4074,"2014","074"
"12064","NOVI DI MODENA",1005,828,0,1833,"2014","028"
"12065","NOVI LIGURE",537,0,0,537,"2014","114"
"12066","NOVIGLIO",12,496,0,508,"2014","158"
"12067","NUVOLENTO",16,925,0,941,"2014","119"
"12068","NUVOLERA",1244,317,0,1561,"2014","120"
"12069","OCCHIEPPO INFERIORE",6,146,0,152,"2014","040"
"12070","OCCHIEPPO SUPERIORE",46,53,36,135,"2014","041"
"12071","OCCHIOBELLO",3,160,0,163,"2014","033"
"12072","OCCIMIANO",40,0,0,40,"2014","115"
"12073","ODALENGO GRANDE",91,0,0,91,"2014","116"
"12074","ODERZO",109,426,0,535,"2014","051"
"12075","ODOLO",6,0,0,6,"2014","121"
"12076","OFFANENGO",244,459,0,703,"2014","062"
"12077","OFFLAGA",632,3356,98,4086,"2014","122"
"12078","OGGEBBIO",5,0,0,5,"2014","049"
"12079","OGGIONA CON SANTO STEFANO",2,32,0,34,"2014","107"
"12080","OGGIONO",68,76,4,148,"2014","057"
"12081","OGLIANICO",76,306,0,382,"2014","170"
"12082","OLDENICO",2,0,0,2,"2014","089"
"12083","OLEGGIO",166,882,0,1048,"2014","108"
"12084","OLEGGIO CASTELLO",28,0,0,28,"2014","109"
"12085","OLGIATE COMASCO",42,15,14,71,"2014","165"
"12086","OLGIATE MOLGORA",24,98,0,122,"2014","058"
"12087","OLGIATE OLONA",4,0,0,4,"2014","108"
"12088","OLGINATE",11,0,0,11,"2014","059"
"12089","OLIVETO LARIO",16,0,0,16,"2014","060"
"12090","OLMENETA",21,329,96,446,"2014","063"
"12091","OLMO AL BREMBO",3,6,0,9,"2014","145"
"12092","OLMO GENTILE",27,0,4,31,"2014","081"
"12093","OLTRE IL COLLE",27,83,0,110,"2014","146"
"12094","OLTRESSENDA ALTA",2,26,0,28,"2014","147"
"12095","OLTRONA DI SAN MAMETTE",15,0,0,15,"2014","169"
"12096","OME",21,20,0,41,"2014","123"
"12097","OMEGNA",32,0,0,32,"2014","050"
"12098","ONCINO",59,0,0,59,"2014","154"
"12099","ONETA",3,49,0,52,"2014","148"
"12100","ONO SAN PIETRO",1,15,0,16,"2014","124"
"12101","ONORE",10,12,0,22,"2014","149"
"12102","OPERA",0,138,0,138,"2014","159"
"12103","OPPEANO",4178,849,0,5027,"2014","055"
"12104","ORBASSANO",682,0,208,890,"2014","171"
"12105","ORGIANO",477,18,0,495,"2014","075"
"12106","ORIGGIO",72,0,10,82,"2014","109"
"12107","ORINO",3,0,0,3,"2014","110"
"12108","ORIO CANAVESE",55,0,0,55,"2014","172"
"12109","ORIO LITTA",0,180,0,180,"2014","042"
"12110","ORMEA",135,20,0,155,"2014","155"
"12111","ORMELLE",27,195,9,231,"2014","052"
"12112","ORNAGO",23,43,0,66,"2014",NA
"12113","ORNAVASSO",17,0,0,17,"2014","051"
"12114","ORNICA",3,0,0,3,"2014","151"
"12115","ORSAGO",19,150,0,169,"2014","053"
"12116","ORSARA BORMIDA",12,0,0,12,"2014","119"
"12117","ORSENIGO",7,41,0,48,"2014","170"
"12118","ORTA SAN GIULIO",3,0,0,3,"2014","112"
"12119","ORZINUOVI",766,4344,0,5110,"2014","125"
"12120","ORZIVECCHI",21,670,0,691,"2014","126"
"12121","OSASCO",387,0,90,477,"2014","173"
"12122","OSASIO",238,282,0,520,"2014","174"
"12123","OSIO SOPRA",25,592,0,617,"2014","152"
"12124","OSMATE",28,0,0,28,"2014","111"
"12125","OSNAGO",260,83,0,343,"2014","061"
"12126","OSPEDALETTO EUGANEO",232,40,0,272,"2014","059"
"12127","OSPEDALETTO LODIGIANO",0,936,0,936,"2014","043"
"12128","OSPITALETTO",111,199,0,310,"2014","127"
"12129","OSSAGO LODIGIANO",64,1685,8,1757,"2014","044"
"12130","OSSIMO",0,27,0,27,"2014","128"
"12131","OSSONA",46,0,0,46,"2014","164"
"12132","OSTANA",42,0,0,42,"2014","156"
"12133","OSTELLATO",3358,16,0,3374,"2014","017"
"12134","OSTIANO",479,1407,60,1946,"2014","064"
"12135","OSTIGLIA",44,31,55,130,"2014","038"
"12136","OTTIGLIO",115,0,0,115,"2014","120"
"12137","OTTOBIANO",1,43,0,44,"2014","106"
"12138","OTTONE",76,0,0,76,"2014","030"
"12139","OULX",52,0,0,52,"2014","175"
"12140","OVADA",30,0,0,30,"2014","121"
"12141","OVIGLIO",31,12,0,43,"2014","122"
"12142","OZEGNA",137,27,0,164,"2014","176"
"12143","OZZANO DELL'EMILIA",195,218,0,413,"2014","046"
"12144","OZZANO MONFERRATO",72,0,0,72,"2014","123"
"12145","OZZERO",36,319,0,355,"2014","165"
"12146","PADENGHE SUL GARDA",42,0,27,69,"2014","129"
"12147","PADERNO D'ADDA",0,20,0,20,"2014","062"
"12148","PADERNO DEL GRAPPA",61,158,0,219,"2014","054"
"12149","PADERNO DUGNANO",21,0,3,24,"2014","166"
"12150","PADERNO FRANCIACORTA",1,125,139,265,"2014","130"
"12151","PADERNO PONCHIELLI",195,1865,70,2130,"2014","065"
"12152","PADOVA",528,303,123,954,"2014","060"
"12153","PAESANA",680,28,0,708,"2014","157"
"12154","PAESE",2094,746,90,2930,"2014","055"
"12155","PAGNO",42,0,0,42,"2014","158"
"12156","PAGNONA",16,0,8,24,"2014","063"
"12157","PAISCO LOVENO",1,10,1,12,"2014","131"
"12158","PAITONE",33,24,0,57,"2014","132"
"12159","PALADINA",1,6,0,7,"2014","155"
"12160","PALAGANO",95,646,2,743,"2014","029"
"12161","PALANZANO",14,471,0,485,"2014","026"
"12162","PALAZZAGO",104,110,0,214,"2014","156"
"12163","PALAZZO CANAVESE",1,0,0,1,"2014","177"
"12164","PALAZZO PIGNANO",19,1008,0,1027,"2014","066"
"12165","PALAZZOLO SULL'OGLIO",1387,1207,33,2627,"2014","133"
"12166","PALAZZOLO VERCELLESE",2,0,0,2,"2014","090"
"12167","PALESTRO",0,0,16,16,"2014","107"
"12168","PALLANZENO",8,0,0,8,"2014","052"
"12169","PALOSCO",455,449,0,904,"2014","157"
"12170","PALU'",978,0,0,978,"2014","056"
"12171","PAMPARATO",52,0,0,52,"2014","159"
"12172","PANCALIERI",21,124,0,145,"2014","178"
"12173","PANDINO",38,3755,243,4036,"2014","067"
"12174","PANTIGLIATE",2,0,0,2,"2014","167"
"12175","PAPOZZE",42,97,0,139,"2014","034"
"12176","PARABIAGO",99,32,0,131,"2014","168"
"12177","PARATICO",12,51,0,63,"2014","134"
"12178","PARETO",50,1,0,51,"2014","125"
"12179","PARLASCO",2,0,0,2,"2014","064"
"12180","PARMA",812,9214,0,10026,"2014","027"
"12181","PARODI LIGURE",19,0,29,48,"2014","126"
"12182","PAROLDO",24,0,0,24,"2014","160"
"12183","PARONA",9,0,0,9,"2014","109"
"12184","PARRE",27,64,0,91,"2014","158"
"12185","PARUZZARO",30,46,0,76,"2014","114"
"12186","PARZANICA",0,0,9,9,"2014","159"
"12187","PASPARDO",0,6,0,6,"2014","135"
"12188","PASSERANO MARMORITO",105,0,0,105,"2014","082"
"12189","PASSIRANO",126,289,2,417,"2014","136"
"12190","PASTRENGO",2,153,0,155,"2014","057"
"12191","PASTURO",52,138,30,220,"2014","065"
"12192","PAULLO",0,488,0,488,"2014","169"
"12193","PAVAROLO",72,0,0,72,"2014","180"
"12194","PAVIA",113,230,14,357,"2014","110"
"12195","PAVONE CANAVESE",116,0,0,116,"2014","181"
"12196","PAVONE DEL MELLA",1969,436,3,2408,"2014","137"
"12197","PAVULLO NEL FRIGNANO",240,3949,0,4189,"2014","030"
"12198","PECETTO DI VALENZA",33,0,0,33,"2014","128"
"12199","PECETTO TORINESE",104,0,0,104,"2014","183"
"12200","PECORARA",300,125,0,425,"2014","031"
"12201","PEDAVENA",8,114,0,122,"2014","036"
"12202","PEDEMONTE",8,8,0,16,"2014","076"
"12203","PEDEROBBA",133,169,0,302,"2014","056"
"12204","PEDRENGO",27,148,0,175,"2014","160"
"12205","PEGLIO",4,0,11,15,"2014","178"
"12206","PEGOGNAGA",2025,1707,2071,5803,"2014","039"
"12207","PEIA",10,10,0,20,"2014","161"
"12208","PELLEGRINO PARMENSE",28,809,3,840,"2014","028"
"12209","PELLIO INTELVI",7,18,18,43,"2014","179"
"12210","PENANGO",83,0,0,83,"2014","083"
"12211","PENNABILLI",260,18,0,278,"2014","024"
"12212","PEREGO",3,0,5,8,"2014","066"
"12213","PERLEDO",4,0,0,4,"2014","067"
"12214","PERLETTO",213,0,0,213,"2014","161"
"12215","PERLO",39,0,0,39,"2014","162"
"12216","PERNUMIA",322,157,0,479,"2014","061"
"12217","PERO",6,0,0,6,"2014",NA
"12218","PEROSA ARGENTINA",53,17,0,70,"2014","184"
"12219","PEROSA CANAVESE",113,206,0,319,"2014","185"
"12220","PERRERO",33,0,0,33,"2014","186"
"12221","PERSICO DOSIMO",3,1861,0,1864,"2014","068"
"12222","PERTENGO",3,0,0,3,"2014","091"
"12223","PERTICA ALTA",24,7,0,31,"2014","139"
"12224","PERTICA BASSA",35,56,0,91,"2014","140"
"12225","PERTUSIO",56,0,0,56,"2014","187"
"12226","PESCANTINA",41,102,1,144,"2014","058"
"12227","PESCAROLO ED UNITI",78,835,0,913,"2014","069"
"12228","PESCHIERA BORROMEO",12,515,0,527,"2014","171"
"12229","PESSANO CON BORNAGO",63,124,0,187,"2014","172"
"12230","PESSINA CREMONESE",391,2831,0,3222,"2014","070"
"12231","PESSINETTO",1,0,0,1,"2014","188"
"12232","PETTENASCO",11,0,0,11,"2014","116"
"12233","PETTINENGO",6,0,23,29,"2014","042"
"12234","PETTORAZZA GRIMANI",253,256,0,509,"2014","035"
"12235","PEVERAGNO",1075,505,66,1646,"2014","163"
"12236","PEZZAZE",15,21,0,36,"2014","141"
"12237","PEZZOLO VALLE UZZONE",69,0,0,69,"2014","164"
"12238","PIACENZA",672,1525,0,2197,"2014","032"
"12239","PIACENZA D'ADIGE",557,0,0,557,"2014","062"
"12240","PIADENA",0,359,0,359,"2014","071"
"12241","PIAN CAMUNO",6,262,1,269,"2014","142"
"12242","PIANCOGNO",9,64,0,73,"2014","206"
"12243","PIANELLO DEL LARIO",4,2,7,13,"2014","183"
"12244","PIANELLO VAL TIDONE",370,71,0,441,"2014","033"
"12245","PIANENGO",2,143,0,145,"2014","072"
"12246","PIANEZZA",278,453,92,823,"2014","189"
"12247","PIANEZZE",171,65,0,236,"2014","077"
"12248","PIANFEI",793,67,32,892,"2014","165"
"12249","PIANICO",10,83,0,93,"2014","162"
"12250","PIANIGA",46,42,9,97,"2014","028"
"12251","PIANORO",146,236,0,382,"2014","047"
"12252","PIANTEDO",16,316,0,332,"2014","048"
"12253","PIARIO",0,33,0,33,"2014","163"
"12254","PIASCO",188,247,0,435,"2014","166"
"12255","PIATEDA",15,59,0,74,"2014","049"
"12256","PIATTO",15,0,0,15,"2014","043"
"12257","PIAZZA BREMBANA",0,3,0,3,"2014","164"
"12258","PIAZZATORRE",0,2,0,2,"2014","165"
"12259","PIAZZOLA SUL BRENTA",2351,1161,3,3515,"2014","063"
"12260","PIAZZOLO",18,0,0,18,"2014","166"
"12261","PIEA",61,0,0,61,"2014","084"
"12262","PIEDIMULERA",1,48,0,49,"2014","053"
"12263","PIERANICA",40,0,0,40,"2014","073"
"12264","PIETRA DE' GIORGI",22,0,0,22,"2014","111"
"12265","PIEVE D'ALPAGO",23,22,0,45,"2014","038"
"12266","PIEVE D'OLMI",0,1389,376,1765,"2014","074"
"12267","PIEVE DEL CAIRO",1,65,0,66,"2014","113"
"12268","PIEVE DI CADORE",2,13,0,15,"2014","039"
"12269","PIEVE DI CORIANO",0,0,88,88,"2014","040"
"12270","PIEVE DI SOLIGO",76,136,4,216,"2014","057"
"12271","PIEVE EMANUELE",0,314,97,411,"2014","173"
"12272","PIEVE FISSIRAGA",110,1212,0,1322,"2014","045"
"12273","PIEVE PORTO MORONE",88,0,0,88,"2014","114"
"12274","PIEVE SAN GIACOMO",1,1844,0,1845,"2014","075"
"12275","PIEVE VERGONTE",34,6,25,65,"2014","054"
"12276","PIEVEPELAGO",40,107,0,147,"2014","031"
"12277","PILA",2,0,0,2,"2014",NA
"12278","PINAROLO PO",2192,0,0,2192,"2014","115"
"12279","PINASCA",90,35,6,131,"2014","190"
"12280","PINCARA",218,0,0,218,"2014","036"
"12281","PINEROLO",1823,154,146,2123,"2014","191"
"12282","PINO D'ASTI",4,0,0,4,"2014","085"
"12283","PINO TORINESE",519,0,77,596,"2014","192"
"12284","PIOBESI TORINESE",430,1118,111,1659,"2014","193"
"12285","PIODE",0,19,0,19,"2014","097"
"12286","PIOLTELLO",10,0,0,10,"2014","175"
"12287","PIOMBINO DESE",5786,572,0,6358,"2014","064"
"12288","PIOSSASCO",519,439,154,1112,"2014","194"
"12289","PIOVA' MASSAIA",226,0,0,226,"2014","086"
"12290","PIOVE DI SACCO",2937,165,38,3140,"2014","065"
"12291","PIOVENE ROCCHETTE",1194,144,0,1338,"2014","078"
"12292","PIOVERA",94,294,0,388,"2014","130"
"12293","PIOZZANO",157,3,0,160,"2014","034"
"12294","PIOZZO",416,0,0,416,"2014","169"
"12295","PISCINA",1799,0,0,1799,"2014","195"
"12296","PISOGNE",9,251,0,260,"2014","143"
"12297","PIUBEGA",3063,616,60,3739,"2014","041"
"12298","PIURO",17,161,0,178,"2014","050"
"12299","PIVERONE",49,128,0,177,"2014","196"
"12300","PIZZIGHETTONE",107,3337,0,3444,"2014","076"
"12301","PLESIO",0,0,1,1,"2014","185"
"12302","POCAPAGLIA",429,55,0,484,"2014","170"
"12303","PODENZANO",112,769,0,881,"2014","035"
"12304","POGGIO RENATICO",4,376,0,380,"2014","018"
"12305","POGGIO RUSCO",565,386,107,1058,"2014","042"
"12306","POGGIO TORRIANA",234,0,0,234,"2014",NA
"12307","POGGIRIDENTI",3,7,0,10,"2014","051"
"12308","POGNANO",20,359,0,379,"2014","167"
"12309","POIRINO",3777,611,0,4388,"2014","197"
"12310","POJANA MAGGIORE",1408,28,0,1436,"2014","079"
"12311","POLAVENO",21,11,0,32,"2014","144"
"12312","POLESELLA",11,0,0,11,"2014","037"
"12313","POLESINE PARMENSE",7,356,0,363,"2014","029"
"12314","POLINAGO",61,683,0,744,"2014","032"
"12315","POLLONE",243,26,0,269,"2014","046"
"12316","POLONGHERA",253,191,0,444,"2014","171"
"12317","POLPENAZZE DEL GARDA",20,86,1,107,"2014","145"
"12318","POLVERARA",52,74,0,126,"2014","066"
"12319","POMARETTO",50,0,11,61,"2014","198"
"12320","POMARO MONFERRATO",7,0,198,205,"2014","131"
"12321","POMBIA",4,61,0,65,"2014","121"
"12322","POMPIANO",15,1324,0,1339,"2014","146"
"12323","POMPONESCO",4,460,9,473,"2014","043"
"12324","PONCARALE",447,797,110,1354,"2014","147"
"12325","PONDERANO",45,36,38,119,"2014","047"
"12326","PONNA",1,0,10,11,"2014","187"
"12327","PONSO",91,0,0,91,"2014","067"
"12328","PONT-CANAVESE",32,69,0,101,"2014","199"
"12329","PONTE DELL'OLIO",98,171,0,269,"2014","036"
"12330","PONTE DI LEGNO",2,16,0,18,"2014","148"
"12331","PONTE DI PIAVE",58,89,0,147,"2014","058"
"12332","PONTE IN VALTELLINA",13,14,0,27,"2014","052"
"12333","PONTE LAMBRO",3,27,0,30,"2014","188"
"12334","PONTE NELLE ALPI",36,208,0,244,"2014","040"
"12335","PONTE NIZZA",94,36,0,130,"2014","117"
"12336","PONTE NOSSA",0,27,0,27,"2014","168"
"12337","PONTE SAN NICOLO'",323,46,33,402,"2014","069"
"12338","PONTE SAN PIETRO",3,0,0,3,"2014","170"
"12339","PONTECCHIO POLESINE",985,0,0,985,"2014","038"
"12340","PONTECHIANALE",166,0,0,166,"2014","172"
"12341","PONTECURONE",2,0,0,2,"2014","132"
"12342","PONTELONGO",511,0,0,511,"2014","068"
"12343","PONTENURE",70,125,0,195,"2014","037"
"12344","PONTERANICA",4,0,0,4,"2014","169"
"12345","PONTESTURA",7,0,0,7,"2014","133"
"12346","PONTEVICO",184,2977,328,3489,"2014","149"
"12347","PONTI",97,0,12,109,"2014","134"
"12348","PONTI SUL MINCIO",209,426,39,674,"2014","044"
"12349","PONTIDA",30,0,0,30,"2014","171"
"12350","PONTIROLO NUOVO",352,484,0,836,"2014","172"
"12351","PONTOGLIO",882,1110,0,1992,"2014","150"
"12352","PONZANO MONFERRATO",34,0,0,34,"2014","135"
"12353","PONZANO VENETO",432,210,1,643,"2014","059"
"12354","PONZONE",36,11,0,47,"2014","136"
"12355","PORLEZZA",19,58,23,100,"2014","189"
"12356","PORRETTA TERME",57,0,0,57,"2014","049"
"12357","PORTACOMARO",55,0,0,55,"2014","087"
"12358","PORTALBERA",1,0,0,1,"2014","118"
"12359","PORTE",10,0,0,10,"2014","200"
"12360","PORTICO E SAN BENEDETTO",58,0,0,58,"2014","031"
"12361","PORTO CERESIO",1,0,0,1,"2014","113"
"12362","PORTO MANTOVANO",1118,746,2242,4106,"2014","045"
"12363","PORTO TOLLE",31,0,0,31,"2014","039"
"12364","PORTO VALTRAVAGLIA",5,0,3,8,"2014","114"
"12365","PORTO VIRO",3988,0,0,3988,"2014","052"
"12366","PORTOBUFFOLE'",5,0,14,19,"2014","060"
"12367","PORTOGRUARO",1017,95,2,1114,"2014","029"
"12368","PORTOMAGGIORE",531,432,0,963,"2014","019"
"12369","PORTULA",9,0,0,9,"2014","048"
"12370","POSINA",2,15,0,17,"2014","080"
"12371","POSSAGNO",11,14,0,25,"2014","061"
"12372","POSTALESIO",1,0,2,3,"2014","053"
"12373","POSTUA",3,4,0,7,"2014","102"
"12374","POVE DEL GRAPPA",12,29,0,41,"2014","081"
"12375","POVEGLIANO",82,211,72,365,"2014","062"
"12376","POVEGLIANO VERONESE",2024,619,20,2663,"2014","060"
"12377","POVIGLIO",19,1066,0,1085,"2014","029"
"12378","POZZAGLIO ED UNITI",22,2156,249,2427,"2014","077"
"12379","POZZO D'ADDA",185,0,0,185,"2014","177"
"12380","POZZOL GROPPO",31,0,0,31,"2014","137"
"12381","POZZOLENGO",655,581,49,1285,"2014","151"
"12382","POZZOLEONE",314,1791,0,2105,"2014","082"
"12383","POZZOLO FORMIGARO",19,0,122,141,"2014","138"
"12384","POZZONOVO",1418,0,0,1418,"2014","070"
"12385","POZZUOLO MARTESANA",28,906,0,934,"2014","178"
"12386","PRADALUNGA",23,0,0,23,"2014","173"
"12387","PRADLEVES",3,16,0,19,"2014","173"
"12388","PRAGELATO",19,0,0,19,"2014","201"
"12389","PRALBOINO",1522,860,4,2386,"2014","152"
"12390","PRALI",39,0,0,39,"2014","202"
"12391","PRALORMO",1228,288,0,1516,"2014","203"
"12392","PRALUNGO",82,0,26,108,"2014","049"
"12393","PRAMAGGIORE",15,53,0,68,"2014","030"
"12394","PRAMOLLO",5,0,0,5,"2014","204"
"12395","PRAROSTINO",30,6,0,36,"2014","205"
"12396","PRASCO",19,0,0,19,"2014","139"
"12397","PRASCORSANO",3,0,0,3,"2014","206"
"12398","PRATA CAMPORTACCIO",38,152,11,201,"2014","054"
"12399","PRATIGLIONE",3,0,0,3,"2014","207"
"12400","PRATO SESIA",0,5,0,5,"2014","122"
"12401","PRAY",40,0,0,40,"2014","050"
"12402","PRAZZO",151,46,24,221,"2014","174"
"12403","PREDAPPIO",130,37,0,167,"2014","032"
"12404","PREDORE",27,0,0,27,"2014","174"
"12405","PREDOSA",152,71,0,223,"2014","140"
"12406","PREGANZIOL",16,203,0,219,"2014","063"
"12407","PREGNANA MILANESE",15,103,0,118,"2014","179"
"12408","PREMANA",18,2,4,24,"2014","069"
"12409","PREMENO",9,0,0,9,"2014","055"
"12410","PREMIA",15,206,0,221,"2014","056"
"12411","PREMILCUORE",304,0,37,341,"2014","033"
"12412","PREMOLO",19,15,0,34,"2014","175"
"12413","PREMOSELLO-CHIOVENDA",20,0,13,33,"2014","057"
"12414","PRESEGLIE",49,2,0,51,"2014","153"
"12415","PRESEZZO",4,0,0,4,"2014",NA
"12416","PRESSANA",3340,88,0,3428,"2014","061"
"12417","PRESTINE",3,72,5,80,"2014","154"
"12418","PREVALLE",135,555,8,698,"2014","155"
"12419","PRIERO",22,0,0,22,"2014","175"
"12420","PRIGNANO SULLA SECCHIA",136,1122,16,1274,"2014","033"
"12421","PRIMALUNA",11,60,2,73,"2014","070"
"12422","PRIOCCA",743,0,0,743,"2014","176"
"12423","PRIOLA",77,0,0,77,"2014","177"
"12424","PROSERPIO",5,4,0,9,"2014","192"
"12425","PROVAGLIO D'ISEO",58,177,9,244,"2014","156"
"12426","PROVAGLIO VAL SABBIA",38,0,3,41,"2014","157"
"12427","PRUNETTO",72,0,0,72,"2014","178"
"12428","PUEGNAGO SUL GARDA",15,106,0,121,"2014","158"
"12429","PUMENENGO",1276,487,154,1917,"2014","177"
"12430","PUOS D'ALPAGO",5,137,0,142,"2014","041"
"12431","PUSIANO",0,0,3,3,"2014","193"
"12432","QUAGLIUZZO",13,0,0,13,"2014","208"
"12433","QUAREGNA",3,0,0,3,"2014","051"
"12434","QUARGNENTO",707,0,0,707,"2014","141"
"12435","QUARNA SOPRA",2,0,0,2,"2014","058"
"12436","QUARNA SOTTO",4,0,0,4,"2014","059"
"12437","QUARONA",25,4,0,29,"2014","107"
"12438","QUARTO D'ALTINO",98,92,0,190,"2014","031"
"12439","QUASSOLO",31,29,9,69,"2014","209"
"12440","QUATTORDIO",652,0,0,652,"2014","142"
"12441","QUATTRO CASTELLA",29,1442,0,1471,"2014","030"
"12442","QUERO VAS",45,82,16,143,"2014",NA
"12443","QUINCINETTO",32,35,0,67,"2014","210"
"12444","QUINGENTOLE",340,81,125,546,"2014","046"
"12445","QUINTANO",0,284,0,284,"2014","078"
"12446","QUINTO DI TREVISO",171,235,40,446,"2014","064"
"12447","QUINTO VERCELLESE",33,0,0,33,"2014","108"
"12448","QUINTO VICENTINO",133,594,57,784,"2014","083"
"12449","QUINZANO D'OGLIO",238,3052,0,3290,"2014","159"
"12450","QUISTELLO",260,1687,663,2610,"2014","047"
"12451","QUITTENGO",2,0,0,2,"2014","052"
"12452","RACCONIGI",1434,2090,80,3604,"2014","179"
"12453","RAMISETO",33,246,3,282,"2014","031"
"12454","RAMPONIO VERNA",8,5,1,14,"2014","194"
"12455","RANCIO VALCUVIA",2,1,0,3,"2014","115"
"12456","RANCO",0,0,27,27,"2014","116"
"12457","RANICA",23,16,0,39,"2014","178"
"12458","RANZANICO",11,22,0,33,"2014","179"
"12459","RASSA",0,28,0,28,"2014","110"
"12460","RAVENNA",1153,1413,0,2566,"2014","014"
"12461","RE",24,0,0,24,"2014","060"
"12462","REANO",23,0,0,23,"2014","211"
"12463","RECOARO TERME",57,92,0,149,"2014","084"
"12464","REDAVALLE",95,0,0,95,"2014","120"
"12465","REDONDESCO",160,346,476,982,"2014","048"
"12466","REFRANCORE",68,0,0,68,"2014","089"
"12467","REFRONTOLO",25,34,0,59,"2014","065"
"12468","REGGIO NELL'EMILIA",47,11478,8,11533,"2014","033"
"12469","REGGIOLO",1070,2505,0,3575,"2014","032"
"12470","REMEDELLO",6908,2588,41,9537,"2014","160"
"12471","RENATE",3,0,2,5,"2014",NA
"12472","RESANA",2353,50,15,2418,"2014","066"
"12473","REVELLO",6117,1979,0,8096,"2014","180"
"12474","REVERE",1,122,2,125,"2014","049"
"12475","REVIGLIASCO D'ASTI",240,0,0,240,"2014","090"
"12476","REVINE LAGO",19,25,0,44,"2014","067"
"12477","REZZATO",170,586,0,756,"2014","161"
"12478","RHO",5,340,0,345,"2014","182"
"12479","RIBORDONE",3,0,0,3,"2014","212"
"12480","RICCIONE",3,0,0,3,"2014","013"
"12481","RICENGO",39,1908,0,1947,"2014","079"
"12482","RIESE PIO X",6690,438,33,7161,"2014","068"
"12483","RIFREDDO",647,88,0,735,"2014","181"
"12484","RIMA SAN GIUSEPPE",8,0,0,8,"2014","111"
"12485","RIMASCO",0,4,0,4,"2014","112"
"12486","RIMELLA",4,6,9,19,"2014","113"
"12487","RIMINI",118,94,0,212,"2014","014"
"12488","RIO SALICETO",851,540,0,1391,"2014","034"
"12489","RIOLO TERME",307,0,0,307,"2014","015"
"12490","RIOLUNATO",57,39,0,96,"2014","035"
"12491","RIPALTA ARPINA",63,299,0,362,"2014","080"
"12492","RIPALTA CREMASCA",4,278,0,282,"2014","081"
"12493","RIPALTA GUERINA",2,517,0,519,"2014","082"
"12494","RIVA DI SOLTO",14,0,0,14,"2014","180"
"12495","RIVA PRESSO CHIERI",3430,60,73,3563,"2014","215"
"12496","RIVA VALDOBBIA",6,30,2,38,"2014","114"
"12497","RIVALBA",95,0,0,95,"2014","213"
"12498","RIVALTA DI TORINO",151,5,0,156,"2014","214"
"12499","RIVAMONTE AGORDINO",33,3,0,36,"2014","043"
"12500","RIVANAZZANO",168,0,0,168,"2014","122"
"12501","RIVARA",72,118,0,190,"2014","216"
"12502","RIVAROLO CANAVESE",809,804,199,1812,"2014","217"
"12503","RIVAROLO DEL RE ED UNITI",2539,381,0,2920,"2014","083"
"12504","RIVAROLO MANTOVANO",95,1089,207,1391,"2014","050"
"12505","RIVAROSSA",13,142,0,155,"2014","218"
"12506","RIVERGARO",90,1026,0,1116,"2014","038"
"12507","RIVOLI",1568,0,109,1677,"2014","219"
"12508","RIVOLI VERONESE",171,21,0,192,"2014","062"
"12509","RIVOLTA D'ADDA",2153,2741,0,4894,"2014","084"
"12510","RO",9,62,0,71,"2014","020"
"12511","ROANA",24,454,6,484,"2014","085"
"12512","ROASCIO",17,0,0,17,"2014","184"
"12513","ROASIO",17,0,0,17,"2014","116"
"12514","ROATTO",100,0,0,100,"2014","091"
"12515","ROBASSOMERO",37,71,0,108,"2014","220"
"12516","ROBBIATE",0,8,0,8,"2014",NA
"12517","ROBBIO",1,201,0,202,"2014","123"
"12518","ROBECCHETTO CON INDUNO",201,215,0,416,"2014","183"
"12519","ROBECCO D'OGLIO",22,2841,0,2863,"2014","085"
"12520","ROBECCO PAVESE",6,0,0,6,"2014","124"
"12521","ROBECCO SUL NAVIGLIO",103,483,157,743,"2014","184"
"12522","ROBELLA",316,0,0,316,"2014","092"
"12523","ROBILANTE",138,0,0,138,"2014","185"
"12524","ROBURENT",23,0,0,23,"2014","186"
"12525","ROCCA CANAVESE",69,0,0,69,"2014","221"
"12526","ROCCA CIGLIE'",49,0,0,49,"2014","188"
"12527","ROCCA D'ARAZZO",400,0,0,400,"2014","093"
"12528","ROCCA DE' BALDI",2566,1267,274,4107,"2014","189"
"12529","ROCCA GRIMALDA",18,0,0,18,"2014","147"
"12530","ROCCA PIETORE",0,6,0,6,"2014","044"
"12531","ROCCA SAN CASCIANO",127,0,0,127,"2014","036"
"12532","ROCCABIANCA",0,841,0,841,"2014","030"
"12533","ROCCABRUNA",119,0,46,165,"2014","187"
"12534","ROCCAFORTE LIGURE",45,0,0,45,"2014","146"
"12535","ROCCAFORTE MONDOVI'",596,11,3,610,"2014","190"
"12536","ROCCAFRANCA",1476,1293,50,2819,"2014","162"
"12537","ROCCASPARVERA",212,0,0,212,"2014","191"
"12538","ROCCAVERANO",206,0,0,206,"2014","094"
"12539","ROCCAVIONE",36,0,0,36,"2014","192"
"12540","ROCCHETTA LIGURE",22,0,0,22,"2014","148"
"12541","ROCCHETTA PALAFEA",10,0,0,10,"2014","095"
"12542","ROCCHETTA TANARO",369,0,0,369,"2014","096"
"12543","RODANO",20,128,0,148,"2014","185"
"12544","RODDI",85,26,0,111,"2014","194"
"12545","RODDINO",90,0,0,90,"2014","195"
"12546","RODELLO",111,0,0,111,"2014","196"
"12547","RODENGO-SAIANO",7,228,183,418,"2014","163"
"12548","RODERO",6,3,0,9,"2014",NA
"12549","RODIGO",1037,791,1444,3272,"2014","051"
"12550","ROE' VOLCIANO",9,0,0,9,"2014","164"
"12551","ROGENO",125,216,0,341,"2014","072"
"12552","ROGNANO",17,0,0,17,"2014","127"
"12553","ROGNO",6,107,0,113,"2014","182"
"12554","ROGOLO",4,23,0,27,"2014","056"
"12555","ROLETTO",204,77,0,281,"2014","222"
"12556","ROLO",0,237,0,237,"2014","035"
"12557","ROMAGNANO SESIA",35,0,0,35,"2014","130"
"12558","ROMAGNESE",130,0,0,130,"2014","128"
"12559","ROMANENGO",0,2005,0,2005,"2014","086"
"12560","ROMANO CANAVESE",29,0,0,29,"2014","223"
"12561","ROMANO D'EZZELINO",243,474,0,717,"2014","086"
"12562","ROMANO DI LOMBARDIA",207,3114,0,3321,"2014","183"
"12563","ROMENTINO",14,0,0,14,"2014","131"
"12564","RONAGO",1,51,0,52,"2014","199"
"12565","RONCA'",9,3,0,12,"2014","063"
"12566","RONCADE",2061,121,0,2182,"2014","069"
"12567","RONCADELLE",312,676,0,988,"2014","165"
"12568","RONCARO",1,0,0,1,"2014","129"
"12569","RONCELLO",1,0,0,1,"2014",NA
"12570","RONCO ALL'ADIGE",6643,0,0,6643,"2014","064"
"12571","RONCO BIELLESE",4,61,0,65,"2014","053"
"12572","RONCO BRIANTINO",0,129,0,129,"2014",NA
"12573","RONCO CANAVESE",58,0,0,58,"2014","224"
"12574","RONCOFERRARO",2668,421,633,3722,"2014","052"
"12575","RONCOFREDDO",26,47,0,73,"2014","037"
"12576","RONCOLA",31,29,0,60,"2014","185"
"12577","RONDISSONE",10,0,0,10,"2014","225"
"12578","RONSECCO",3,0,0,3,"2014",NA
"12579","ROPPOLO",9,0,0,9,"2014","054"
"12580","RORA'",27,0,0,27,"2014","226"
"12581","ROSA'",151,972,0,1123,"2014","087"
"12582","ROSASCO",3,0,0,3,"2014","130"
"12583","ROSATE",2427,527,0,2954,"2014","188"
"12584","ROSIGNANO MONFERRATO",125,0,0,125,"2014","149"
"12585","ROSOLINA",25,0,0,25,"2014","040"
"12586","ROSSA",2,7,0,9,"2014","121"
"12587","ROSSANA",77,108,0,185,"2014","197"
"12588","ROSSANO VENETO",301,205,15,521,"2014","088"
"12589","ROSTA",8,0,88,96,"2014","228"
"12590","ROTA D'IMAGNA",22,35,2,59,"2014","186"
"12591","ROTTOFRENO",273,686,0,959,"2014","039"
"12592","ROTZO",84,0,0,84,"2014","089"
"12593","ROURE",12,0,0,12,"2014","227"
"12594","ROVAGNATE",15,0,7,22,"2014","073"
"12595","ROVASENDA",15,0,0,15,"2014","122"
"12596","ROVATO",1627,1992,55,3674,"2014","166"
"12597","ROVELLASCA",7,66,0,73,"2014","201"
"12598","ROVELLO PORRO",2,0,0,2,"2014",NA
"12599","ROVERBELLA",13884,555,436,14875,"2014","053"
"12600","ROVERCHIARA",4722,25,0,4747,"2014","065"
"12601","ROVERE' VERONESE",210,1280,0,1490,"2014","067"
"12602","ROVEREDO DI GUA'",1563,71,0,1634,"2014","066"
"12603","ROVESCALA",16,0,0,16,"2014","131"
"12604","ROVETTA",34,126,0,160,"2014","187"
"12605","ROVIGO",1522,0,0,1522,"2014","041"
"12606","ROVOLON",204,22,65,291,"2014","071"
"12607","ROZZANO",0,1,0,1,"2014","189"
"12608","RUBANO",48,46,47,141,"2014","072"
"12609","RUBIANA",4,0,0,4,"2014","229"
"12610","RUBIERA",1,540,0,541,"2014","036"
"12611","RUDIANO",563,1143,0,1706,"2014","167"
"12612","RUEGLIO",96,97,0,193,"2014","230"
"12613","RUFFIA",254,345,0,599,"2014","198"
"12614","RUINO",101,0,0,101,"2014","132"
"12615","RUSSI",11,85,0,96,"2014","016"
"12616","SABBIO CHIESE",26,27,3,56,"2014","168"
"12617","SABBIONETA",7,105,32,144,"2014","054"
"12618","SACCOLONGO",77,472,79,628,"2014","073"
"12619","SAGLIANO MICCA",35,0,0,35,"2014","056"
"12620","SALA BAGANZA",4,86,0,90,"2014","031"
"12621","SALA BIELLESE",2,0,0,2,"2014","057"
"12622","SALA BOLOGNESE",266,81,0,347,"2014","050"
"12623","SALA COMACINA",1,0,4,5,"2014","203"
"12624","SALARA",3,0,0,3,"2014","042"
"12625","SALASSA",14,0,0,14,"2014","231"
"12626","SALBERTRAND",37,0,0,37,"2014","232"
"12627","SALCEDO",698,55,0,753,"2014","090"
"12628","SALE",20,0,0,20,"2014","151"
"12629","SALE DELLE LANGHE",63,0,0,63,"2014","199"
"12630","SALE MARASINO",61,24,0,85,"2014","169"
"12631","SALE SAN GIOVANNI",58,0,0,58,"2014","200"
"12632","SALERANO SUL LAMBRO",4,206,0,210,"2014","046"
"12633","SALETTO",13,33,0,46,"2014","074"
"12634","SALGAREDA",2145,361,0,2506,"2014","070"
"12635","SALICETO",79,0,0,79,"2014","201"
"12636","SALIZZOLE",1927,541,2,2470,"2014","068"
"12637","SALMOUR",201,0,0,201,"2014","202"
"12638","SALO'",2,38,0,40,"2014","170"
"12639","SALSOMAGGIORE TERME",27,1141,16,1184,"2014","032"
"12640","SALTRIO",48,0,0,48,"2014","117"
"12641","SALUDECIO",106,54,0,160,"2014","015"
"12642","SALUGGIA",528,189,0,717,"2014","128"
"12643","SALUSSOLA",377,98,0,475,"2014","058"
"12644","SALUZZO",3022,3803,0,6825,"2014","203"
"12645","SALVIROLA",684,94,0,778,"2014","087"
"12646","SALZANO",140,26,3,169,"2014","032"
"12647","SAMARATE",47,0,0,47,"2014","118"
"12648","SAMBUCO",16,0,0,16,"2014","204"
"12649","SAMOLACO",166,729,12,907,"2014","057"
"12650","SAMONE",13,0,4,17,"2014","235"
"12651","SAMPEYRE",251,50,0,301,"2014","205"
"12652","SAN BARTOLOMEO VAL CAVARGNA",8,0,7,15,"2014","204"
"12653","SAN BASSANO",13,1748,0,1761,"2014","088"
"12654","SAN BELLINO",2074,0,0,2074,"2014","043"
"12655","SAN BENEDETTO BELBO",25,78,0,103,"2014","206"
"12656","SAN BENEDETTO PO",481,1699,1574,3754,"2014","055"
"12657","SAN BENEDETTO VAL DI SAMBRO",224,146,0,370,"2014","051"
"12658","SAN BENIGNO CANAVESE",285,0,33,318,"2014","236"
"12659","SAN BERNARDINO VERBANO",3,0,0,3,"2014","061"
"12660","SAN BIAGIO DI CALLALTA",196,52,0,248,"2014","071"
"12661","SAN BONIFACIO",2257,0,0,2257,"2014","069"
"12662","SAN CARLO CANAVESE",231,326,0,557,"2014","237"
"12663","SAN CESARIO SUL PANARO",27,623,0,650,"2014","036"
"12664","SAN CIPRIANO PO",38,0,0,38,"2014","133"
"12665","SAN CLEMENTE",20,0,0,20,"2014","016"
"12666","SAN COLOMBANO AL LAMBRO",30,385,0,415,"2014","191"
"12667","SAN COLOMBANO BELMONTE",8,13,0,21,"2014","238"
"12668","SAN CRISTOFORO",19,0,0,19,"2014","152"
"12669","SAN DAMIANO D'ASTI",4225,0,0,4225,"2014","097"
"12670","SAN DAMIANO MACRA",43,0,0,43,"2014","207"
"12671","SAN DANIELE PO",39,1459,0,1498,"2014","089"
"12672","SAN DIDERO",0,8,0,8,"2014","239"
"12673","SAN DONA' DI PIAVE",355,461,11,827,"2014","033"
"12674","SAN DONATO MILANESE",9,0,0,9,"2014","192"
"12675","SAN FEDELE INTELVI",18,11,9,38,"2014","205"
"12676","SAN FELICE DEL BENACO",4,0,0,4,"2014","171"
"12677","SAN FELICE SUL PANARO",0,834,0,834,"2014","037"
"12678","SAN FERMO DELLA BATTAGLIA",11,0,20,31,"2014","206"
"12679","SAN FIOR",33,59,0,92,"2014","072"
"12680","SAN FIORANO",0,103,0,103,"2014","047"
"12681","SAN FRANCESCO AL CAMPO",499,371,0,870,"2014","240"
"12682","SAN GENESIO ED UNITI",5,427,0,432,"2014","135"
"12683","SAN GERMANO CHISONE",50,29,0,79,"2014","242"
"12684","SAN GERMANO DEI BERICI",350,290,0,640,"2014","092"
"12685","SAN GERMANO VERCELLESE",21,0,0,21,"2014","131"
"12686","SAN GERVASIO BRESCIANO",1,254,0,255,"2014","172"
"12687","SAN GIACOMO DELLE SEGNATE",266,142,195,603,"2014","056"
"12688","SAN GIACOMO FILIPPO",3,0,0,3,"2014","058"
"12689","SAN GIACOMO VERCELLESE",1770,0,0,1770,"2014","035"
"12690","SAN GILLIO",158,82,0,240,"2014","243"
"12691","SAN GIORGIO CANAVESE",343,50,0,393,"2014","244"
"12692","SAN GIORGIO DELLE PERTICHE",292,117,0,409,"2014","075"
"12693","SAN GIORGIO DI LOMELLINA",9,0,0,9,"2014","136"
"12694","SAN GIORGIO DI MANTOVA",391,126,11,528,"2014","057"
"12695","SAN GIORGIO DI PIANO",16,0,0,16,"2014","052"
"12696","SAN GIORGIO IN BOSCO",286,950,0,1236,"2014","076"
"12697","SAN GIORGIO MONFERRATO",15,0,0,15,"2014","153"
"12698","SAN GIORGIO PIACENTINO",301,717,0,1018,"2014","040"
"12699","SAN GIORGIO SCARAMPI",95,0,0,95,"2014","098"
"12700","SAN GIORIO DI SUSA",8,41,0,49,"2014","245"
"12701","SAN GIOVANNI BIANCO",52,33,0,85,"2014","188"
"12702","SAN GIOVANNI DEL DOSSO",0,307,88,395,"2014","058"
"12703","SAN GIOVANNI ILARIONE",627,18,0,645,"2014","070"
"12704","SAN GIOVANNI IN CROCE",0,462,3,465,"2014","090"
"12705","SAN GIOVANNI IN MARIGNANO",11,0,0,11,"2014","017"
"12706","SAN GIOVANNI IN PERSICETO",129,792,0,921,"2014","053"
"12707","SAN GIOVANNI LUPATOTO",509,23,0,532,"2014","071"
"12708","SAN GIULIANO MILANESE",10,516,0,526,"2014","195"
"12709","SAN GIUSTO CANAVESE",102,37,0,139,"2014","246"
"12710","SAN GREGORIO NELLE ALPI",27,64,0,91,"2014","045"
"12711","SAN LAZZARO DI SAVENA",10,8,0,18,"2014","054"
"12712","SAN LEO",246,307,0,553,"2014","025"
"12713","SAN MARTINO ALFIERI",13,0,0,13,"2014","099"
"12714","SAN MARTINO BUON ALBERGO",281,996,0,1277,"2014","073"
"12715","SAN MARTINO CANAVESE",43,0,0,43,"2014","247"
"12716","SAN MARTINO DALL'ARGINE",343,801,41,1185,"2014","059"
"12717","SAN MARTINO DEL LAGO",15,0,0,15,"2014","091"
"12718","SAN MARTINO DI LUPARI",1581,415,0,1996,"2014","077"
"12719","SAN MARTINO IN RIO",0,781,0,781,"2014","037"
"12720","SAN MARTINO IN STRADA",3,990,0,993,"2014","048"
"12721","SAN MARTINO SICCOMARIO",1,3,0,4,"2014","137"
"12722","SAN MARZANO OLIVETO",54,0,0,54,"2014","100"
"12723","SAN MAURIZIO CANAVESE",140,562,27,729,"2014","248"
"12724","SAN MAURIZIO D'OPAGLIO",17,0,0,17,"2014","133"
"12725","SAN MAURO DI SALINE",57,324,25,406,"2014","074"
"12726","SAN MAURO PASCOLI",2,0,0,2,"2014","041"
"12727","SAN MAURO TORINESE",18,0,0,18,"2014","249"
"12728","SAN MICHELE AL TAGLIAMENTO",2173,36,0,2209,"2014","034"
"12729","SAN MICHELE MONDOVI'",152,0,0,152,"2014","210"
"12730","SAN NAZARIO",16,0,0,16,"2014","093"
"12731","SAN NAZZARO SESIA",120,0,0,120,"2014","134"
"12732","SAN NAZZARO VAL CAVARGNA",8,0,4,12,"2014","207"
"12733","SAN NICOLO' DI COMELICO",0,6,0,6,"2014","046"
"12734","SAN PAOLO",392,2124,27,2543,"2014","138"
"12735","SAN PAOLO CERVO",1,0,0,1,"2014","060"
"12736","SAN PAOLO D'ARGON",33,31,0,64,"2014","189"
"12737","SAN PAOLO SOLBRITO",19,0,0,19,"2014","101"
"12738","SAN PELLEGRINO TERME",50,40,0,90,"2014","190"
"12739","SAN PIETRO DI CADORE",5,55,0,60,"2014","047"
"12740","SAN PIETRO DI FELETTO",21,22,0,43,"2014","073"
"12741","SAN PIETRO IN CASALE",34,125,0,159,"2014","055"
"12742","SAN PIETRO IN CERRO",82,715,0,797,"2014","041"
"12743","SAN PIETRO IN GU",936,3152,0,4088,"2014","078"
"12744","SAN PIETRO MOSEZZO",13,0,0,13,"2014","135"
"12745","SAN PIETRO MUSSOLINO",15,0,0,15,"2014","094"
"12746","SAN PIETRO VAL LEMINA",2,0,0,2,"2014","250"
"12747","SAN PIETRO VIMINARIO",484,194,0,678,"2014","079"
"12748","SAN POLO D'ENZA",6,751,0,757,"2014","038"
"12749","SAN POLO DI PIAVE",820,82,1,903,"2014","074"
"12750","SAN PONSO",1,45,0,46,"2014","251"
"12751","SAN POSSIDONIO",520,375,0,895,"2014","038"
"12752","SAN PROSPERO",5,465,0,470,"2014","039"
"12753","SAN RAFFAELE CIMENA",35,0,0,35,"2014","252"
"12754","SAN ROCCO AL PORTO",288,488,0,776,"2014","049"
"12755","SAN SALVATORE MONFERRATO",177,0,0,177,"2014","154"
"12756","SAN SEBASTIANO CURONE",9,0,0,9,"2014","155"
"12757","SAN SEBASTIANO DA PO",294,0,0,294,"2014","253"
"12758","SAN SECONDO DI PINEROLO",597,57,69,723,"2014","254"
"12759","SAN SECONDO PARMENSE",7,1536,0,1543,"2014","033"
"12760","SAN SIRO",0,0,4,4,"2014","248"
"12761","SAN VENDEMIANO",98,175,0,273,"2014","076"
"12762","SAN VITO DI LEGUZZANO",425,129,0,554,"2014","096"
"12763","SAN VITTORE OLONA",38,30,0,68,"2014","201"
"12764","SAN ZENO DI MONTAGNA",145,283,79,507,"2014","079"
"12765","SAN ZENO NAVIGLIO",1,541,0,542,"2014","173"
"12766","SAN ZENONE AL LAMBRO",0,789,0,789,"2014","202"
"12767","SAN ZENONE DEGLI EZZELINI",2157,608,2,2767,"2014","077"
"12768","SANDIGLIANO",53,62,0,115,"2014","059"
"12769","SANDRIGO",1676,1485,0,3161,"2014","091"
"12770","SANFRE'",778,72,0,850,"2014","208"
"12771","SANFRONT",1831,217,0,2048,"2014","209"
"12772","SANGANO",117,0,28,145,"2014","241"
"12773","SANGIANO",4,24,0,28,"2014","141"
"12774","SANGUINETTO",1,124,0,125,"2014","072"
"12775","SANNAZZARO DE' BURGONDI",14,37,0,51,"2014","138"
"12776","SANT'AGATA BOLOGNESE",10,523,0,533,"2014","056"
"12777","SANT'AGATA FELTRIA",218,55,0,273,"2014","026"
"12778","SANT'AGATA FOSSILI",80,0,0,80,"2014","156"
"12779","SANT'AGATA SUL SANTERNO",27,1,0,28,"2014","017"
"12780","SANT'ALBANO STURA",4205,661,120,4986,"2014","211"
"12781","SANT'AMBROGIO DI TORINO",57,16,21,94,"2014","255"
"12782","SANT'AMBROGIO DI VALPOLICELLA",3,51,0,54,"2014","077"
"12783","SANT'ANGELO DI PIOVE DI SACCO",302,39,0,341,"2014","082"
"12784","SANT'ANGELO LODIGIANO",44,294,0,338,"2014","050"
"12785","SANT'ANGELO LOMELLINA",0,290,0,290,"2014","144"
"12786","SANT'ANNA D'ALFAEDO",222,1448,23,1693,"2014","078"
"12787","SANT'ANTONINO DI SUSA",10,38,36,84,"2014","256"
"12788","SANT'ELENA",56,0,0,56,"2014","083"
"12789","SANT'ILARIO D'ENZA",1,690,0,691,"2014","039"
"12790","SANT'OMOBONO TERME",77,36,0,113,"2014","192"
"12791","SANT'URBANO",536,0,1,537,"2014","084"
"12792","SANTA BRIGIDA",5,30,0,35,"2014","191"
"12793","SANTA CRISTINA E BISSONE",52,214,12,278,"2014","139"
"12794","SANTA GIULETTA",22,0,0,22,"2014","140"
"12795","SANTA GIUSTINA",307,138,0,445,"2014","048"
"12796","SANTA GIUSTINA IN COLLE",1221,405,7,1633,"2014","080"
"12797","SANTA LUCIA DI PIAVE",71,109,12,192,"2014","075"
"12798","SANTA MARGHERITA D'ADIGE",745,0,28,773,"2014","081"
"12799","SANTA MARGHERITA DI STAFFORA",71,0,0,71,"2014","142"
"12800","SANTA MARIA DELLA VERSA",2,0,0,2,"2014","143"
"12801","SANTA MARIA DI SALA",79,161,11,251,"2014","035"
"12802","SANTA MARIA HOE'",4,0,0,4,"2014","074"
"12803","SANTA MARIA MAGGIORE",41,0,19,60,"2014","062"
"12804","SANTA SOFIA",237,1,4,242,"2014","043"
"12805","SANTA VITTORIA D'ALBA",53,0,0,53,"2014","212"
"12806","SANTARCANGELO DI ROMAGNA",30,0,0,30,"2014","018"
"12807","SANTENA",547,0,0,547,"2014","257"
"12808","SANTHIA'",263,103,0,366,"2014","133"
"12809","SANTO STEFANO BELBO",7,0,0,7,"2014","213"
"12810","SANTO STEFANO DI CADORE",4,31,0,35,"2014","050"
"12811","SANTO STEFANO LODIGIANO",26,305,0,331,"2014","051"
"12812","SANTO STEFANO ROERO",122,0,0,122,"2014","214"
"12813","SANTO STEFANO TICINO",0,65,0,65,"2014","200"
"12814","SANTO STINO DI LIVENZA",3064,89,0,3153,"2014","036"
"12815","SANTORSO",441,213,0,654,"2014","095"
"12816","SAONARA",183,7,2,192,"2014","085"
"12817","SAPPADA",8,63,0,71,"2014","052"
"12818","SARCEDO",1508,377,0,1885,"2014","097"
"12819","SARDIGLIANO",3,0,0,3,"2014","157"
"12820","SAREGO",366,25,0,391,"2014","098"
"12821","SAREZZO",20,21,0,41,"2014","174"
"12822","SARMATO",9,210,0,219,"2014","042"
"12823","SARMEDE",54,55,0,109,"2014","078"
"12824","SARNICO",10,0,0,10,"2014","193"
"12825","SARONNO",0,0,1,1,"2014","119"
"12826","SARSINA",122,1,0,123,"2014","044"
"12827","SARTIRANA LOMELLINA",6,0,0,6,"2014","146"
"12828","SASSO MARCONI",73,1,0,74,"2014","057"
"12829","SASSUOLO",45,410,0,455,"2014","040"
"12830","SAUZE DI CESANA",16,0,0,16,"2014","258"
"12831","SAVIGLIANO",9282,5156,143,14581,"2014","215"
"12832","SAVIGNANO SUL PANARO",11,82,0,93,"2014","041"
"12833","SAVIGNANO SUL RUBICONE",33,0,0,33,"2014","045"
"12834","SAVIORE DELL'ADAMELLO",6,40,3,49,"2014","175"
"12835","SCAGNELLO",143,0,0,143,"2014","216"
"12836","SCALDASOLE",13,71,0,84,"2014","147"
"12837","SCALENGHE",1408,1938,389,3735,"2014","260"
"12838","SCANDIANO",22,1381,2,1405,"2014","040"
"12839","SCANDOLARA RAVARA",0,630,0,630,"2014","092"
"12840","SCANDOLARA RIPA D'OGLIO",11,799,87,897,"2014","093"
"12841","SCANZOROSCIATE",52,9,0,61,"2014","194"
"12842","SCARMAGNO",9,0,0,9,"2014","261"
"12843","SCARNAFIGI",1277,1671,0,2948,"2014","217"
"12844","SCHIAVON",2008,1773,6,3787,"2014","099"
"12845","SCHIGNANO",3,4,14,21,"2014","211"
"12846","SCHILPARIO",0,65,0,65,"2014","195"
"12847","SCHIO",349,280,10,639,"2014","100"
"12848","SCHIVENOGLIA",0,10,0,10,"2014","060"
"12849","SCIOLZE",131,0,0,131,"2014","262"
"12850","SCOPELLO",10,3,0,13,"2014","135"
"12851","SCORZE'",3396,119,0,3515,"2014","037"
"12852","SECUGNAGO",13,1283,0,1296,"2014","052"
"12853","SEDICO",1437,139,0,1576,"2014","053"
"12854","SEDRIANO",23,479,154,656,"2014","204"
"12855","SEDRINA",21,14,0,35,"2014","196"
"12856","SEGRATE",24,0,0,24,"2014","205"
"12857","SEGUSINO",5,76,0,81,"2014","079"
"12858","SELLERO",4,31,3,38,"2014","176"
"12859","SELVA DI CADORE",0,9,0,9,"2014","054"
"12860","SELVA DI PROGNO",58,689,71,818,"2014","080"
"12861","SELVAZZANO DENTRO",11,0,72,83,"2014","086"
"12862","SELVINO",1,0,0,1,"2014","197"
"12863","SENAGO",2,0,0,2,"2014",NA
"12864","SENIGA",1929,1842,0,3771,"2014","177"
"12865","SENNA COMASCO",31,111,35,177,"2014","212"
"12866","SENNA LODIGIANA",12,910,0,922,"2014","053"
"12867","SEREGNO",14,0,0,14,"2014",NA
"12868","SEREN DEL GRAPPA",64,35,195,294,"2014","055"
"12869","SERGNANO",4,1392,8,1404,"2014","094"
"12870","SERIATE",938,77,0,1015,"2014","198"
"12871","SERINA",20,76,0,96,"2014","199"
"12872","SERLE",29,54,0,83,"2014","178"
"12873","SERMIDE",1,244,148,393,"2014","061"
"12874","SERNAGLIA DELLA BATTAGLIA",256,25,4,285,"2014","080"
"12875","SERNIO",3,0,0,3,"2014","059"
"12876","SEROLE",78,0,3,81,"2014","104"
"12877","SERRALUNGA D'ALBA",25,0,0,25,"2014","218"
"12878","SERRALUNGA DI CREA",11,0,0,11,"2014","159"
"12879","SERRAMAZZONI",36,1698,0,1734,"2014","042"
"12880","SERRAVALLE A PO",17,24,148,189,"2014","062"
"12881","SERRAVALLE LANGHE",127,0,0,127,"2014","219"
"12882","SERRAVALLE SCRIVIA",4,0,3,7,"2014","160"
"12883","SERRAVALLE SESIA",3,0,0,3,"2014","137"
"12884","SESTO CALENDE",30,0,0,30,"2014","120"
"12885","SESTO ED UNITI",6,1213,365,1584,"2014","095"
"12886","SESTOLA",57,352,18,427,"2014","043"
"12887","SETTALA",57,198,0,255,"2014","210"
"12888","SETTIME",211,0,0,211,"2014","106"
"12889","SETTIMO MILANESE",50,362,2,414,"2014","211"
"12890","SETTIMO ROTTARO",4,49,0,53,"2014","264"
"12891","SETTIMO TORINESE",309,293,179,781,"2014","265"
"12892","SETTIMO VITTONE",185,203,2,390,"2014","266"
"12893","SEZZADIO",51,0,0,51,"2014","161"
"12894","SILEA",6,121,2,129,"2014","081"
"12895","SILLAVENGO",25,98,0,123,"2014","138"
"12896","SILVANO D'ORBA",4,0,0,4,"2014","162"
"12897","SINIO",21,6,0,27,"2014","220"
"12898","SIRONE",12,86,0,98,"2014","075"
"12899","SIRTORI",9,0,0,9,"2014","076"
"12900","SISSA TRECASALI",11,981,0,992,"2014",NA
"12901","SIZIANO",51,85,0,136,"2014","150"
"12902","SIZZANO",236,22,162,420,"2014","139"
"12903","SOAVE",129,0,0,129,"2014","081"
"12904","SOGLIANO AL RUBICONE",219,54,0,273,"2014","046"
"12905","SOIANO DEL LAGO",8,0,0,8,"2014","180"
"12906","SOLAGNA",0,13,0,13,"2014","101"
"12907","SOLARO",0,16,0,16,"2014","213"
"12908","SOLAROLO",4,0,0,4,"2014","018"
"12909","SOLAROLO RAINERIO",12,269,0,281,"2014","096"
"12910","SOLBIATE",3,50,59,112,"2014","215"
"12911","SOLERO",292,0,0,292,"2014","163"
"12912","SOLESINO",10,0,0,10,"2014","087"
"12913","SOLFERINO",763,202,201,1166,"2014","063"
"12914","SOLIERA",28,900,0,928,"2014","044"
"12915","SOLIGNANO",12,351,0,363,"2014","035"
"12916","SOLONGHELLO",93,0,0,93,"2014","164"
"12917","SOLTO COLLINA",19,2,0,21,"2014","200"
"12918","SOMAGLIA",11,1059,0,1070,"2014","054"
"12919","SOMANO",40,0,0,40,"2014","221"
"12920","SOMMA LOMBARDO",10,9,0,19,"2014","123"
"12921","SOMMACAMPAGNA",1801,422,85,2308,"2014","082"
"12922","SOMMARIVA DEL BOSCO",1460,556,113,2129,"2014","222"
"12923","SOMMARIVA PERNO",26,0,0,26,"2014","223"
"12924","SOMMO",16,0,0,16,"2014","151"
"12925","SONA",2399,631,1,3031,"2014","083"
"12926","SONCINO",711,4901,68,5680,"2014","097"
"12927","SONDALO",40,107,11,158,"2014","060"
"12928","SONDRIO",14,40,0,54,"2014","061"
"12929","SONGAVAZZO",2,0,0,2,"2014","201"
"12930","SONICO",3,96,12,111,"2014","181"
"12931","SORAGNA",10,1953,0,1963,"2014","036"
"12932","SORBOLO",1,1629,0,1630,"2014","037"
"12933","SORDEVOLO",129,25,8,162,"2014","063"
"12934","SORDIO",0,228,0,228,"2014","055"
"12935","SORESINA",37,1512,234,1783,"2014","098"
"12936","SORGA'",1645,49,0,1694,"2014","084"
"12937","SORICO",4,12,53,69,"2014","216"
"12938","SORISO",3,0,0,3,"2014","140"
"12939","SORISOLE",61,57,0,118,"2014","202"
"12940","SORMANO",26,0,1,27,"2014","217"
"12941","SOSPIRO",32,369,1,402,"2014","099"
"12942","SOSPIROLO",14,107,0,121,"2014","056"
"12943","SOSSANO",15,428,0,443,"2014","102"
"12944","SOSTEGNO",2,0,0,2,"2014","064"
"12945","SOTTO IL MONTE GIOVANNI XXIII",62,63,0,125,"2014","203"
"12946","SOVERE",47,58,4,109,"2014","204"
"12947","SOVERZENE",2,0,0,2,"2014","057"
"12948","SOVIZZO",807,31,0,838,"2014","103"
"12949","SOVRAMONTE",9,103,17,129,"2014","058"
"12950","SOZZAGO",8,0,0,8,"2014","141"
"12951","SPARONE",23,63,0,86,"2014","267"
"12952","SPESSA",7,0,0,7,"2014","152"
"12953","SPIGNO MONFERRATO",147,22,66,235,"2014","165"
"12954","SPILAMBERTO",2213,1469,0,3682,"2014","045"
"12955","SPINADESCO",2,0,0,2,"2014","100"
"12956","SPINEA",36,208,0,244,"2014","038"
"12957","SPINEDA",4,776,0,780,"2014","101"
"12958","SPINETO SCRIVIA",186,0,0,186,"2014","166"
"12959","SPINO D'ADDA",754,2077,0,2831,"2014","102"
"12960","SPINONE AL LAGO",12,0,0,12,"2014","205"
"12961","SPIRANO",17,1100,0,1117,"2014","206"
"12962","SPRESIANO",84,259,38,381,"2014","082"
"12963","STAGNO LOMBARDO",10,5819,227,6056,"2014","103"
"12964","STANGHELLA",407,0,0,407,"2014","088"
"12965","STAZZANO",21,0,2,23,"2014","167"
"12966","STAZZONA",14,2,15,31,"2014","218"
"12967","STEZZANO",172,285,143,600,"2014","207"
"12968","STIENTA",154,0,3,157,"2014","045"
"12969","STRA",0,0,2,2,"2014","039"
"12970","STRADELLA",12,39,0,51,"2014","153"
"12971","STRAMBINO",162,0,0,162,"2014","269"
"12972","STRESA",42,0,0,42,"2014","064"
"12973","STREVI",38,0,0,38,"2014","168"
"12974","STROPPO",7,0,0,7,"2014","224"
"12975","STROZZA",3,0,0,3,"2014","208"
"12976","SUARDI",5,0,0,5,"2014","154"
"12977","SUEGLIO",3,0,0,3,"2014","077"
"12978","SUELLO",6,0,5,11,"2014","078"
"12979","SUISIO",1,60,0,61,"2014","209"
"12980","SULBIATE",20,0,0,20,"2014",NA
"12981","SULZANO",30,203,0,233,"2014","182"
"12982","SUMIRAGO",42,71,0,113,"2014","124"
"12983","SUNO",48,392,0,440,"2014","143"
"12984","SUSA",114,23,0,137,"2014","270"
"12985","SUSEGANA",829,95,0,924,"2014","083"
"12986","SUSTINENTE",436,406,320,1162,"2014","064"
"12987","SUZZARA",1779,1827,742,4348,"2014","065"
"12988","TACENO",15,0,5,20,"2014","079"
"12989","TAGLIO DI PO",6327,0,0,6327,"2014","046"
"12990","TAGLIOLO MONFERRATO",45,0,0,45,"2014","169"
"12991","TAIBON AGORDINO",3,29,0,32,"2014","059"
"12992","TAINO",28,120,0,148,"2014","125"
"12993","TALAMELLO",2,0,0,2,"2014","027"
"12994","TALAMONA",15,158,0,173,"2014","063"
"12995","TALEGGIO",63,20,0,83,"2014","210"
"12996","TAMBRE",21,135,0,156,"2014","060"
"12997","TARANTASCA",2184,302,222,2708,"2014","225"
"12998","TARTANO",2,25,0,27,"2014","064"
"12999","TARZO",25,29,0,54,"2014","084"
"13000","TASSAROLO",3,0,0,3,"2014","170"
"13001","TAVAGNASCO",106,12,34,152,"2014","271"
"13002","TAVAZZANO CON VILLAVESCO",2,969,134,1105,"2014","056"
"13003","TAVERNOLA BERGAMASCA",12,9,0,21,"2014","211"
"13004","TAVERNOLE SUL MELLA",21,54,0,75,"2014","183"
"13005","TAVIGLIANO",30,0,0,30,"2014","066"
"13006","TEGLIO",29,253,30,312,"2014","065"
"13007","TELGATE",1942,254,0,2196,"2014","212"
"13008","TEMU'",8,16,0,24,"2014","184"
"13009","TEOLO",20,42,24,86,"2014","089"
"13010","TERDOBBIATE",1,129,0,130,"2014","144"
"13011","TERENZO",103,588,7,698,"2014","038"
"13012","TERNO D'ISOLA",5,50,0,55,"2014","213"
"13013","TERRANOVA DEI PASSERINI",24,739,0,763,"2014","057"
"13014","TERRASSA PADOVANA",1462,0,0,1462,"2014","090"
"13015","TERRAZZO",1,29,0,30,"2014","085"
"13016","TERRUGGIA",14,0,15,29,"2014","171"
"13017","TERZO",50,0,5,55,"2014","172"
"13018","TEZZE SUL BRENTA",84,360,0,444,"2014","104"
"13019","THIENE",352,382,0,734,"2014","105"
"13020","TICENGO",0,437,0,437,"2014","104"
"13021","TIGLIOLE",917,0,0,917,"2014","108"
"13022","TIGNALE",9,0,1,10,"2014","185"
"13023","TIRANO",11,8,5,24,"2014","066"
"13024","TIZZANO VAL PARMA",0,905,0,905,"2014","039"
"13025","TOANO",30,1632,20,1682,"2014","041"
"13026","TOCENO",10,7,7,24,"2014","065"
"13027","TOLLEGNO",3,10,0,13,"2014","068"
"13028","TOMBOLO",1168,69,0,1237,"2014","091"
"13029","TONCO",543,0,0,543,"2014","109"
"13030","TONENGO",110,0,0,110,"2014","110"
"13031","TONEZZA DEL CIMONE",2,0,0,2,"2014","106"
"13032","TORBOLE CASAGLIA",2,1000,40,1042,"2014","186"
"13033","TORINO",182,0,0,182,"2014","272"
"13034","TORLINO VIMERCATI",0,457,0,457,"2014","105"
"13035","TORNATA",2,152,0,154,"2014","106"
"13036","TORNOLO",68,5,0,73,"2014","040"
"13037","TORRAZZA COSTE",21,0,0,21,"2014","155"
"13038","TORRAZZA PIEMONTE",236,15,0,251,"2014","273"
"13039","TORRAZZO",11,0,0,11,"2014","069"
"13040","TORRE BERETTI E CASTELLARO",16,339,0,355,"2014","156"
"13041","TORRE BOLDONE",3,0,0,3,"2014","214"
"13042","TORRE BORMIDA",0,13,0,13,"2014","226"
"13043","TORRE D'ARESE",4,0,0,4,"2014","157"
"13044","TORRE D'ISOLA",0,519,0,519,"2014","159"
"13045","TORRE DE' BUSI",11,0,0,11,"2014","080"
"13046","TORRE DE' NEGRI",9,57,69,135,"2014","158"
"13047","TORRE DE' PICENARDI",8,1124,0,1132,"2014","107"
"13048","TORRE DE' ROVERI",3,0,0,3,"2014","216"
"13049","TORRE DI MOSTO",32,495,0,527,"2014","041"
"13050","TORRE DI SANTA MARIA",24,4,0,28,"2014","067"
"13051","TORRE PALLAVICINA",340,370,0,710,"2014","217"
"13052","TORRE PELLICE",77,0,0,77,"2014","275"
"13053","TORRE SAN GIORGIO",89,54,0,143,"2014","228"
"13054","TORREBELVICINO",780,15,0,795,"2014","107"
"13055","TORREGLIA",5,0,0,5,"2014","092"
"13056","TORRESINA",3,0,0,3,"2014","229"
"13057","TORREVECCHIA PIA",76,14,3,93,"2014","160"
"13058","TORRI DI QUARTESOLO",69,133,30,232,"2014","108"
"13059","TORRILE",0,2403,0,2403,"2014","041"
"13060","TORTONA",2281,242,0,2523,"2014","174"
"13061","TOSCOLANO-MADERNO",10,0,0,10,"2014","187"
"13062","TOVO DI SANT'AGATA",0,71,4,75,"2014","068"
"13063","TRADATE",53,0,1,54,"2014","127"
"13064","TRANA",65,22,28,115,"2014","276"
"13065","TRAONA",61,90,87,238,"2014","069"
"13066","TRAREGO VIGGIONA",2,0,0,2,"2014","066"
"13067","TRASQUERA",17,0,6,23,"2014","067"
"13068","TRAUSELLA",17,24,0,41,"2014","277"
"13069","TRAVAGLIATO",943,491,0,1434,"2014","188"
"13070","TRAVEDONA-MONATE",13,32,0,45,"2014","128"
"13071","TRAVERSELLA",38,70,8,116,"2014","278"
"13072","TRAVERSETOLO",42,986,0,1028,"2014","042"
"13073","TRAVES",3,0,0,3,"2014","279"
"13074","TRAVO",69,39,0,108,"2014","043"
"13075","TREBASELEGHE",7776,161,0,7937,"2014","093"
"13076","TRECATE",5,194,0,199,"2014","149"
"13077","TRECENTA",1113,167,0,1280,"2014","047"
"13078","TREDOZIO",128,0,0,128,"2014","049"
"13079","TREGNAGO",638,155,0,793,"2014","087"
"13080","TREMEZZINA",14,11,61,86,"2014",NA
"13081","TREMOSINE",36,405,14,455,"2014","189"
"13082","TRENZANO",1023,1361,87,2471,"2014","190"
"13083","TRESCORE BALNEARIO",36,56,26,118,"2014","218"
"13084","TRESCORE CREMASCO",94,364,0,458,"2014","109"
"13085","TRESIGALLO",15,0,0,15,"2014","024"
"13086","TRESIVIO",3,43,0,46,"2014","070"
"13087","TREVENZUOLO",289,773,23,1085,"2014","088"
"13088","TREVIGLIO",914,1506,2,2422,"2014","219"
"13089","TREVIGNANO",1927,203,1,2131,"2014","085"
"13090","TREVILLE",1,0,0,1,"2014","175"
"13091","TREVIOLO",79,205,0,284,"2014","220"
"13092","TREVISO",662,159,5,826,"2014","086"
"13093","TREVISO BRESCIANO",10,53,0,63,"2014","191"
"13094","TREZZANO SUL NAVIGLIO",0,248,0,248,"2014","220"
"13095","TREZZO SULL'ADDA",5,393,0,398,"2014","221"
"13096","TREZZO TINELLA",38,0,0,38,"2014","231"
"13097","TREZZONE",1,0,0,1,"2014","226"
"13098","TRIBANO",4,0,0,4,"2014","094"
"13099","TRIBIANO",0,36,0,36,"2014","222"
"13100","TRICHIANA",111,398,0,509,"2014","061"
"13101","TRIGOLO",1,1658,0,1659,"2014","110"
"13102","TRINITA'",2519,302,426,3247,"2014","232"
"13103","TRINO",4,142,0,146,"2014","148"
"13104","TRISOBBIO",114,0,0,114,"2014","176"
"13105","TRISSINO",59,370,0,429,"2014","110"
"13106","TRIUGGIO",86,266,5,357,"2014",NA
"13107","TRIVERO",7,35,0,42,"2014","070"
"13108","TROFARELLO",726,81,0,807,"2014","280"
"13109","TROMELLO",17,69,230,316,"2014","164"
"13110","TRONTANO",7,15,11,33,"2014","068"
"13111","TRONZANO LAGO MAGGIORE",3,0,0,3,"2014","129"
"13112","TRONZANO VERCELLESE",137,25,0,162,"2014","150"
"13113","TROVO",10,1,0,11,"2014","165"
"13114","TRUCCAZZANO",86,1793,0,1879,"2014","224"
"13115","TURANO LODIGIANO",69,1817,0,1886,"2014","058"
"13116","TURATE",166,0,1,167,"2014","227"
"13117","TURBIGO",3,54,0,57,"2014","226"
"13118","UBIALE CLANEZZO",5,0,0,5,"2014","221"
"13119","UBOLDO",23,0,0,23,"2014","130"
"13120","UGGIATE-TREVANO",16,57,16,89,"2014","228"
"13121","URAGO D'OGLIO",420,1045,1,1466,"2014","192"
"13122","URBANA",1033,0,0,1033,"2014","095"
"13123","URGNANO",343,229,0,572,"2014","222"
"13124","USMATE VELATE",7,73,0,80,"2014",NA
"13125","USSEAUX",32,87,0,119,"2014","281"
"13126","USSEGLIO",28,0,0,28,"2014","282"
"13127","VAIANO CREMASCO",61,295,0,356,"2014","111"
"13128","VAIE",2,18,60,80,"2014","283"
"13129","VAILATE",4,501,0,505,"2014","112"
"13130","VAL BREMBILLA",69,51,0,120,"2014",NA
"13131","VAL DELLA TORRE",357,0,0,357,"2014","284"
"13132","VAL DI NIZZA",0,5,0,5,"2014","166"
"13133","VAL MASINO",9,0,0,9,"2014","074"
"13134","VAL REZZO",8,3,5,16,"2014","233"
"13135","VALBONDIONE",3,22,0,25,"2014","223"
"13136","VALBREMBO",40,2,0,42,"2014","224"
"13137","VALBRONA",8,0,1,9,"2014","229"
"13138","VALDAGNO",40,191,0,231,"2014","111"
"13139","VALDASTICO",952,19,0,971,"2014","112"
"13140","VALDENGO",18,56,0,74,"2014","071"
"13141","VALDIDENTRO",30,108,27,165,"2014","071"
"13142","VALDISOTTO",27,134,8,169,"2014","072"
"13143","VALDOBBIADENE",141,416,0,557,"2014","087"
"13144","VALDUGGIA",7,0,0,7,"2014","152"
"13145","VALEGGIO",69,0,0,69,"2014","167"
"13146","VALEGGIO SUL MINCIO",2314,2114,64,4492,"2014","089"
"13147","VALENZA",46,0,0,46,"2014","177"
"13148","VALERA FRATTA",150,247,0,397,"2014","059"
"13149","VALFENERA",958,109,152,1219,"2014","112"
"13150","VALFURVA",9,115,20,144,"2014","073"
"13151","VALGANNA",25,0,1,26,"2014","131"
"13152","VALGOGLIO",23,50,0,73,"2014","225"
"13153","VALGRANA",81,0,0,81,"2014","234"
"13154","VALGREGHENTINO",2,0,0,2,"2014","082"
"13155","VALLADA AGORDINA",3,3,0,6,"2014","062"
"13156","VALLE DI CADORE",7,0,0,7,"2014","063"
"13157","VALLE LOMELLINA",9,715,0,724,"2014","168"
"13158","VALLE MOSSO",2,0,0,2,"2014","073"
"13159","VALLE SALIMBENE",0,71,0,71,"2014","169"
"13160","VALLE SAN NICOLAO",5,0,0,5,"2014","074"
"13161","VALLEVE",0,24,0,24,"2014","226"
"13162","VALLI DEL PASUBIO",4,8,0,12,"2014","113"
"13163","VALLIO TERME",9,0,0,9,"2014","193"
"13164","VALLO TORINESE",23,0,0,23,"2014","286"
"13165","VALMADRERA",147,0,0,147,"2014","083"
"13166","VALMOREA",4,39,0,43,"2014","232"
"13167","VALMOZZOLA",42,12,0,54,"2014","044"
"13168","VALPERGA",166,239,0,405,"2014","287"
"13169","VALPRATO SOANA",32,0,0,32,"2014","288"
"13170","VALSAMOGGIA",248,1090,2,1340,"2014",NA
"13171","VALSOLDA",7,7,3,17,"2014","234"
"13172","VALSTAGNA",6,0,0,6,"2014","114"
"13173","VALSTRONA",27,0,0,27,"2014","069"
"13174","VALTORTA",5,41,0,46,"2014","229"
"13175","VALVERDE",5,0,0,5,"2014","170"
"13176","VALVESTINO",7,7,0,14,"2014","194"
"13177","VANZAGO",30,0,19,49,"2014","229"
"13178","VANZONE CON SAN CARLO",1,0,0,1,"2014",NA
"13179","VAPRIO D'ADDA",30,342,0,372,"2014","230"
"13180","VARALLO",28,50,0,78,"2014","156"
"13181","VARANO BORGHI",4,0,0,4,"2014","132"
"13182","VARANO DE' MELEGARI",21,370,0,391,"2014","045"
"13183","VAREDO",3,0,0,3,"2014",NA
"13184","VARESE",72,113,0,185,"2014","133"
"13185","VARISELLA",8,0,0,8,"2014","289"
"13186","VARSI",13,405,0,418,"2014","046"
"13187","VARZI",83,7,0,90,"2014","171"
"13188","VARZO",10,23,7,40,"2014","071"
"13189","VAUDA CANAVESE",40,0,0,40,"2014","290"
"13190","VAZZOLA",1367,296,4,1667,"2014","088"
"13191","VEDANO OLONA",112,110,0,222,"2014","134"
"13192","VEDELAGO",18863,469,90,19422,"2014","089"
"13193","VEDESETA",5,128,0,133,"2014","230"
"13194","VEGGIANO",79,110,51,240,"2014","096"
"13195","VEGLIO",28,0,0,28,"2014","075"
"13196","VELESO",0,0,16,16,"2014","236"
"13197","VELEZZO LOMELLINA",5,0,0,5,"2014","172"
"13198","VELLEZZO BELLINI",29,354,0,383,"2014","173"
"13199","VELO D'ASTICO",939,24,0,963,"2014","115"
"13200","VELO VERONESE",401,1918,0,2319,"2014","090"
"13201","VENARIA REALE",58,15,277,350,"2014","292"
"13202","VENASCA",118,0,0,118,"2014","237"
"13203","VENAUS",18,28,13,59,"2014","291"
"13204","VENDROGNO",12,7,1,20,"2014","085"
"13205","VENEGONO INFERIORE",1,101,2,104,"2014","136"
"13206","VENEGONO SUPERIORE",0,3,8,11,"2014","137"
"13207","VENEZIA",1418,94,82,1594,"2014","042"
"13208","VENIANO",44,96,0,140,"2014","238"
"13209","VERANO BRIANZA",13,0,0,13,"2014",NA
"13210","VERBANIA",64,0,0,64,"2014","072"
"13211","VERCANA",3,14,0,17,"2014","239"
"13212","VERCEIA",13,4,0,17,"2014","075"
"13213","VERCELLI",66,178,0,244,"2014","158"
"13214","VERDELLINO",0,83,0,83,"2014","232"
"13215","VERDELLO",324,83,0,407,"2014","233"
"13216","VERDERIO",2,0,37,39,"2014",NA
"13217","VERDUNO",114,0,0,114,"2014","238"
"13218","VERGATO",65,0,12,77,"2014","059"
"13219","VERGHERETO",472,0,43,515,"2014","050"
"13220","VERGIATE",39,0,0,39,"2014","138"
"13221","VERMEZZO",0,407,0,407,"2014","235"
"13222","VERNANTE",270,54,0,324,"2014","239"
"13223","VERNASCA",76,68,0,144,"2014","044"
"13224","VERNATE",9,66,0,75,"2014","236"
"13225","VEROLANUOVA",933,2327,159,3419,"2014","195"
"13226","VEROLAVECCHIA",49,3237,682,3968,"2014","196"
"13227","VEROLENGO",250,139,0,389,"2014","293"
"13228","VERONA",2532,1006,49,3587,"2014","091"
"13229","VERONELLA",5321,380,0,5701,"2014","092"
"13230","VERRONE",31,0,0,31,"2014","076"
"13231","VERRUA PO",1,0,0,1,"2014","175"
"13232","VERRUA SAVOIA",595,0,0,595,"2014","294"
"13233","VERTEMATE CON MINOPRIO",1,0,0,1,"2014","242"
"13234","VERTOVA",24,44,0,68,"2014","234"
"13235","VERUCCHIO",150,14,0,164,"2014","020"
"13236","VERUNO",3,0,0,3,"2014","157"
"13237","VERVIO",7,1,0,8,"2014","076"
"13238","VERZUOLO",26,23,0,49,"2014","240"
"13239","VESCOVANA",6,0,0,6,"2014","097"
"13240","VESCOVATO",2536,818,520,3874,"2014","113"
"13241","VESIME",548,0,0,548,"2014","113"
"13242","VESPOLATE",37,114,0,151,"2014","158"
"13243","VESTENANOVA",638,187,0,825,"2014","093"
"13244","VESTIGNE'",8,58,0,66,"2014","295"
"13245","VESTONE",8,0,0,8,"2014","197"
"13246","VETTO",13,360,33,406,"2014","042"
"13247","VEZZA D'ALBA",2,0,0,2,"2014","241"
"13248","VEZZA D'OGLIO",1,208,36,245,"2014","198"
"13249","VEZZANO SUL CROSTOLO",23,174,0,197,"2014","043"
"13250","VIADANA",278,1337,96,1711,"2014","066"
"13251","VIADANICA",20,26,0,46,"2014","235"
"13252","VIALE",281,0,0,281,"2014","114"
"13253","VIALFRE'",10,0,0,10,"2014","296"
"13254","VIANO",2,795,4,801,"2014","044"
"13255","VIARIGI",29,0,0,29,"2014","115"
"13256","VICENZA",295,986,2,1283,"2014","116"
"13257","VICO CANAVESE",141,137,0,278,"2014","297"
"13258","VICOFORTE",509,0,0,509,"2014","242"
"13259","VICOLUNGO",1,0,0,1,"2014","159"
"13260","VIDIGULFO",21,363,0,384,"2014","176"
"13261","VIDOR",34,327,0,361,"2014","090"
"13262","VIDRACCO",0,0,1,1,"2014","298"
"13263","VIGANELLA",1,0,0,1,"2014",NA
"13264","VIGANO SAN MARTINO",9,0,0,9,"2014","236"
"13265","VIGANO'",1,0,0,1,"2014",NA
"13266","VIGASIO",511,555,0,1066,"2014","094"
"13267","VIGEVANO",81,67,206,354,"2014","177"
"13268","VIGGIU'",19,38,0,57,"2014","139"
"13269","VIGHIZZOLO D'ESTE",70,25,0,95,"2014","098"
"13270","VIGLIANO BIELLESE",5,43,0,48,"2014","077"
"13271","VIGLIANO D'ASTI",58,0,0,58,"2014","116"
"13272","VIGNALE MONFERRATO",178,0,0,178,"2014","179"
"13273","VIGNATE",4,450,0,454,"2014","237"
"13274","VIGNOLA",3,123,0,126,"2014","046"
"13275","VIGNOLE BORBERA",23,0,0,23,"2014","180"
"13276","VIGNOLO",1383,0,0,1383,"2014","243"
"13277","VIGNONE",2,0,0,2,"2014","074"
"13278","VIGO DI CADORE",8,7,5,20,"2014","065"
"13279","VIGODARZERE",347,100,0,447,"2014","099"
"13280","VIGOLO",27,142,0,169,"2014","237"
"13281","VIGOLZONE",96,412,0,508,"2014","045"
"13282","VIGONE",1762,1129,168,3059,"2014","299"
"13283","VIGONOVO",6,0,8,14,"2014","043"
"13284","VIGONZA",541,365,0,906,"2014","100"
"13285","VILLA BARTOLOMEA",47,0,0,47,"2014","095"
"13286","VILLA CARCINA",5,0,0,5,"2014","199"
"13287","VILLA CORTESE",96,0,0,96,"2014","248"
"13288","VILLA D'ADDA",14,0,0,14,"2014","238"
"13289","VILLA D'ALME'",63,23,3,89,"2014","239"
"13290","VILLA D'OGNA",2,73,0,75,"2014","241"
"13291","VILLA DEL BOSCO",2,0,0,2,"2014","078"
"13292","VILLA DEL CONTE",797,757,2,1556,"2014","101"
"13293","VILLA DI CHIAVENNA",4,2,2,8,"2014","077"
"13294","VILLA DI SERIO",6,0,0,6,"2014","240"
"13295","VILLA DI TIRANO",11,130,64,205,"2014","078"
"13296","VILLA ESTENSE",235,0,0,235,"2014","102"
"13297","VILLA GUARDIA",139,0,0,139,"2014","245"
"13298","VILLA MINOZZO",35,698,7,740,"2014","045"
"13299","VILLA POMA",0,615,96,711,"2014","067"
"13300","VILLA SAN SECONDO",8,0,0,8,"2014","119"
"13301","VILLACHIARA",436,1592,872,2900,"2014","200"
"13302","VILLADEATI",13,0,0,13,"2014","182"
"13303","VILLADOSE",543,0,90,633,"2014","048"
"13304","VILLADOSSOLA",9,0,0,9,"2014","075"
"13305","VILLAFALLETTO",1789,647,384,2820,"2014","244"
"13306","VILLAFRANCA D'ASTI",310,0,0,310,"2014","117"
"13307","VILLAFRANCA DI VERONA",7816,3103,86,11005,"2014","096"
"13308","VILLAFRANCA PADOVANA",692,1860,15,2567,"2014","103"
"13309","VILLAFRANCA PIEMONTE",2588,1927,535,5050,"2014","300"
"13310","VILLAGA",40,244,27,311,"2014","117"
"13311","VILLALVERNIA",1,0,0,1,"2014",NA
"13312","VILLAMARZANA",59,93,0,152,"2014","049"
"13313","VILLAMIROGLIO",20,0,0,20,"2014","184"
"13314","VILLANOVA BIELLESE",247,0,0,247,"2014","079"
"13315","VILLANOVA CANAVESE",46,22,0,68,"2014","301"
"13316","VILLANOVA D'ARDENGHI",20,0,5,25,"2014","179"
"13317","VILLANOVA D'ASTI",3797,102,0,3899,"2014","118"
"13318","VILLANOVA DEL GHEBBO",21,0,0,21,"2014","050"
"13319","VILLANOVA DEL SILLARO",1,1269,8,1278,"2014","060"
"13320","VILLANOVA DI CAMPOSAMPIERO",32,39,6,77,"2014","104"
"13321","VILLANOVA MARCHESANA",3,70,0,73,"2014","051"
"13322","VILLANOVA MONDOVI'",2255,447,131,2833,"2014","245"
"13323","VILLANOVA MONFERRATO",1,83,0,84,"2014","185"
"13324","VILLANOVA SOLARO",191,568,6,765,"2014","246"
"13325","VILLANOVA SULL'ARDA",135,1310,0,1445,"2014","046"
"13326","VILLANTERIO",7,0,146,153,"2014","180"
"13327","VILLANUOVA SUL CLISI",6,0,0,6,"2014","201"
"13328","VILLAR DORA",36,0,50,86,"2014","303"
"13329","VILLAR FOCCHIARDO",20,31,71,122,"2014","305"
"13330","VILLAR PELLICE",214,31,14,259,"2014","306"
"13331","VILLAR PEROSA",12,0,18,30,"2014","307"
"13332","VILLAR SAN COSTANZO",317,179,102,598,"2014","247"
"13333","VILLARBASSE",227,21,0,248,"2014","302"
"13334","VILLARBOIT",4,0,0,4,"2014","163"
"13335","VILLAREGGIA",61,25,0,86,"2014","304"
"13336","VILLAROMAGNANO",15,0,0,15,"2014","186"
"13337","VILLASTELLONE",958,617,110,1685,"2014","308"
"13338","VILLATA",12,29,0,41,"2014","164"
"13339","VILLAVERLA",126,1231,0,1357,"2014","118"
"13340","VILLETTE",36,0,0,36,"2014","076"
"13341","VILLIMPENTA",376,88,39,503,"2014","068"
"13342","VILLONGO",10,0,0,10,"2014","242"
"13343","VILLORBA",113,13,0,126,"2014","091"
"13344","VILMINORE DI SCALVE",14,186,0,200,"2014","243"
"13345","VIMERCATE",8,38,0,46,"2014",NA
"13346","VINADIO",172,0,0,172,"2014","248"
"13347","VINCHIO",16,0,0,16,"2014","120"
"13348","VINOVO",265,171,0,436,"2014","309"
"13349","VINZAGLIO",18,44,0,62,"2014","164"
"13350","VIOLA",64,0,0,64,"2014","249"
"13351","VIONE",3,32,3,38,"2014","202"
"13352","VIRLE PIEMONTE",295,332,158,785,"2014","310"
"13353","VISANO",1519,672,0,2191,"2014","203"
"13354","VISCHE",13,0,0,13,"2014","311"
"13355","VISONE",59,0,0,59,"2014","187"
"13356","VISTARINO",44,0,24,68,"2014","181"
"13357","VISTRORIO",9,0,0,9,"2014","312"
"13358","VITTORIO VENETO",286,186,15,487,"2014","092"
"13359","VITTUONE",4,169,0,173,"2014","243"
"13360","VIU'",61,41,42,144,"2014","313"
"13361","VIVERONE",44,0,0,44,"2014","080"
"13362","VIZZOLO PREDABISSI",21,34,0,55,"2014","244"
"13363","VO'",96,75,0,171,"2014","105"
"13364","VOBARNO",50,70,5,125,"2014","204"
"13365","VOCCA",0,12,0,12,"2014","166"
"13366","VODO CADORE",0,0,27,27,"2014","066"
"13367","VOGHERA",13,0,0,13,"2014","182"
"13368","VOGHIERA",3,0,0,3,"2014","023"
"13369","VOGOGNA",19,4,0,23,"2014","077"
"13370","VOLONGO",31,0,0,31,"2014","114"
"13371","VOLPAGO DEL MONTELLO",839,570,16,1425,"2014","093"
"13372","VOLPEDO",2,0,0,2,"2014","188"
"13373","VOLPEGLINO",3,0,0,3,"2014","189"
"13374","VOLPIANO",336,65,123,524,"2014","314"
"13375","VOLTA MANTOVANA",2309,1507,806,4622,"2014","070"
"13376","VOLTAGGIO",7,83,0,90,"2014","190"
"13377","VOLTIDO",0,320,0,320,"2014","115"
"13378","VOLVERA",1493,206,0,1699,"2014","315"
"13379","VOTTIGNASCO",1964,99,0,2063,"2014","250"
"13380","ZANDOBBIO",6,30,0,36,"2014","244"
"13381","ZANE'",374,183,0,557,"2014","119"
"13382","ZANICA",749,1179,0,1928,"2014","245"
"13383","ZAVATTARELLO",115,0,0,115,"2014","184"
"13384","ZECCONE",4,254,0,258,"2014","185"
"13385","ZELBIO",0,0,11,11,"2014","246"
"13386","ZELO BUON PERSICO",0,1145,0,1145,"2014","061"
"13387","ZELO SURRIGONE",0,193,0,193,"2014","246"
"13388","ZEME",70,28,0,98,"2014","186"
"13389","ZENEVREDO",8,0,0,8,"2014","187"
"13390","ZENSON DI PIAVE",9,0,0,9,"2014","094"
"13391","ZERBOLO'",2,256,0,258,"2014","189"
"13392","ZERMEGHEDO",0,55,0,55,"2014","120"
"13393","ZERO BRANCO",207,202,7,416,"2014","095"
"13394","ZEVIO",3704,766,76,4546,"2014","097"
"13395","ZIANO PIACENTINO",80,0,0,80,"2014","048"
"13396","ZIBELLO",3,1052,0,1055,"2014","048"
"13397","ZIBIDO SAN GIACOMO",38,414,0,452,"2014","247"
"13398","ZIMELLA",7176,487,73,7736,"2014","098"
"13399","ZINASCO",14,0,0,14,"2014","190"
"13400","ZOCCA",92,874,0,966,"2014","047"
"13401","ZOGNO",112,67,0,179,"2014","246"
"13402","ZOLA PREDOSA",23,132,0,155,"2014","060"
"13403","ZOLDO ALTO",12,0,0,12,"2014","068"
"13404","ZONE",4,40,0,44,"2014","205"
"13405","ZOVENCEDO",8,0,0,8,"2014","121"
"13406","ZUBIENA",31,6,13,50,"2014","082"
"13407","ZUGLIANO",329,188,17,534,"2014","122"
"13408","ZUMAGLIA",19,0,0,19,"2014","083"
"13409","ABANO TERME",18,187,51,256,"2015","001"
"13410","ABBADIA CERRETO",0,1183,0,1183,"2015","001"
"13411","ABBADIA LARIANA",17,21,1,39,"2015","001"
"13412","ABBIATEGRASSO",93,1559,6,1658,"2015","002"
"13413","ACCEGLIO",50,25,0,75,"2015","001"
"13414","ACQUAFREDDA",1601,170,0,1771,"2015","001"
"13415","ACQUANEGRA CREMONESE",6,90,584,680,"2015","001"
"13416","ACQUANEGRA SUL CHIESE",2156,797,119,3072,"2015","001"
"13417","ACQUI TERME",237,0,0,237,"2015","001"
"13418","ADRARA SAN MARTINO",31,27,3,61,"2015","001"
"13419","ADRARA SAN ROCCO",7,7,0,14,"2015","002"
"13420","ADRIA",2175,280,0,2455,"2015","001"
"13421","ADRO",482,21,0,503,"2015","002"
"13422","AFFI",0,1,0,1,"2015","001"
"13423","AGAZZANO",183,274,0,457,"2015","001"
"13424","AGLIANO TERME",67,0,0,67,"2015","001"
"13425","AGLIE'",188,16,0,204,"2015","001"
"13426","AGNA",353,0,0,353,"2015","002"
"13427","AGNADELLO",3,1349,13,1365,"2015","002"
"13428","AGNOSINE",15,40,0,55,"2015","003"
"13429","AGORDO",2,20,0,22,"2015","001"
"13430","AGRATE CONTURBIA",47,0,0,47,"2015","001"
"13431","AGUGLIARO",276,57,0,333,"2015","001"
"13432","AICURZIO",7,56,0,63,"2015",NA
"13433","AILOCHE",0,1,0,1,"2015","001"
"13434","AIRASCA",998,355,114,1467,"2015","002"
"13435","AIRUNO",7,0,0,7,"2015","002"
"13436","AISONE",33,0,0,33,"2015","002"
"13437","ALA DI STURA",30,49,0,79,"2015","003"
"13438","ALAGNA VALSESIA",14,15,0,29,"2015","002"
"13439","ALANO DI PIAVE",419,61,0,480,"2015","002"
"13440","ALBA",811,0,0,811,"2015","003"
"13441","ALBAIRATE",20,694,0,714,"2015","005"
"13442","ALBANO SANT'ALESSANDRO",9,0,0,9,"2015","003"
"13443","ALBAREDO D'ADIGE",8277,233,0,8510,"2015","002"
"13444","ALBAREDO PER SAN MARCO",6,29,0,35,"2015","001"
"13445","ALBARETO",85,88,0,173,"2015","001"
"13446","ALBARETTO DELLA TORRE",30,0,0,30,"2015","004"
"13447","ALBERA LIGURE",22,0,0,22,"2015","002"
"13448","ALBESE CON CASSANO",0,0,4,4,"2015","004"
"13449","ALBETTONE",1866,555,37,2458,"2015","002"
"13450","ALBIANO D'IVREA",143,34,0,177,"2015","004"
"13451","ALBIATE",343,0,0,343,"2015",NA
"13452","ALBIGNASEGO",172,72,105,349,"2015","003"
"13453","ALBINEA",5,1268,0,1273,"2015","001"
"13454","ALBINO",73,50,0,123,"2015","004"
"13455","ALBIOLO",22,0,0,22,"2015","005"
"13456","ALBIZZATE",5,0,0,5,"2015","002"
"13457","ALBOSAGGIA",34,74,30,138,"2015","002"
"13458","ALBUGNANO",70,0,0,70,"2015","002"
"13459","ALBUZZANO",13,0,0,13,"2015","004"
"13460","ALESSANDRIA",8994,2033,0,11027,"2015","003"
"13461","ALFIANELLO",9,470,1,480,"2015","004"
"13462","ALFIANO NATTA",30,0,0,30,"2015","004"
"13463","ALFONSINE",38,0,0,38,"2015","001"
"13464","ALGUA",1,4,0,5,"2015","248"
"13465","ALICE BEL COLLE",3,0,0,3,"2015","005"
"13466","ALICE CASTELLO",513,31,0,544,"2015","004"
"13467","ALICE SUPERIORE",26,0,0,26,"2015","005"
"13468","ALLEGHE",9,0,0,9,"2015","003"
"13469","ALLUVIONI CAMBIO'",15,0,0,15,"2015","006"
"13470","ALME'",7,0,1,8,"2015","005"
"13471","ALMENNO SAN BARTOLOMEO",38,0,0,38,"2015","006"
"13472","ALMENNO SAN SALVATORE",6,0,0,6,"2015","007"
"13473","ALMESE",48,18,0,66,"2015","006"
"13474","ALONTE",621,17,0,638,"2015","003"
"13475","ALPIGNANO",289,133,41,463,"2015","008"
"13476","ALSENO",528,819,0,1347,"2015","002"
"13477","ALSERIO",3,0,0,3,"2015","006"
"13478","ALTAVILLA MONFERRATO",87,0,0,87,"2015","007"
"13479","ALTAVILLA VICENTINA",118,0,0,118,"2015","004"
"13480","ALTISSIMO",31,62,0,93,"2015","005"
"13481","ALTIVOLE",10769,80,33,10882,"2015","001"
"13482","ALZANO LOMBARDO",26,48,0,74,"2015","008"
"13483","ALZANO SCRIVIA",3,0,0,3,"2015","008"
"13484","ALZATE BRIANZA",15,172,0,187,"2015","007"
"13485","AMBIVERE",3,0,0,3,"2015","009"
"13486","AMENO",11,10,20,41,"2015","002"
"13487","ANDALO VALTELLINO",9,0,0,9,"2015",NA
"13488","ANDEZENO",444,0,0,444,"2015","009"
"13489","ANDORNO MICCA",20,0,39,59,"2015","002"
"13490","ANDRATE",34,0,0,34,"2015","010"
"13491","ANFO",6,16,0,22,"2015","005"
"13492","ANGERA",70,212,0,282,"2015","003"
"13493","ANGOLO TERME",6,55,1,62,"2015","006"
"13494","ANGROGNA",117,0,5,122,"2015","011"
"13495","ANGUILLARA VENETA",9,0,0,9,"2015","004"
"13496","ANNICCO",40,804,214,1058,"2015","003"
"13497","ANNONE DI BRIANZA",23,20,0,43,"2015","003"
"13498","ANNONE VENETO",29,67,0,96,"2015","001"
"13499","ANTEGNATE",828,1365,0,2193,"2015","010"
"13500","ANTIGNANO",92,0,0,92,"2015","003"
"13501","ANTRONA SCHIERANCO",16,0,0,16,"2015","001"
"13502","ANZANO DEL PARCO",0,144,0,144,"2015","009"
"13503","ANZOLA D'OSSOLA",3,99,0,102,"2015","002"
"13504","ANZOLA DELL'EMILIA",59,196,0,255,"2015","001"
"13505","APPIANO GENTILE",84,296,33,413,"2015","010"
"13506","APRICA",2,7,0,9,"2015","004"
"13507","ARAMENGO",210,0,0,210,"2015","004"
"13508","ARCADE",1171,107,0,1278,"2015","002"
"13509","ARCENE",12,343,0,355,"2015","011"
"13510","ARCISATE",66,547,289,902,"2015","004"
"13511","ARCOLE",1218,161,0,1379,"2015","004"
"13512","ARCONATE",30,94,0,124,"2015","007"
"13513","ARCORE",35,21,0,56,"2015",NA
"13514","ARCUGNANO",110,3,0,113,"2015","006"
"13515","ARDENNO",46,49,0,95,"2015","005"
"13516","ARDESIO",81,43,0,124,"2015","012"
"13517","ARENA PO",93,334,67,494,"2015","005"
"13518","ARESE",0,97,0,97,"2015","009"
"13519","ARGEGNO",3,0,0,3,"2015","011"
"13520","ARGELATO",78,40,0,118,"2015","002"
"13521","ARGENTA",1643,96,0,1739,"2015","001"
"13522","ARGUELLO",74,0,0,74,"2015","007"
"13523","ARIANO NEL POLESINE",954,171,0,1125,"2015","002"
"13524","ARIGNANO",559,0,0,559,"2015","012"
"13525","ARLUNO",54,198,9,261,"2015","010"
"13526","ARMENO",52,75,0,127,"2015","006"
"13527","AROLA",8,0,9,17,"2015","004"
"13528","ARONA",3,0,0,3,"2015","008"
"13529","AROSIO",1,0,0,1,"2015","012"
"13530","ARQUA' PETRARCA",71,0,0,71,"2015","005"
"13531","ARQUA' POLESINE",813,6,0,819,"2015","003"
"13532","ARQUATA SCRIVIA",9,0,0,9,"2015","009"
"13533","ARRE",5,20,0,25,"2015","006"
"13534","ARSAGO SEPRIO",5,0,0,5,"2015","005"
"13535","ARSIE'",17,6,414,437,"2015","004"
"13536","ARSIERO",9,14,0,23,"2015","007"
"13537","ARTOGNE",13,385,22,420,"2015","007"
"13538","ARZAGO D'ADDA",305,784,0,1089,"2015","013"
"13539","ARZERGRANDE",240,163,0,403,"2015","007"
"13540","ARZIGNANO",259,236,0,495,"2015","008"
"13541","ASIAGO",88,1037,0,1125,"2015","009"
"13542","ASIGLIANO VENETO",62,0,0,62,"2015","010"
"13543","ASIGLIANO VERCELLESE",25,0,0,25,"2015","007"
"13544","ASOLA",7505,1767,1413,10685,"2015","002"
"13545","ASOLO",9701,596,0,10297,"2015","003"
"13546","ASSO",22,0,2,24,"2015","013"
"13547","ASTI",2470,12,0,2482,"2015","005"
"13548","AURANO",9,0,0,9,"2015","005"
"13549","AURONZO DI CADORE",11,8,0,19,"2015","005"
"13550","AVERARA",0,0,2,2,"2015","014"
"13551","AVIATICO",1,18,0,19,"2015","015"
"13552","AVIGLIANA",208,30,11,249,"2015","013"
"13553","AVOLASCA",200,0,0,200,"2015","010"
"13554","AZEGLIO",61,14,69,144,"2015","014"
"13555","AZZANELLO",1,396,0,397,"2015","004"
"13556","AZZANO MELLA",340,865,3,1208,"2015","008"
"13557","AZZANO SAN PAOLO",19,136,0,155,"2015","016"
"13558","AZZATE",19,11,0,30,"2015","006"
"13559","AZZIO",9,95,0,104,"2015","007"
"13560","AZZONE",0,11,0,11,"2015","017"
"13561","BACENO",7,20,12,39,"2015","006"
"13562","BADIA CALAVENA",1219,279,40,1538,"2015","005"
"13563","BADIA PAVESE",27,0,0,27,"2015","006"
"13564","BADIA POLESINE",198,0,0,198,"2015","004"
"13565","BAGNACAVALLO",41,0,0,41,"2015","002"
"13566","BAGNARA DI ROMAGNA",6,0,0,6,"2015","003"
"13567","BAGNARIA",16,0,0,16,"2015","007"
"13568","BAGNASCO",122,0,0,122,"2015","008"
"13569","BAGNATICA",4,138,0,142,"2015","018"
"13570","BAGNO DI ROMAGNA",936,20,0,956,"2015","001"
"13571","BAGNOLI DI SOPRA",351,8,0,359,"2015","008"
"13572","BAGNOLO CREMASCO",9,1588,0,1597,"2015","005"
"13573","BAGNOLO IN PIANO",1,613,0,614,"2015","002"
"13574","BAGNOLO MELLA",305,2924,294,3523,"2015","009"
"13575","BAGNOLO PIEMONTE",957,104,39,1100,"2015","009"
"13576","BAGNOLO SAN VITO",35,2497,1152,3684,"2015","003"
"13577","BAGOLINO",7,335,13,355,"2015","010"
"13578","BAIRO",64,93,0,157,"2015","015"
"13579","BAISO",9,900,7,916,"2015","003"
"13580","BALANGERO",164,97,26,287,"2015","016"
"13581","BALDICHIERI D'ASTI",56,0,0,56,"2015","007"
"13582","BALDISSERO CANAVESE",0,71,0,71,"2015","017"
"13583","BALDISSERO D'ALBA",681,0,0,681,"2015","010"
"13584","BALDISSERO TORINESE",189,0,0,189,"2015","018"
"13585","BALLABIO",22,58,0,80,"2015","004"
"13586","BALME",14,0,0,14,"2015","019"
"13587","BALOCCO",57,19,40,116,"2015","009"
"13588","BANCHETTE",4,0,0,4,"2015","020"
"13589","BANNIO ANZINO",45,0,2,47,"2015","007"
"13590","BAONE",8,0,0,8,"2015","009"
"13591","BARBANIA",28,215,75,318,"2015","021"
"13592","BARBARANO VICENTINO",271,304,0,575,"2015","011"
"13593","BARBARESCO",28,0,0,28,"2015","011"
"13594","BARBARIGA",563,1405,0,1968,"2015","011"
"13595","BARBATA",9,1145,0,1154,"2015","019"
"13596","BARBIANELLO",131,3,0,134,"2015","008"
"13597","BARBONA",102,5,0,107,"2015","010"
"13598","BARDELLO",15,0,0,15,"2015","009"
"13599","BARDI",53,688,0,741,"2015","002"
"13600","BARDOLINO",24,87,0,111,"2015","006"
"13601","BARDONECCHIA",15,39,0,54,"2015","022"
"13602","BAREGGIO",59,282,0,341,"2015","012"
"13603","BARENGO",8,102,0,110,"2015","012"
"13604","BARGE",4082,1940,289,6311,"2015","012"
"13605","BARGHE",9,15,0,24,"2015","012"
"13606","BARIANO",0,354,0,354,"2015","020"
"13607","BARNI",8,5,6,19,"2015","015"
"13608","BAROLO",33,0,0,33,"2015","013"
"13609","BARONE CANAVESE",147,51,0,198,"2015","023"
"13610","BARZAGO",258,18,0,276,"2015","005"
"13611","BARZANO'",13,0,0,13,"2015","006"
"13612","BARZIO",6,58,8,72,"2015","007"
"13613","BASALUZZO",88,0,0,88,"2015","012"
"13614","BASCAPE'",83,690,0,773,"2015","009"
"13615","BASIANO",2,0,0,2,"2015","014"
"13616","BASIGLIO",0,60,0,60,"2015","015"
"13617","BASSANO BRESCIANO",6,111,0,117,"2015","013"
"13618","BASSANO DEL GRAPPA",273,179,6,458,"2015","012"
"13619","BASSIGNANA",3,0,0,3,"2015","013"
"13620","BASTIA MONDOVI'",678,3,0,681,"2015","014"
"13621","BASTIDA PANCARANA",2,0,0,2,"2015","011"
"13622","BASTIGLIA",102,0,0,102,"2015","001"
"13623","BATTAGLIA TERME",7,0,0,7,"2015","011"
"13624","BEDERO VALCUVIA",20,0,0,20,"2015","010"
"13625","BEDIZZOLE",3239,1307,0,4546,"2015","014"
"13626","BEDONIA",184,153,0,337,"2015","003"
"13627","BEDULITA",13,0,0,13,"2015","022"
"13628","BEE",2,0,0,2,"2015","009"
"13629","BEINASCO",24,0,0,24,"2015","024"
"13630","BEINETTE",705,327,12,1044,"2015","016"
"13631","BELFIORE",2177,0,0,2177,"2015","007"
"13632","BELGIOIOSO",3,146,0,149,"2015","013"
"13633","BELLAGIO",7,64,23,94,"2015","019"
"13634","BELLANO",4,0,0,4,"2015","008"
"13635","BELLARIA-IGEA MARINA",12,0,0,12,"2015","001"
"13636","BELLINO",95,0,0,95,"2015","017"
"13637","BELLINZAGO LOMBARDO",88,1315,0,1403,"2015","016"
"13638","BELLINZAGO NOVARESE",523,583,0,1106,"2015","016"
"13639","BELLUNO",741,414,23,1178,"2015","006"
"13640","BELVEDERE LANGHE",159,0,56,215,"2015","018"
"13641","BEMA",0,6,0,6,"2015","006"
"13642","BENE LARIO",1,12,63,76,"2015","021"
"13643","BENE VAGIENNA",1642,426,0,2068,"2015","019"
"13644","BENEVELLO",192,0,0,192,"2015","020"
"13645","BENNA",10,20,21,51,"2015","003"
"13646","BENTIVOGLIO",21,280,0,301,"2015","005"
"13647","BERBENNO",16,42,0,58,"2015","023"
"13648","BERBENNO DI VALTELLINA",29,139,3,171,"2015","007"
"13649","BERCETO",56,71,0,127,"2015","004"
"13650","BEREGAZZO CON FIGLIARO",18,0,0,18,"2015","022"
"13651","BEREGUARDO",7,651,67,725,"2015","014"
"13652","BERGAMASCO",66,0,0,66,"2015","015"
"13653","BERGAMO",143,111,0,254,"2015","024"
"13654","BERLINGO",3490,281,41,3812,"2015","015"
"13655","BERNAREGGIO",1,9,0,10,"2015",NA
"13656","BERNATE TICINO",45,137,0,182,"2015","019"
"13657","BERNEZZO",297,65,3,365,"2015","022"
"13658","BERRA",1642,54,0,1696,"2015","002"
"13659","BERTINORO",122,7,0,129,"2015","003"
"13660","BERTONICO",34,2516,0,2550,"2015","002"
"13661","BERZANO DI SAN PIETRO",9,0,0,9,"2015","009"
"13662","BERZO DEMO",7,52,5,64,"2015","016"
"13663","BERZO INFERIORE",6,116,2,124,"2015","017"
"13664","BERZO SAN FERMO",558,80,20,658,"2015","025"
"13665","BESANA IN BRIANZA",1010,49,33,1092,"2015",NA
"13666","BESANO",38,0,0,38,"2015","011"
"13667","BESATE",152,0,0,152,"2015","022"
"13668","BESENZONE",847,1524,0,2371,"2015","003"
"13669","BESNATE",3,196,0,199,"2015","012"
"13670","BESOZZO",8,61,0,69,"2015","013"
"13671","BETTOLA",268,136,0,404,"2015","004"
"13672","BEURA-CARDEZZA",13,9,0,22,"2015","011"
"13673","BEVILACQUA",180,48,0,228,"2015","008"
"13674","BIANDRONNO",11,0,7,18,"2015","014"
"13675","BIANZANO",3,12,0,15,"2015","026"
"13676","BIANZE'",90,277,0,367,"2015","011"
"13677","BIANZONE",2,23,0,25,"2015","008"
"13678","BIASSONO",4,0,0,4,"2015",NA
"13679","BIBBIANO",39,2236,0,2275,"2015","004"
"13680","BIBIANA",575,0,12,587,"2015","025"
"13681","BIELLA",124,29,154,307,"2015","004"
"13682","BIENNO",3,74,1,78,"2015","018"
"13683","BIGARELLO",1924,251,602,2777,"2015","004"
"13684","BINAGO",32,79,74,185,"2015","023"
"13685","BIOGLIO",14,0,0,14,"2015","005"
"13686","BIONE",19,7,1,27,"2015","019"
"13687","BISTAGNO",23,0,0,23,"2015","017"
"13688","BISUSCHIO",4,0,0,4,"2015","015"
"13689","BIZZARONE",6,12,0,18,"2015","024"
"13690","BLELLO",22,32,0,54,"2015","027"
"13691","BLESSAGNO",0,0,9,9,"2015","025"
"13692","BOARA PISANI",1,0,0,1,"2015","012"
"13693","BOBBIO",148,107,0,255,"2015","005"
"13694","BOBBIO PELLICE",42,11,150,203,"2015","026"
"13695","BOCA",6,0,0,6,"2015","019"
"13696","BOCCIOLETO",4,0,0,4,"2015","014"
"13697","BOFFALORA D'ADDA",86,290,8,384,"2015","003"
"13698","BOFFALORA SOPRA TICINO",78,117,26,221,"2015","026"
"13699","BOGOGNO",2,0,0,2,"2015",NA
"13700","BOLGARE",65,301,0,366,"2015","028"
"13701","BOLLATE",2,237,8,247,"2015","027"
"13702","BOLLENGO",73,44,0,117,"2015","027"
"13703","BOLOGNA",21,11,0,32,"2015","006"
"13704","BOLTIERE",14,69,0,83,"2015","029"
"13705","BOLZANO NOVARESE",0,12,0,12,"2015","022"
"13706","BOLZANO VICENTINO",237,1314,55,1606,"2015","013"
"13707","BOMPORTO",1247,125,0,1372,"2015","002"
"13708","BONATE SOPRA",196,10,0,206,"2015","030"
"13709","BONATE SOTTO",58,0,0,58,"2015","031"
"13710","BONAVIGO",3271,33,0,3304,"2015","009"
"13711","BONDENO",386,398,0,784,"2015","003"
"13712","BONEMERSE",26,165,0,191,"2015","006"
"13713","BORDOLANO",10,540,0,550,"2015","007"
"13714","BORE",62,7,0,69,"2015","005"
"13715","BORETTO",2,259,0,261,"2015","005"
"13716","BORGARELLO",0,0,1,1,"2015","015"
"13717","BORGARO TORINESE",55,86,10,151,"2015","028"
"13718","BORGHETTO DI BORBERA",151,0,6,157,"2015","018"
"13719","BORGHETTO LODIGIANO",7,1510,30,1547,"2015","004"
"13720","BORGHI",1249,0,0,1249,"2015","004"
"13721","BORGIALLO",4,26,0,30,"2015","029"
"13722","BORGO D'ALE",222,0,0,222,"2015","015"
"13723","BORGO DI TERZO",3,0,0,3,"2015","032"
"13724","BORGO PRIOLO",5,0,0,5,"2015","016"
"13725","BORGO SAN DALMAZZO",386,98,72,556,"2015","025"
"13726","BORGO SAN GIACOMO",1534,3685,13,5232,"2015","020"
"13727","BORGO SAN GIOVANNI",6,875,0,881,"2015","005"
"13728","BORGO SAN SIRO",2,640,0,642,"2015","018"
"13729","BORGO TICINO",30,0,0,30,"2015","025"
"13730","BORGO TOSSIGNANO",9,0,0,9,"2015","007"
"13731","BORGO VAL DI TARO",132,230,0,362,"2015","006"
"13732","BORGO VERCELLI",0,3,0,3,"2015","017"
"13733","BORGO VIRGILIO",61,4006,1843,5910,"2015",NA
"13734","BORGOFRANCO D'IVREA",181,20,0,201,"2015","030"
"13735","BORGOFRANCO SUL PO",1,17,57,75,"2015","006"
"13736","BORGOLAVEZZARO",4,0,0,4,"2015","023"
"13737","BORGOMALE",68,0,0,68,"2015","024"
"13738","BORGOMANERO",109,16,0,125,"2015","024"
"13739","BORGOMASINO",65,0,0,65,"2015","031"
"13740","BORGONE SUSA",26,24,0,50,"2015","032"
"13741","BORGONOVO VAL TIDONE",432,1805,0,2237,"2015","006"
"13742","BORGORATTO ALESSANDRINO",13,0,0,13,"2015","019"
"13743","BORGORATTO MORMOROLO",14,0,0,14,"2015","017"
"13744","BORGORICCO",94,42,0,136,"2015","013"
"13745","BORGOSATOLLO",2,604,25,631,"2015","021"
"13746","BORGOSESIA",65,45,0,110,"2015","016"
"13747","BORMIO",17,319,38,374,"2015","009"
"13748","BORNASCO",117,547,0,664,"2015","019"
"13749","BORNO",3,123,38,164,"2015","022"
"13750","BORRIANA",117,34,35,186,"2015","006"
"13751","BORSO DEL GRAPPA",142,200,12,354,"2015","004"
"13752","BOSARO",3,0,0,3,"2015","007"
"13753","BOSCHI SANT'ANNA",3,29,0,32,"2015","010"
"13754","BOSCO CHIESANUOVA",36,1465,0,1501,"2015","011"
"13755","BOSCO MARENGO",76,34,0,110,"2015","021"
"13756","BOSCONERO",75,31,0,106,"2015","033"
"13757","BOSIA",453,0,0,453,"2015","026"
"13758","BOSIO",18,0,4,22,"2015","022"
"13759","BOSISIO PARINI",0,127,0,127,"2015","009"
"13760","BOSSICO",33,76,0,109,"2015","033"
"13761","BOSSOLASCO",60,84,0,144,"2015","027"
"13762","BOTTANUCO",19,243,344,606,"2015","034"
"13763","BOTTICINO",35,0,0,35,"2015","023"
"13764","BOVEGNO",84,94,38,216,"2015","024"
"13765","BOVES",798,548,284,1630,"2015","028"
"13766","BOVEZZO",1,0,0,1,"2015","025"
"13767","BOVOLENTA",3161,380,0,3541,"2015","014"
"13768","BOVOLONE",3207,299,0,3506,"2015","012"
"13769","BOZZOLO",68,1062,12,1142,"2015","007"
"13770","BRA",3986,1248,0,5234,"2015","029"
"13771","BRACCA",5,0,0,5,"2015","035"
"13772","BRALLO DI PREGOLA",5,14,0,19,"2015","021"
"13773","BRANDICO",1,517,0,518,"2015","026"
"13774","BRANDIZZO",0,0,86,86,"2015","034"
"13775","BRANZI",1,48,5,54,"2015","036"
"13776","BRAONE",0,31,0,31,"2015","027"
"13777","BREBBIA",29,0,2,31,"2015","017"
"13778","BREDA DI PIAVE",55,369,4,428,"2015","005"
"13779","BREGANO",3,0,0,3,"2015","018"
"13780","BREGANZE",420,802,169,1391,"2015","014"
"13781","BREGNANO",6,114,0,120,"2015","028"
"13782","BREIA",4,0,0,4,"2015","019"
"13783","BREMBATE",47,0,180,227,"2015","037"
"13784","BREMBATE DI SOPRA",2,223,0,225,"2015","038"
"13785","BREMBIO",73,1700,122,1895,"2015","006"
"13786","BREME",18,0,0,18,"2015","022"
"13787","BRENDOLA",285,93,5,383,"2015","015"
"13788","BRENNA",4,0,0,4,"2015","029"
"13789","BRENO",9,285,17,311,"2015","028"
"13790","BRENTA",3,0,0,3,"2015","019"
"13791","BRENTINO BELLUNO",3,0,0,3,"2015","013"
"13792","BRENZONE",5,0,0,5,"2015","014"
"13793","BRESCELLO",2,52,0,54,"2015","006"
"13794","BRESCIA",100,615,0,715,"2015","029"
"13795","BRESSANA BOTTARONE",23,0,0,23,"2015","023"
"13796","BRESSANVIDO",65,1398,0,1463,"2015","016"
"13797","BRESSO",2,0,0,2,"2015",NA
"13798","BREZZO DI BEDERO",5,0,0,5,"2015","020"
"13799","BRIAGLIA",46,0,0,46,"2015","030"
"13800","BRICHERASIO",980,48,24,1052,"2015","035"
"13801","BRIGA NOVARESE",11,65,0,76,"2015","026"
"13802","BRIGNANO GERA D'ADDA",190,1685,0,1875,"2015","040"
"13803","BRIGNANO-FRASCATA",6,0,0,6,"2015","024"
"13804","BRINZIO",8,0,0,8,"2015","021"
"13805","BRIONA",11,1613,0,1624,"2015","027"
"13806","BRIONE",9,0,0,9,"2015","030"
"13807","BRIOSCO",8,0,0,8,"2015",NA
"13808","BRISIGHELLA",322,63,0,385,"2015","004"
"13809","BRISSAGO-VALTRAVAGLIA",6,0,0,6,"2015","022"
"13810","BRIVIO",37,69,0,106,"2015","010"
"13811","BROGLIANO",35,35,0,70,"2015","017"
"13812","BRONDELLO",3,0,0,3,"2015","032"
"13813","BRONI",90,0,0,90,"2015","024"
"13814","BROSSASCO",66,0,0,66,"2015","033"
"13815","BROSSO",27,20,0,47,"2015","036"
"13816","BROVELLO-CARPUGNINO",20,0,5,25,"2015","013"
"13817","BROZOLO",81,0,0,81,"2015","037"
"13818","BRUGHERIO",0,286,0,286,"2015",NA
"13819","BRUGINE",3699,122,56,3877,"2015","015"
"13820","BRUINO",110,0,0,110,"2015","038"
"13821","BRUMANO",11,22,0,33,"2015","041"
"13822","BRUNELLO",13,4,0,17,"2015","023"
"13823","BRUNO",10,0,0,10,"2015","010"
"13824","BRUSAPORTO",33,0,25,58,"2015","042"
"13825","BRUSASCO",103,0,0,103,"2015","039"
"13826","BRUSNENGO",23,0,0,23,"2015","007"
"13827","BRUZOLO",66,30,10,106,"2015","040"
"13828","BUBBIANO",4,28,0,32,"2015","035"
"13829","BUBBIO",67,0,0,67,"2015","011"
"13830","BUCCINASCO",11,457,0,468,"2015","036"
"13831","BUDRIO",243,338,0,581,"2015","008"
"13832","BUGLIO IN MONTE",25,240,44,309,"2015","010"
"13833","BUGUGGIATE",12,0,0,12,"2015","025"
"13834","BULCIAGO",9,0,166,175,"2015","011"
"13835","BULGAROGRASSO",44,335,0,379,"2015","034"
"13836","BURIASCO",1133,743,197,2073,"2015","041"
"13837","BUROLO",5,0,0,5,"2015","042"
"13838","BURONZO",5,17,0,22,"2015","021"
"13839","BUSANA",0,29,0,29,"2015","007"
"13840","BUSANO",22,37,0,59,"2015","043"
"13841","BUSCA",4171,1272,671,6114,"2015","034"
"13842","BUSCATE",69,0,0,69,"2015","038"
"13843","BUSNAGO",10,2,0,12,"2015",NA
"13844","BUSSERO",2,589,0,591,"2015","040"
"13845","BUSSETO",12,3722,5,3739,"2015","007"
"13846","BUSSOLENGO",987,126,97,1210,"2015","015"
"13847","BUSSOLENO",35,241,0,276,"2015","044"
"13848","BUSTO ARSIZIO",16,233,37,286,"2015","026"
"13849","BUSTO GAROLFO",85,207,0,292,"2015","041"
"13850","BUTTAPIETRA",71,141,0,212,"2015","016"
"13851","BUTTIGLIERA ALTA",73,52,0,125,"2015","045"
"13852","BUTTIGLIERA D'ASTI",1794,114,62,1970,"2015","012"
"13853","CA' D'ANDREA",4,1329,0,1333,"2015","008"
"13854","CABELLA LIGURE",82,0,0,82,"2015","025"
"13855","CADEGLIANO-VICONAGO",4,0,0,4,"2015","027"
"13856","CADELBOSCO DI SOPRA",83,1669,0,1752,"2015","008"
"13857","CADEO",83,2513,0,2596,"2015","007"
"13858","CADONEGHE",6,0,18,24,"2015","016"
"13859","CADORAGO",10,0,68,78,"2015","036"
"13860","CADREZZATE",4,0,0,4,"2015","028"
"13861","CAERANO DI SAN MARCO",294,107,4,405,"2015","006"
"13862","CAFASSE",66,16,0,82,"2015","046"
"13863","CAGLIO",20,0,0,20,"2015","037"
"13864","CAGNO",0,36,0,36,"2015","038"
"13865","CAINO",5,0,0,5,"2015","031"
"13866","CAIOLO",5,123,0,128,"2015","011"
"13867","CAIRATE",3,0,2,5,"2015","029"
"13868","CALAMANDRANA",102,0,0,102,"2015","013"
"13869","CALASCA-CASTIGLIONE",16,0,0,16,"2015","014"
"13870","CALCINATE",331,222,0,553,"2015","043"
"13871","CALCINATO",3532,1914,1173,6619,"2015","032"
"13872","CALCIO",286,1369,0,1655,"2015","044"
"13873","CALCO",17,179,0,196,"2015","012"
"13874","CALDERARA DI RENO",43,81,0,124,"2015","009"
"13875","CALDIERO",1,0,0,1,"2015","017"
"13876","CALDOGNO",174,358,12,544,"2015","018"
"13877","CALENDASCO",142,392,0,534,"2015","008"
"13878","CALESTANO",3,459,0,462,"2015","008"
"13879","CALLABIANA",16,0,0,16,"2015","008"
"13880","CALLIANO",220,0,0,220,"2015","014"
"13881","CALOLZIOCORTE",15,0,16,31,"2015","013"
"13882","CALOSSO",8,0,0,8,"2015","015"
"13883","CALTIGNAGA",834,227,0,1061,"2015","030"
"13884","CALTO",16,0,0,16,"2015","008"
"13885","CALTRANO",1428,3,0,1431,"2015","019"
"13886","CALUSCO D'ADDA",14,0,0,14,"2015","046"
"13887","CALUSO",796,171,0,967,"2015","047"
"13888","CALVAGESE DELLA RIVIERA",102,214,8,324,"2015","033"
"13889","CALVATONE",33,112,3,148,"2015","009"
"13890","CALVENE",12,61,0,73,"2015","020"
"13891","CALVENZANO",2,485,0,487,"2015","047"
"13892","CALVIGNASCO",1,35,0,36,"2015","042"
"13893","CALVISANO",14729,4485,22,19236,"2015","034"
"13894","CAMAGNA MONFERRATO",24,0,0,24,"2015","026"
"13895","CAMAIRAGO",0,1227,0,1227,"2015","007"
"13896","CAMANDONA",8,0,0,8,"2015","009"
"13897","CAMBIAGO",16,96,0,112,"2015","044"
"13898","CAMBIANO",352,0,0,352,"2015","048"
"13899","CAMBIASCA",8,0,0,8,"2015","015"
"13900","CAMBURZANO",105,0,12,117,"2015","010"
"13901","CAMERANA",289,0,0,289,"2015","035"
"13902","CAMERANO CASASCO",18,0,0,18,"2015","016"
"13903","CAMERATA CORNELLO",4,78,0,82,"2015","048"
"13904","CAMERI",121,584,0,705,"2015","032"
"13905","CAMINATA",22,0,0,22,"2015","009"
"13906","CAMINO",1,0,0,1,"2015",NA
"13907","CAMISANO",249,2413,0,2662,"2015","010"
"13908","CAMISANO VICENTINO",400,1609,41,2050,"2015","021"
"13909","CAMPAGNA LUPIA",95,100,0,195,"2015","002"
"13910","CAMPAGNOLA CREMASCA",25,497,89,611,"2015","011"
"13911","CAMPAGNOLA EMILIA",10,733,0,743,"2015","009"
"13912","CAMPEGINE",2,1109,0,1111,"2015","010"
"13913","CAMPERTOGNO",130,31,0,161,"2015","025"
"13914","CAMPIGLIA CERVO",0,0,13,13,"2015","011"
"13915","CAMPIGLIA DEI BERICI",768,115,0,883,"2015","022"
"13916","CAMPIGLIONE-FENILE",644,3,77,724,"2015","049"
"13917","CAMPO SAN MARTINO",208,92,0,300,"2015","020"
"13918","CAMPODARSEGO",714,62,1,777,"2015","017"
"13919","CAMPODORO",66,250,0,316,"2015","018"
"13920","CAMPOGALLIANO",2,519,0,521,"2015","003"
"13921","CAMPOLONGO MAGGIORE",52,61,0,113,"2015","003"
"13922","CAMPOLONGO SUL BRENTA",34,0,0,34,"2015","023"
"13923","CAMPONOGARA",140,51,16,207,"2015","004"
"13924","CAMPOSAMPIERO",199,90,0,289,"2015","019"
"13925","CAMUGNANO",201,137,0,338,"2015","010"
"13926","CANALE",696,0,4,700,"2015","037"
"13927","CANARO",272,45,0,317,"2015","009"
"13928","CANDA",11,0,0,11,"2015","010"
"13929","CANDELO",39,87,67,193,"2015","012"
"13930","CANDIA CANAVESE",19,0,0,19,"2015","050"
"13931","CANDIANA",10614,193,0,10807,"2015","021"
"13932","CANDIOLO",159,403,172,734,"2015","051"
"13933","CANELLI",9,0,0,9,"2015","017"
"13934","CANEVINO",21,0,0,21,"2015","028"
"13935","CANISCHIO",5,23,0,28,"2015","052"
"13936","CANNERO RIVIERA",1,0,0,1,"2015","016"
"13937","CANNETO SULL'OGLIO",1537,1551,1154,4242,"2015","008"
"13938","CANNOBIO",12,0,0,12,"2015","017"
"13939","CANONICA D'ADDA",24,384,0,408,"2015","049"
"13940","CANOSIO",5,0,36,41,"2015","038"
"13941","CANOSSA",22,281,0,303,"2015","018"
"13942","CANTALUPA",40,0,0,40,"2015","053"
"13943","CANTALUPO LIGURE",9,0,0,9,"2015","028"
"13944","CANTARANA",90,0,0,90,"2015","018"
"13945","CANTELLO",126,165,0,291,"2015","030"
"13946","CANTOIRA",57,13,12,82,"2015","054"
"13947","CANTU'",230,230,24,484,"2015","041"
"13948","CANZO",0,0,14,14,"2015","042"
"13949","CAORLE",706,53,0,759,"2015","005"
"13950","CAORSO",1,448,0,449,"2015","010"
"13951","CAPERGNANICA",383,1052,0,1435,"2015","012"
"13952","CAPIAGO INTIMIANO",1,38,1,40,"2015","043"
"13953","CAPIZZONE",14,26,0,40,"2015","050"
"13954","CAPO DI PONTE",27,155,0,182,"2015","035"
"13955","CAPONAGO",57,0,0,57,"2015",NA
"13956","CAPOVALLE",18,10,1,29,"2015","036"
"13957","CAPPELLA CANTONE",0,342,0,342,"2015","013"
"13958","CAPPELLA DE' PICENARDI",2,348,0,350,"2015","014"
"13959","CAPPELLA MAGGIORE",16,17,2,35,"2015","007"
"13960","CAPRALBA",0,1472,0,1472,"2015","015"
"13961","CAPRAUNA",5,0,0,5,"2015","039"
"13962","CAPRIANO DEL COLLE",18,345,0,363,"2015","037"
"13963","CAPRIATA D'ORBA",40,0,0,40,"2015","029"
"13964","CAPRIE",20,0,0,20,"2015","055"
"13965","CAPRIGLIO",1,0,0,1,"2015","019"
"13966","CAPRILE",34,1,0,35,"2015","013"
"13967","CAPRINO BERGAMASCO",9,30,0,39,"2015","052"
"13968","CAPRINO VERONESE",79,677,71,827,"2015","018"
"13969","CAPRIOLO",290,39,46,375,"2015","038"
"13970","CARAGLIO",3050,816,419,4285,"2015","040"
"13971","CARAMAGNA PIEMONTE",1182,719,61,1962,"2015","041"
"13972","CARATE BRIANZA",6,0,0,6,"2015",NA
"13973","CARAVAGGIO",453,2761,59,3273,"2015","053"
"13974","CARAVATE",16,116,0,132,"2015","031"
"13975","CARAVINO",1,0,0,1,"2015","056"
"13976","CARBONARA AL TICINO",0,286,0,286,"2015","030"
"13977","CARBONARA DI PO",0,290,235,525,"2015","009"
"13978","CARBONARA SCRIVIA",43,0,0,43,"2015","030"
"13979","CARBONATE",129,43,22,194,"2015","045"
"13980","CARBONERA",77,343,0,420,"2015","008"
"13981","CARCERI",944,0,0,944,"2015","022"
"13982","CARCOFORO",0,11,0,11,"2015","029"
"13983","CARDANO AL CAMPO",10,0,0,10,"2015","032"
"13984","CARDE'",2415,1978,0,4393,"2015","042"
"13985","CAREMA",99,9,0,108,"2015","057"
"13986","CARENNO",27,0,4,31,"2015","014"
"13987","CARENTINO",70,603,0,673,"2015","031"
"13988","CARESANA",4,0,0,4,"2015","030"
"13989","CAREZZANO",5,0,0,5,"2015","032"
"13990","CARIGNANO",2761,1678,325,4764,"2015","058"
"13991","CARISIO",30,0,0,30,"2015","032"
"13992","CARLAZZO",17,40,29,86,"2015","047"
"13993","CARMAGNOLA",6132,3065,86,9283,"2015","059"
"13994","CARMIGNANO DI BRENTA",391,1294,0,1685,"2015","023"
"13995","CARNAGO",23,53,0,76,"2015","033"
"13996","CAROBBIO DEGLI ANGELI",94,29,0,123,"2015","055"
"13997","CARONNO PERTUSELLA",4,0,0,4,"2015","034"
"13998","CARONNO VARESINO",34,0,0,34,"2015","035"
"13999","CARPANETO PIACENTINO",57,4199,0,4256,"2015","011"
"14000","CARPENEDOLO",1560,4137,1,5698,"2015","039"
"14001","CARPENETO",122,0,0,122,"2015","033"
"14002","CARPI",12,1945,0,1957,"2015","005"
"14003","CARPIANO",133,1474,0,1607,"2015","050"
"14004","CARPIGNANO SESIA",135,0,0,135,"2015","036"
"14005","CARPINETI",118,1491,0,1609,"2015","011"
"14006","CARRE'",43,148,0,191,"2015","024"
"14007","CARREGA LIGURE",58,0,0,58,"2015","034"
"14008","CARRU'",671,23,77,771,"2015","043"
"14009","CARTIGLIANO",18,44,0,62,"2015","025"
"14010","CARTIGNANO",213,72,0,285,"2015","044"
"14011","CARTOSIO",38,0,0,38,"2015","036"
"14012","CARTURA",408,36,0,444,"2015","026"
"14013","CARUGATE",0,109,0,109,"2015","051"
"14014","CARUGO",8,0,0,8,"2015","048"
"14015","CARVICO",5,0,0,5,"2015","057"
"14016","CASAL CERMELLI",4,0,0,4,"2015","037"
"14017","CASALBELTRAME",1,0,133,134,"2015","037"
"14018","CASALBORGONE",60,0,0,60,"2015","060"
"14019","CASALBUTTANO ED UNITI",10,1113,0,1123,"2015","016"
"14020","CASALE CORTE CERRO",8,0,0,8,"2015","019"
"14021","CASALE CREMASCO-VIDOLASCO",45,1612,0,1657,"2015","017"
"14022","CASALE DI SCODOSIA",600,0,0,600,"2015","027"
"14023","CASALE LITTA",26,153,6,185,"2015","036"
"14024","CASALE MONFERRATO",127,165,0,292,"2015","039"
"14025","CASALE SUL SILE",134,104,9,247,"2015","009"
"14026","CASALEGGIO BOIRO",3,0,0,3,"2015","038"
"14027","CASALEONE",9,0,0,9,"2015","019"
"14028","CASALETTO CEREDANO",7,5,0,12,"2015","018"
"14029","CASALETTO DI SOPRA",25,311,0,336,"2015","019"
"14030","CASALETTO LODIGIANO",9,373,33,415,"2015","008"
"14031","CASALETTO VAPRIO",150,687,0,837,"2015","020"
"14032","CASALFIUMANESE",298,156,0,454,"2015","012"
"14033","CASALGRANDE",7,1114,0,1121,"2015","012"
"14034","CASALGRASSO",239,340,0,579,"2015","045"
"14035","CASALINO",5,395,0,400,"2015","040"
"14036","CASALMAGGIORE",14,683,0,697,"2015","021"
"14037","CASALMAIOCCO",25,590,0,615,"2015","009"
"14038","CASALMORANO",90,1974,0,2064,"2015","022"
"14039","CASALMORO",766,260,277,1303,"2015","010"
"14040","CASALNOCETO",34,0,0,34,"2015","040"
"14041","CASALOLDO",929,1111,907,2947,"2015","011"
"14042","CASALPUSTERLENGO",370,1228,0,1598,"2015","010"
"14043","CASALROMANO",55,247,202,504,"2015","012"
"14044","CASALSERUGO",129,10,66,205,"2015","028"
"14045","CASALVOLONE",13,59,0,72,"2015","041"
"14046","CASALZUIGNO",4,98,0,102,"2015","037"
"14047","CASARGO",9,7,0,16,"2015","015"
"14048","CASARILE",36,28,0,64,"2015","055"
"14049","CASASCO D'INTELVI",2,0,0,2,"2015",NA
"14050","CASATENOVO",405,22,0,427,"2015","016"
"14051","CASAZZA",5,25,1,31,"2015","058"
"14052","CASCIAGO",26,0,35,61,"2015","038"
"14053","CASEI GEROLA",545,0,0,545,"2015","033"
"14054","CASELETTE",93,321,34,448,"2015","062"
"14055","CASELLE LANDI",322,405,0,727,"2015","011"
"14056","CASELLE LURANI",71,251,12,334,"2015","012"
"14057","CASELLE TORINESE",266,1342,0,1608,"2015","063"
"14058","CASIER",9,103,0,112,"2015","010"
"14059","CASINA",85,1047,0,1132,"2015","013"
"14060","CASIRATE D'ADDA",171,332,0,503,"2015","059"
"14061","CASLINO D'ERBA",0,17,1,18,"2015","052"
"14062","CASNATE CON BERNATE",42,0,0,42,"2015","053"
"14063","CASNIGO",55,151,0,206,"2015","060"
"14064","CASOLA VALSENIO",134,84,0,218,"2015","005"
"14065","CASORATE PRIMO",19,102,0,121,"2015","034"
"14066","CASORATE SEMPIONE",2,0,0,2,"2015","039"
"14067","CASOREZZO",2,331,0,333,"2015","058"
"14068","CASORZO",3,0,0,3,"2015","020"
"14069","CASPOGGIO",2,39,0,41,"2015","013"
"14070","CASSAGO BRIANZA",4,35,1,40,"2015","017"
"14071","CASSANO D'ADDA",175,180,0,355,"2015","059"
"14072","CASSANO MAGNAGO",29,126,18,173,"2015","040"
"14073","CASSANO SPINOLA",319,0,0,319,"2015","042"
"14074","CASSANO VALCUVIA",4,0,0,4,"2015","041"
"14075","CASSINA DE' PECCHI",0,452,0,452,"2015","060"
"14076","CASSINA VALSASSINA",3,57,0,60,"2015","018"
"14077","CASSINASCO",25,19,0,44,"2015","021"
"14078","CASSINE",147,0,0,147,"2015","043"
"14079","CASSINELLE",6,0,0,6,"2015","044"
"14080","CASSINETTA DI LUGAGNANO",5,171,0,176,"2015","061"
"14081","CASSOLA",769,26,0,795,"2015","026"
"14082","CASSOLNOVO",13,43,0,56,"2015","035"
"14083","CASTAGNARO",411,0,0,411,"2015","020"
"14084","CASTAGNETO PO",59,0,0,59,"2015","064"
"14085","CASTAGNITO",214,0,0,214,"2015","046"
"14086","CASTAGNOLE DELLE LANZE",262,0,0,262,"2015","022"
"14087","CASTAGNOLE MONFERRATO",58,0,0,58,"2015","023"
"14088","CASTAGNOLE PIEMONTE",1335,832,52,2219,"2015","065"
"14089","CASTANA",1,0,0,1,"2015","036"
"14090","CASTANO PRIMO",87,0,0,87,"2015","062"
"14091","CASTEGGIO",39,0,0,39,"2015","037"
"14092","CASTEGNATO",21,1154,35,1210,"2015","040"
"14093","CASTEGNERO",131,42,0,173,"2015","027"
"14094","CASTEL BOGLIONE",17,0,0,17,"2015","024"
"14095","CASTEL BOLOGNESE",30,0,0,30,"2015","006"
"14096","CASTEL D'AIANO",30,520,18,568,"2015","013"
"14097","CASTEL D'ARIO",0,225,824,1049,"2015","014"
"14098","CASTEL D'AZZANO",1712,143,0,1855,"2015","021"
"14099","CASTEL DEL RIO",5,17,0,22,"2015","014"
"14100","CASTEL DI CASIO",77,22,0,99,"2015","015"
"14101","CASTEL GABBIANO",0,1613,0,1613,"2015","024"
"14102","CASTEL GOFFREDO",1715,564,496,2775,"2015","015"
"14103","CASTEL GUELFO DI BOLOGNA",115,286,0,401,"2015","016"
"14104","CASTEL MAGGIORE",2,0,0,2,"2015","019"
"14105","CASTEL MELLA",4,368,0,372,"2015","042"
"14106","CASTEL ROCCHERO",15,0,0,15,"2015","032"
"14107","CASTEL ROZZONE",3,36,0,39,"2015","063"
"14108","CASTEL SAN GIOVANNI",160,917,0,1077,"2015","013"
"14109","CASTEL SAN PIETRO TERME",320,302,0,622,"2015","020"
"14110","CASTELBELFORTE",1432,62,0,1494,"2015","013"
"14111","CASTELCOVATI",12,285,0,297,"2015","041"
"14112","CASTELCUCCO",48,215,0,263,"2015","011"
"14113","CASTELDELCI",188,0,0,188,"2015","021"
"14114","CASTELDELFINO",55,0,0,55,"2015","047"
"14115","CASTELDIDONE",51,0,0,51,"2015","023"
"14116","CASTELFRANCO EMILIA",948,2726,0,3674,"2015","006"
"14117","CASTELFRANCO VENETO",5994,184,9,6187,"2015","012"
"14118","CASTELGOMBERTO",416,390,0,806,"2015","028"
"14119","CASTELGUGLIELMO",486,0,0,486,"2015","011"
"14120","CASTELL'ALFERO",374,0,0,374,"2015","025"
"14121","CASTELL'ARQUATO",53,743,0,796,"2015","012"
"14122","CASTELLAMONTE",400,299,0,699,"2015","066"
"14123","CASTELLANIA",3,0,0,3,"2015",NA
"14124","CASTELLAR",7,0,0,7,"2015","048"
"14125","CASTELLARANO",31,291,0,322,"2015","014"
"14126","CASTELLAZZO BORMIDA",113,1,0,114,"2015","047"
"14127","CASTELLAZZO NOVARESE",2,0,0,2,"2015","042"
"14128","CASTELLEONE",783,3628,3,4414,"2015","025"
"14129","CASTELLERO",1,0,0,1,"2015","026"
"14130","CASTELLETTO CERVO",22,0,0,22,"2015","015"
"14131","CASTELLETTO D'ERRO",1,0,0,1,"2015",NA
"14132","CASTELLETTO D'ORBA",10,0,0,10,"2015","049"
"14133","CASTELLETTO DI BRANDUZZO",6,0,0,6,"2015","038"
"14134","CASTELLETTO MERLI",79,0,0,79,"2015","050"
"14135","CASTELLETTO MONFERRATO",87,0,0,87,"2015","051"
"14136","CASTELLETTO SOPRA TICINO",105,62,0,167,"2015","043"
"14137","CASTELLETTO STURA",1309,64,91,1464,"2015","049"
"14138","CASTELLETTO UZZONE",14,0,0,14,"2015","050"
"14139","CASTELLI CALEPIO",45,286,0,331,"2015","062"
"14140","CASTELLINALDO D'ALBA",815,0,0,815,"2015",NA
"14141","CASTELLINO TANARO",138,0,0,138,"2015","052"
"14142","CASTELLO CABIAGLIO",15,0,0,15,"2015","043"
"14143","CASTELLO D'ARGILE",29,61,0,90,"2015","017"
"14144","CASTELLO DELL'ACQUA",15,12,0,27,"2015","014"
"14145","CASTELLO DI ANNONE",143,0,0,143,"2015","028"
"14146","CASTELLO DI BRIANZA",19,0,0,19,"2015","019"
"14147","CASTELLO DI GODEGO",5448,145,1,5594,"2015","013"
"14148","CASTELLUCCHIO",878,1428,1663,3969,"2015","016"
"14149","CASTELMAGNO",64,13,11,88,"2015","053"
"14150","CASTELMARTE",14,0,1,15,"2015","058"
"14151","CASTELMASSA",4,128,0,132,"2015","012"
"14152","CASTELNOVETTO",1,0,0,1,"2015","040"
"14153","CASTELNOVO BARIANO",859,46,0,905,"2015","013"
"14154","CASTELNOVO DI SOTTO",11,1107,16,1134,"2015","015"
"14155","CASTELNOVO NE' MONTI",106,1502,0,1608,"2015","016"
"14156","CASTELNUOVO BELBO",6,0,0,6,"2015","029"
"14157","CASTELNUOVO BOCCA D'ADDA",2612,212,0,2824,"2015","013"
"14158","CASTELNUOVO BORMIDA",10,0,0,10,"2015","052"
"14159","CASTELNUOVO BOZZENTE",4,18,0,22,"2015","059"
"14160","CASTELNUOVO DEL GARDA",3021,274,0,3295,"2015","022"
"14161","CASTELNUOVO DON BOSCO",181,0,0,181,"2015","031"
"14162","CASTELNUOVO NIGRA",51,0,0,51,"2015","067"
"14163","CASTELNUOVO RANGONE",0,753,0,753,"2015","007"
"14164","CASTELNUOVO SCRIVIA",176,0,17,193,"2015","053"
"14165","CASTELSEPRIO",1,0,2,3,"2015","044"
"14166","CASTELSPINA",13,0,0,13,"2015","054"
"14167","CASTELVECCANA",3,0,0,3,"2015","045"
"14168","CASTELVERDE",30,3307,68,3405,"2015","026"
"14169","CASTELVETRO DI MODENA",24,1319,0,1343,"2015","008"
"14170","CASTELVETRO PIACENTINO",616,950,0,1566,"2015","014"
"14171","CASTELVISCONTI",4,1572,0,1576,"2015","027"
"14172","CASTENASO",36,229,0,265,"2015","021"
"14173","CASTENEDOLO",829,1397,13,2239,"2015","043"
"14174","CASTIGLIONE D'ADDA",8,438,0,446,"2015","014"
"14175","CASTIGLIONE D'INTELVI",5,24,4,33,"2015","060"
"14176","CASTIGLIONE DEI PEPOLI",115,94,0,209,"2015","022"
"14177","CASTIGLIONE DELLE STIVIERE",3191,1400,1542,6133,"2015","017"
"14178","CASTIGLIONE FALLETTO",15,0,0,15,"2015","055"
"14179","CASTIGLIONE OLONA",2,0,8,10,"2015","046"
"14180","CASTIGLIONE TINELLA",33,0,0,33,"2015","056"
"14181","CASTIGLIONE TORINESE",20,0,0,20,"2015","068"
"14182","CASTINO",177,0,0,177,"2015","057"
"14183","CASTIONE ANDEVENNO",21,40,1,62,"2015","015"
"14184","CASTIONE DELLA PRESOLANA",34,7,0,41,"2015","064"
"14185","CASTIRAGA VIDARDO",6,264,0,270,"2015","015"
"14186","CASTO",26,32,1,59,"2015","044"
"14187","CASTREZZATO",367,1224,8,1599,"2015","045"
"14188","CASTRO",1,0,0,1,"2015","065"
"14189","CASTROCARO TERME E TERRA DEL SOLE",4,0,4,8,"2015","005"
"14190","CASTRONNO",3,0,0,3,"2015","047"
"14191","CAVA MANARA",1,0,0,1,"2015","041"
"14192","CAVACURTA",65,442,0,507,"2015","016"
"14193","CAVAGLIA'",1143,196,16,1355,"2015","016"
"14194","CAVAGLIETTO",2,211,0,213,"2015","044"
"14195","CAVAGNOLO",26,0,0,26,"2015","069"
"14196","CAVAION VERONESE",6,0,0,6,"2015","023"
"14197","CAVALLASCA",0,0,19,19,"2015","061"
"14198","CAVALLERLEONE",404,1114,85,1603,"2015","058"
"14199","CAVALLERMAGGIORE",2278,2409,40,4727,"2015","059"
"14200","CAVALLINO-TREPORTI",30,0,0,30,"2015","044"
"14201","CAVALLIRIO",2,0,0,2,"2015","047"
"14202","CAVARGNA",0,0,8,8,"2015","062"
"14203","CAVARIA CON PREMEZZO",4,0,0,4,"2015","048"
"14204","CAVARZERE",6157,7,0,6164,"2015","006"
"14205","CAVASO DEL TOMBA",92,62,0,154,"2015","014"
"14206","CAVATORE",3,0,0,3,"2015","055"
"14207","CAVENAGO D'ADDA",18,827,159,1004,"2015","017"
"14208","CAVERNAGO",7,0,0,7,"2015","066"
"14209","CAVEZZO",0,355,0,355,"2015","009"
"14210","CAVOUR",3076,429,944,4449,"2015","070"
"14211","CAVRIAGO",10,601,0,611,"2015","017"
"14212","CAVRIANA",1867,1633,359,3859,"2015","018"
"14213","CAZZAGO SAN MARTINO",4366,215,153,4734,"2015","046"
"14214","CAZZANO DI TRAMIGNA",15,0,0,15,"2015","024"
"14215","CAZZANO SANT'ANDREA",298,0,0,298,"2015","067"
"14216","CECIMA",14,0,0,14,"2015","042"
"14217","CEDEGOLO",1,24,4,29,"2015","047"
"14218","CEDRASCO",0,68,0,68,"2015","016"
"14219","CEGGIA",8,2,0,10,"2015","007"
"14220","CELLA DATI",265,79,24,368,"2015","028"
"14221","CELLA MONTE",154,0,0,154,"2015","056"
"14222","CELLARENGO",263,79,123,465,"2015","033"
"14223","CELLATICA",3,46,0,49,"2015","048"
"14224","CELLE DI MACRA",116,0,0,116,"2015","060"
"14225","CELLE ENOMONDO",186,0,0,186,"2015","034"
"14226","CELLIO",8,0,0,8,"2015","038"
"14227","CENATE SOPRA",11,0,6,17,"2015","068"
"14228","CENATE SOTTO",23,0,0,23,"2015","069"
"14229","CENCENIGHE AGORDINO",0,7,0,7,"2015","010"
"14230","CENE",25,41,0,66,"2015","070"
"14231","CENESELLI",2,214,7,223,"2015","014"
"14232","CENTALLO",5303,619,320,6242,"2015","061"
"14233","CEPPO MORELLI",22,0,0,22,"2015","021"
"14234","CERANO",73,0,0,73,"2015","049"
"14235","CERANO D'INTELVI",8,0,34,42,"2015","063"
"14236","CERANOVA",0,647,0,647,"2015","043"
"14237","CERCENASCO",144,246,0,390,"2015","071"
"14238","CERCINO",13,50,0,63,"2015","017"
"14239","CEREA",1131,221,0,1352,"2015","025"
"14240","CEREGNANO",3,0,0,3,"2015","015"
"14241","CERES",10,0,0,10,"2015","072"
"14242","CERESARA",1269,426,120,1815,"2015","019"
"14243","CERESETO",95,0,0,95,"2015","057"
"14244","CERESOLE ALBA",3129,649,0,3778,"2015","062"
"14245","CERESOLE REALE",0,32,0,32,"2015","073"
"14246","CERETE",10,193,0,203,"2015","071"
"14247","CERETTO LOMELLINA",1,0,0,1,"2015","044"
"14248","CERIANO LAGHETTO",0,38,0,38,"2015",NA
"14249","CERIGNALE",29,0,0,29,"2015","015"
"14250","CERMENATE",1,211,4,216,"2015","064"
"14251","CERNUSCO LOMBARDONE",11,0,0,11,"2015","020"
"14252","CERNUSCO SUL NAVIGLIO",1,154,0,155,"2015","070"
"14253","CERRETO CASTELLO",55,84,0,139,"2015","017"
"14254","CERRETO D'ASTI",1,0,0,1,"2015","035"
"14255","CERRETO GRUE",33,0,0,33,"2015","058"
"14256","CERRETTO LANGHE",12,0,0,12,"2015","063"
"14257","CERRINA MONFERRATO",37,0,53,90,"2015","059"
"14258","CERRIONE",96,343,0,439,"2015","018"
"14259","CERRO AL LAMBRO",2,708,0,710,"2015","071"
"14260","CERRO MAGGIORE",5,71,0,76,"2015","072"
"14261","CERRO TANARO",219,0,0,219,"2015","036"
"14262","CERRO VERONESE",3,131,0,134,"2015","026"
"14263","CERTOSA DI PAVIA",19,0,0,19,"2015","046"
"14264","CERVARESE SANTA CROCE",49,172,39,260,"2015","030"
"14265","CERVASCA",845,300,37,1182,"2015","064"
"14266","CERVATTO",8,0,0,8,"2015",NA
"14267","CERVENO",2,14,6,22,"2015","049"
"14268","CERVERE",1516,267,169,1952,"2015","065"
"14269","CERVIA",3,0,0,3,"2015","007"
"14270","CERVIGNANO D'ADDA",0,881,0,881,"2015","018"
"14271","CESANA BRIANZA",4,29,0,33,"2015","021"
"14272","CESANA TORINESE",38,0,36,74,"2015","074"
"14273","CESANO BOSCONE",0,84,0,84,"2015","074"
"14274","CESANO MADERNO",2,0,0,2,"2015",NA
"14275","CESARA",2,0,0,2,"2015","022"
"14276","CESENA",91,26,0,117,"2015","007"
"14277","CESENATICO",0,84,0,84,"2015","008"
"14278","CESIOMAGGIORE",269,88,0,357,"2015","011"
"14279","CESSALTO",28,117,0,145,"2015","015"
"14280","CESSOLE",167,0,0,167,"2015","037"
"14281","CETO",4,39,20,63,"2015","050"
"14282","CEVA",897,0,0,897,"2015","066"
"14283","CEVO",44,4,3,51,"2015","051"
"14284","CHERASCO",4464,1025,0,5489,"2015","067"
"14285","CHIALAMBERTO",18,55,0,73,"2015","075"
"14286","CHIAMPO",33,85,0,118,"2015","029"
"14287","CHIANOCCO",127,0,0,127,"2015","076"
"14288","CHIARANO",19,462,0,481,"2015","016"
"14289","CHIARI",1239,5195,167,6601,"2015","052"
"14290","CHIAVENNA",5,7,7,19,"2015","018"
"14291","CHIAVERANO",20,0,0,20,"2015","077"
"14292","CHIERI",2756,536,57,3349,"2015","078"
"14293","CHIES D'ALPAGO",24,8,0,32,"2015","012"
"14294","CHIESA IN VALMALENCO",22,64,2,88,"2015","019"
"14295","CHIESANUOVA",32,59,0,91,"2015","079"
"14296","CHIEVE",101,931,0,1032,"2015","029"
"14297","CHIGNOLO D'ISOLA",58,352,0,410,"2015","072"
"14298","CHIGNOLO PO",27,81,0,108,"2015","048"
"14299","CHIOGGIA",2561,0,0,2561,"2015","008"
"14300","CHIOMONTE",3,19,0,22,"2015","080"
"14301","CHIUDUNO",40,0,0,40,"2015","073"
"14302","CHIUPPANO",14,44,0,58,"2015","030"
"14303","CHIURO",2,89,0,91,"2015","020"
"14304","CHIUSA DI PESIO",1444,302,267,2013,"2015","068"
"14305","CHIUSA DI SAN MICHELE",0,0,50,50,"2015","081"
"14306","CHIUSANO D'ASTI",29,0,0,29,"2015","038"
"14307","CHIVASSO",1530,258,0,1788,"2015","082"
"14308","CICOGNOLO",0,761,0,761,"2015","030"
"14309","CICONIO",81,87,0,168,"2015","083"
"14310","CIGLIANO",271,87,34,392,"2015","042"
"14311","CIGLIE'",502,0,0,502,"2015","069"
"14312","CIGOGNOLA",2,0,0,2,"2015","049"
"14313","CIGOLE",1114,1216,0,2330,"2015","053"
"14314","CILAVEGNA",20,30,0,50,"2015","050"
"14315","CIMADOLMO",12,74,0,86,"2015","017"
"14316","CIMBERGO",2,2,0,4,"2015","054"
"14317","CINAGLIO",741,0,0,741,"2015","039"
"14318","CINGIA DE' BOTTI",1,873,0,874,"2015","031"
"14319","CINO",13,12,0,25,"2015","021"
"14320","CINTANO",32,0,0,32,"2015","084"
"14321","CINTO CAOMAGGIORE",432,9,25,466,"2015","009"
"14322","CINTO EUGANEO",49,41,0,90,"2015","031"
"14323","CINZANO",16,0,0,16,"2015","085"
"14324","CIRIE'",321,297,0,618,"2015","086"
"14325","CIRIMIDO",3,43,0,46,"2015","068"
"14326","CISANO BERGAMASCO",17,0,0,17,"2015","074"
"14327","CISERANO",15,40,5,60,"2015","075"
"14328","CISLAGO",3,0,0,3,"2015","050"
"14329","CISLIANO",251,511,0,762,"2015","078"
"14330","CISMON DEL GRAPPA",3,33,0,36,"2015","031"
"14331","CISON DI VALMARINO",57,9,22,88,"2015","018"
"14332","CISSONE",7,0,0,7,"2015","070"
"14333","CISTERNA D'ASTI",94,0,0,94,"2015","040"
"14334","CITTADELLA",2069,1119,111,3299,"2015","032"
"14335","CITTIGLIO",14,12,0,26,"2015","051"
"14336","CIVATE",13,0,0,13,"2015","022"
"14337","CIVIASCO",4,1,0,5,"2015","043"
"14338","CIVIDATE AL PIANO",1044,555,6,1605,"2015","076"
"14339","CIVIDATE CAMUNO",4,0,0,4,"2015","055"
"14340","CIVITELLA DI ROMAGNA",466,0,33,499,"2015","009"
"14341","CIVO",6,23,0,29,"2015","022"
"14342","CLAINO CON OSTENO",1,0,3,4,"2015","071"
"14343","CLAVESANA",437,0,0,437,"2015","071"
"14344","CLIVIO",15,47,0,62,"2015","052"
"14345","CLUSONE",65,215,0,280,"2015","077"
"14346","COASSOLO TORINESE",28,39,1,68,"2015","088"
"14347","COAZZE",17,0,15,32,"2015","089"
"14348","COAZZOLO",36,0,0,36,"2015","041"
"14349","COCCAGLIO",358,663,11,1032,"2015","056"
"14350","COCCONATO",112,0,0,112,"2015","042"
"14351","COCQUIO-TREVISAGO",22,0,0,22,"2015","053"
"14352","CODEVIGO",600,141,6,747,"2015","033"
"14353","CODIGORO",2840,238,0,3078,"2015","005"
"14354","CODOGNE'",46,238,2,286,"2015","019"
"14355","CODOGNO",30,815,0,845,"2015","019"
"14356","COGGIOLA",6,0,0,6,"2015","019"
"14357","COGLIATE",72,0,0,72,"2015",NA
"14358","COGOLLO DEL CENGIO",357,90,23,470,"2015","032"
"14359","COLERE",5,0,0,5,"2015","078"
"14360","COLI",54,0,0,54,"2015","016"
"14361","COLICO",98,128,52,278,"2015","023"
"14362","COLLAGNA",6,71,0,77,"2015","019"
"14363","COLLE BRIANZA",20,0,1,21,"2015","024"
"14364","COLLE SANTA LUCIA",0,21,0,21,"2015","014"
"14365","COLLE UMBERTO",33,180,0,213,"2015","020"
"14366","COLLECCHIO",7,2556,0,2563,"2015","009"
"14367","COLLEGNO",169,274,5,448,"2015","090"
"14368","COLLERETTO CASTELNUOVO",5,26,0,31,"2015","091"
"14369","COLLERETTO GIACOSA",28,0,0,28,"2015","092"
"14370","COLLIO",39,66,10,115,"2015","058"
"14371","COLOGNA VENETA",8595,187,0,8782,"2015","027"
"14372","COLOGNE",424,609,15,1048,"2015","059"
"14373","COLOGNO AL SERIO",40,977,8,1025,"2015","079"
"14374","COLOGNO MONZESE",2,0,0,2,"2015","081"
"14375","COLOGNOLA AI COLLI",8,0,0,8,"2015","028"
"14376","COLORINA",41,426,0,467,"2015","023"
"14377","COLORNO",15,1604,0,1619,"2015","010"
"14378","COLTURANO",20,15,0,35,"2015","082"
"14379","COLVERDE",18,102,22,142,"2015",NA
"14380","COLZATE",29,13,0,42,"2015","080"
"14381","COMACCHIO",504,176,0,680,"2015","006"
"14382","COMAZZO",53,844,3,900,"2015","020"
"14383","COMELICO SUPERIORE",31,172,0,203,"2015","015"
"14384","COMERIO",3,0,0,3,"2015","055"
"14385","COMEZZANO-CIZZAGO",184,1888,0,2072,"2015","060"
"14386","COMMESSAGGIO",0,10,18,28,"2015","020"
"14387","COMO",6,60,10,76,"2015","075"
"14388","COMPIANO",10,22,0,32,"2015","011"
"14389","COMUN NUOVO",33,31,0,64,"2015","081"
"14390","CONA",12368,0,0,12368,"2015","010"
"14391","CONCAMARISE",3,232,0,235,"2015","029"
"14392","CONCESIO",15,11,0,26,"2015","061"
"14393","CONCO",31,261,0,292,"2015","033"
"14394","CONCORDIA SAGITTARIA",1122,0,0,1122,"2015","011"
"14395","CONCORDIA SULLA SECCHIA",17,364,0,381,"2015","010"
"14396","CONCOREZZO",11,21,0,32,"2015",NA
"14397","CONDOVE",138,24,42,204,"2015","093"
"14398","CONEGLIANO",38,63,12,113,"2015","021"
"14399","CONFIENZA",41,19,34,94,"2015","052"
"14400","CONIOLO",176,0,0,176,"2015","060"
"14401","CONSELICE",489,219,0,708,"2015","008"
"14402","CONSELVE",712,37,0,749,"2015","034"
"14403","CONZANO",73,0,0,73,"2015","061"
"14404","COPPARO",46,0,0,46,"2015","007"
"14405","CORBETTA",1049,60,16,1125,"2015","085"
"14406","CORBOLA",80,199,0,279,"2015","017"
"14407","CORDIGNANO",107,242,0,349,"2015","022"
"14408","CORIANO",34,202,0,236,"2015","003"
"14409","CORIO",179,23,0,202,"2015","094"
"14410","CORNA IMAGNA",21,50,0,71,"2015","082"
"14411","CORNALBA",1,12,0,13,"2015","249"
"14412","CORNAREDO",13,195,7,215,"2015","087"
"14413","CORNATE D'ADDA",28,80,0,108,"2015",NA
"14414","CORNEDO VICENTINO",9,139,0,148,"2015","034"
"14415","CORNEGLIANO LAUDENSE",0,168,0,168,"2015","021"
"14416","CORNELIANO D'ALBA",131,0,0,131,"2015","072"
"14417","CORNIGLIO",22,464,0,486,"2015","012"
"14418","CORNO GIOVINE",161,91,0,252,"2015","022"
"14419","CORNOVECCHIO",107,0,0,107,"2015","023"
"14420","CORNUDA",1127,381,0,1508,"2015","023"
"14421","CORREGGIO",12,2000,0,2012,"2015","020"
"14422","CORREZZANA",1,42,0,43,"2015",NA
"14423","CORREZZOLA",4989,18,0,5007,"2015","035"
"14424","CORRIDO",22,2,6,30,"2015","077"
"14425","CORTANZE",62,0,0,62,"2015","046"
"14426","CORTAZZONE",4,0,0,4,"2015","047"
"14427","CORTE BRUGNATELLA",84,23,0,107,"2015","017"
"14428","CORTE DE' CORTESI CON CIGNONE",2,102,161,265,"2015","032"
"14429","CORTE DE' FRATI",8,748,0,756,"2015","033"
"14430","CORTE FRANCA",92,71,0,163,"2015","062"
"14431","CORTE PALASIO",6,1806,1,1813,"2015","024"
"14432","CORTEMAGGIORE",150,1670,0,1820,"2015","018"
"14433","CORTEMILIA",245,0,0,245,"2015","073"
"14434","CORTENO GOLGI",15,90,12,117,"2015","063"
"14435","CORTENOVA",6,32,0,38,"2015","025"
"14436","CORTENUOVA",176,1300,0,1476,"2015","083"
"14437","CORTEOLONA",10,0,0,10,"2015","056"
"14438","CORTINA D'AMPEZZO",23,35,0,58,"2015","016"
"14439","CORVINO SAN QUIRICO",2,0,0,2,"2015","057"
"14440","CORZANO",116,247,0,363,"2015","064"
"14441","COSIO VALTELLINO",30,661,1,692,"2015","024"
"14442","COSSANO BELBO",367,0,0,367,"2015","074"
"14443","COSSATO",271,145,0,416,"2015","020"
"14444","COSSOGNO",1,0,0,1,"2015","023"
"14445","COSTA DE' NOBILI",76,17,2,95,"2015","058"
"14446","COSTA DI MEZZATE",12,0,0,12,"2015","084"
"14447","COSTA DI ROVIGO",1,334,0,335,"2015","018"
"14448","COSTA MASNAGA",14,5,0,19,"2015","026"
"14449","COSTA SERINA",14,8,0,22,"2015","247"
"14450","COSTA VALLE IMAGNA",5,0,0,5,"2015","085"
"14451","COSTA VESCOVATO",38,0,0,38,"2015","062"
"14452","COSTA VOLPINO",22,33,0,55,"2015","086"
"14453","COSTABISSARA",30,37,0,67,"2015","035"
"14454","COSTERMANO",16,46,0,62,"2015","030"
"14455","COSTIGLIOLE D'ASTI",461,2,0,463,"2015","050"
"14456","COSTIGLIOLE SALUZZO",281,66,0,347,"2015","075"
"14457","COTIGNOLA",93,0,0,93,"2015","009"
"14458","COVO",664,1298,0,1962,"2015","087"
"14459","CRANDOLA VALSASSINA",2,2,4,8,"2015","027"
"14460","CRAVAGLIANA",2,15,0,17,"2015","048"
"14461","CRAVANZANA",3,0,0,3,"2015","076"
"14462","CRAVEGGIA",16,0,0,16,"2015","024"
"14463","CREAZZO",8,29,0,37,"2015","036"
"14464","CREDARO",3,158,0,161,"2015","088"
"14465","CREDERA RUBBIANO",0,1425,44,1469,"2015","034"
"14466","CREMA",423,2214,232,2869,"2015","035"
"14467","CREMELLA",7,0,0,7,"2015","028"
"14468","CREMENO",2,20,62,84,"2015","029"
"14469","CREMIA",2,5,4,11,"2015","083"
"14470","CREMOLINO",104,0,0,104,"2015","063"
"14471","CREMONA",157,1645,0,1802,"2015","036"
"14472","CREMOSANO",14,488,4,506,"2015","037"
"14473","CRESCENTINO",92,0,28,120,"2015","049"
"14474","CRESPADORO",32,79,0,111,"2015","037"
"14475","CRESPANO DEL GRAPPA",1336,751,0,2087,"2015","024"
"14476","CRESPIATICA",0,374,0,374,"2015","025"
"14477","CRESPINO",1822,0,0,1822,"2015","019"
"14478","CRESSA",42,222,0,264,"2015","055"
"14479","CREVACUORE",8,0,0,8,"2015","021"
"14480","CREVALCORE",377,23,0,400,"2015","024"
"14481","CREVOLADOSSOLA",83,45,0,128,"2015","025"
"14482","CRISSOLO",0,24,0,24,"2015",NA
"14483","CROCETTA DEL MONTELLO",88,58,0,146,"2015","025"
"14484","CRODO",25,124,12,161,"2015","026"
"14485","CROSIO DELLA VALLE",6,0,0,6,"2015","057"
"14486","CROTTA D'ADDA",5,524,0,529,"2015","038"
"14487","CROVA",3,0,0,3,"2015","052"
"14488","CUASSO AL MONTE",33,0,0,33,"2015","058"
"14489","CUCCARO MONFERRATO",19,0,0,19,"2015","064"
"14490","CUCCIAGO",6,0,0,6,"2015","084"
"14491","CUCEGLIO",45,0,0,45,"2015","096"
"14492","CUGGIONO",463,39,0,502,"2015","096"
"14493","CUGLIATE-FABIASCO",1,0,0,1,"2015","059"
"14494","CUMIANA",1349,624,47,2020,"2015","097"
"14495","CUMIGNANO SUL NAVIGLIO",0,1450,0,1450,"2015","039"
"14496","CUNARDO",2,0,0,2,"2015","060"
"14497","CUNEO",8244,585,1404,10233,"2015","078"
"14498","CUNICO",1588,0,0,1588,"2015","051"
"14499","CUORGNE'",163,64,0,227,"2015","098"
"14500","CURA CARPIGNANO",12,146,1,159,"2015","060"
"14501","CUREGGIO",20,45,1,66,"2015","058"
"14502","CURIGLIA CON MONTEVIASCO",1,2,3,6,"2015","061"
"14503","CURINO",5,0,0,5,"2015","023"
"14504","CURNO",53,57,19,129,"2015","089"
"14505","CURSOLO-ORASSO",17,0,0,17,"2015","027"
"14506","CURTAROLO",119,183,5,307,"2015","036"
"14507","CURTATONE",3393,1233,1470,6096,"2015","021"
"14508","CUSAGO",120,387,2,509,"2015","097"
"14509","CUSINO",8,0,1,9,"2015","085"
"14510","CUSIO",2,0,0,2,"2015","090"
"14511","CUVEGLIO",3,0,0,3,"2015","062"
"14512","CUVIO",5,67,0,72,"2015","063"
"14513","DAIRAGO",31,34,0,65,"2015","099"
"14514","DALMINE",113,97,0,210,"2015","091"
"14515","DARFO BOARIO TERME",10,268,16,294,"2015","065"
"14516","DAVERIO",2,0,0,2,"2015","064"
"14517","DAZIO",0,16,0,16,"2015","025"
"14518","DELEBIO",39,139,0,178,"2015","026"
"14519","DELLO",689,1837,6,2532,"2015","066"
"14520","DEMONTE",616,162,64,842,"2015","079"
"14521","DENICE",3,0,0,3,"2015","065"
"14522","DERNICE",9,7,0,16,"2015","066"
"14523","DEROVERE",19,274,0,293,"2015","040"
"14524","DESANA",40,0,0,40,"2015","054"
"14525","DESENZANO DEL GARDA",173,1455,474,2102,"2015","067"
"14526","DESIO",24,0,0,24,"2015",NA
"14527","DIANO D'ALBA",93,0,0,93,"2015","080"
"14528","DIVIGNANO",69,0,0,69,"2015","060"
"14529","DIZZASCO",0,0,5,5,"2015","087"
"14530","DOGLIANI",1750,0,0,1750,"2015","081"
"14531","DOLO",493,251,0,744,"2015","012"
"14532","DOMASO",2,8,1,11,"2015","089"
"14533","DOMEGGE DI CADORE",1,1,0,2,"2015","018"
"14534","DOMODOSSOLA",27,13,4,44,"2015","028"
"14535","DONATO",159,0,34,193,"2015","024"
"14536","DONGO",5,13,2,20,"2015","090"
"14537","DORIO",3,0,0,3,"2015","032"
"14538","DORMELLETTO",3,0,0,3,"2015","062"
"14539","DORNO",4,21,0,25,"2015","061"
"14540","DOSOLO",25,347,170,542,"2015","022"
"14541","DOSSENA",12,70,4,86,"2015","092"
"14542","DOSSO DEL LIRO",2,10,6,18,"2015","092"
"14543","DOVADOLA",115,0,0,115,"2015","011"
"14544","DOVERA",31,1208,0,1239,"2015","041"
"14545","DOZZA",8,29,0,37,"2015","025"
"14546","DRESANO",12,0,0,12,"2015","101"
"14547","DRIZZONA",0,444,0,444,"2015","042"
"14548","DRONERO",2075,263,48,2386,"2015","082"
"14549","DRUENTO",748,42,63,853,"2015","099"
"14550","DRUOGNO",12,11,0,23,"2015","029"
"14551","DUBINO",16,627,13,656,"2015","027"
"14552","DUE CARRARE",134,0,0,134,"2015","106"
"14553","DUEVILLE",423,699,0,1122,"2015","038"
"14554","DUMENZA",1,0,4,5,"2015","065"
"14555","DUSINO SAN MICHELE",381,46,0,427,"2015","052"
"14556","EDOLO",14,61,4,79,"2015","068"
"14557","ELLO",4,0,0,4,"2015","033"
"14558","ELVA",13,0,7,20,"2015","083"
"14559","ENDINE GAIANO",54,91,0,145,"2015","093"
"14560","ENEGO",11,233,0,244,"2015","039"
"14561","ENTRACQUE",100,0,0,100,"2015","084"
"14562","ENTRATICO",67,9,0,76,"2015","094"
"14563","ENVIE",1329,533,65,1927,"2015","085"
"14564","ERACLEA",3996,290,0,4286,"2015","013"
"14565","ERBA",44,356,0,400,"2015","095"
"14566","ERBE'",223,33,0,256,"2015","032"
"14567","ERBEZZO",53,728,0,781,"2015","033"
"14568","ERBUSCO",206,41,0,247,"2015","069"
"14569","ERVE",1,0,0,1,"2015","034"
"14570","ESINE",3,165,7,175,"2015","070"
"14571","ESINO LARIO",26,0,0,26,"2015","035"
"14572","ESTE",877,61,0,938,"2015","037"
"14573","EUPILIO",16,48,10,74,"2015","097"
"14574","EXILLES",1,0,0,1,"2015",NA
"14575","FABBRICA CURONE",9,24,0,33,"2015","067"
"14576","FABBRICO",3,277,0,280,"2015","021"
"14577","FAEDO VALTELLINO",7,16,0,23,"2015","028"
"14578","FAENZA",237,113,0,350,"2015","010"
"14579","FAGGETO LARIO",3,0,4,7,"2015","098"
"14580","FAGNANO OLONA",7,76,2,85,"2015","067"
"14581","FALCADE",11,23,0,34,"2015","019"
"14582","FALOPPIO",7,0,2,9,"2015","099"
"14583","FANANO",79,436,0,515,"2015","011"
"14584","FARA GERA D'ADDA",85,647,0,732,"2015","096"
"14585","FARA NOVARESE",7,0,0,7,"2015","065"
"14586","FARA OLIVANA CON SOLA",248,295,0,543,"2015","097"
"14587","FARA VICENTINO",607,444,147,1198,"2015","040"
"14588","FARIGLIANO",505,0,0,505,"2015","086"
"14589","FARINI",86,121,0,207,"2015","019"
"14590","FARRA D'ALPAGO",5,135,0,140,"2015","020"
"14591","FARRA DI SOLIGO",93,32,0,125,"2015","026"
"14592","FAULE",36,111,30,177,"2015","087"
"14593","FAVRIA",327,600,0,927,"2015","101"
"14594","FEISOGLIO",74,0,0,74,"2015","088"
"14595","FELETTO",31,21,0,52,"2015","102"
"14596","FELINO",19,1170,0,1189,"2015","013"
"14597","FELIZZANO",40,0,0,40,"2015","068"
"14598","FELTRE",192,1217,0,1409,"2015","021"
"14599","FENEGRO'",27,6,23,56,"2015","100"
"14600","FENESTRELLE",27,0,0,27,"2015","103"
"14601","FERNO",1,58,0,59,"2015","068"
"14602","FERRARA",320,212,0,532,"2015","008"
"14603","FERRARA DI MONTE BALDO",16,32,3,51,"2015","034"
"14604","FERRERA DI VARESE",8,0,0,8,"2015","069"
"14605","FERRERA ERBOGNONE",10,0,0,10,"2015","062"
"14606","FERRERE",911,0,0,911,"2015","053"
"14607","FERRIERE",138,3,0,141,"2015","020"
"14608","FIANO",8,0,0,8,"2015","104"
"14609","FICAROLO",14,0,0,14,"2015","021"
"14610","FIDENZA",324,3609,32,3965,"2015","014"
"14611","FIESCO",13,621,0,634,"2015","043"
"14612","FIESSE",708,389,242,1339,"2015","071"
"14613","FIESSO D'ARTICO",10,39,0,49,"2015","014"
"14614","FIESSO UMBERTIANO",114,41,0,155,"2015","022"
"14615","FIGINO SERENZA",23,88,0,111,"2015","101"
"14616","FILAGO",46,0,0,46,"2015","098"
"14617","FILIGHERA",1,142,0,143,"2015","063"
"14618","FINALE EMILIA",24,77,0,101,"2015","012"
"14619","FINO DEL MONTE",4,30,0,34,"2015","099"
"14620","FINO MORNASCO",9,0,0,9,"2015","102"
"14621","FIORANO AL SERIO",12,16,0,28,"2015","100"
"14622","FIORANO CANAVESE",45,0,0,45,"2015","105"
"14623","FIORANO MODENESE",19,55,0,74,"2015","013"
"14624","FIORENZUOLA D'ARDA",26,2102,0,2128,"2015","021"
"14625","FISCAGLIA",1758,72,0,1830,"2015",NA
"14626","FIUMALBO",110,90,0,200,"2015","014"
"14627","FLERO",2,415,0,417,"2015","072"
"14628","FOBELLO",7,0,3,10,"2015","057"
"14629","FOGLIZZO",183,0,0,183,"2015","106"
"14630","FOLLINA",364,92,0,456,"2015","027"
"14631","FOMBIO",220,254,0,474,"2015","026"
"14632","FONTANELICE",191,137,0,328,"2015","026"
"14633","FONTANELLA",3231,2356,0,5587,"2015","101"
"14634","FONTANELLATO",60,2386,0,2446,"2015","015"
"14635","FONTANELLE",79,681,6,766,"2015","028"
"14636","FONTANETO D'AGOGNA",14,58,0,72,"2015","066"
"14637","FONTANETTO PO",4,0,0,4,"2015","058"
"14638","FONTANILE",4,0,0,4,"2015","054"
"14639","FONTANIVA",260,337,0,597,"2015","038"
"14640","FONTE",1187,679,0,1866,"2015","029"
"14641","FONTENO",12,0,0,12,"2015","102"
"14642","FONTEVIVO",0,1333,0,1333,"2015","016"
"14643","FONZASO",52,53,0,105,"2015","022"
"14644","FOPPOLO",2,16,0,18,"2015","103"
"14645","FORCOLA",5,151,0,156,"2015","029"
"14646","FORESTO SPARSO",19,92,1,112,"2015","104"
"14647","FORLI'",496,180,0,676,"2015","012"
"14648","FORLIMPOPOLI",5,22,0,27,"2015","013"
"14649","FORMAZZA",2,30,16,48,"2015","031"
"14650","FORMIGARA",3,990,228,1221,"2015","044"
"14651","FORMIGINE",11,1903,0,1914,"2015","015"
"14652","FORMIGLIANA",27,0,0,27,"2015","059"
"14653","FORMIGNANA",7,0,0,7,"2015","009"
"14654","FORNO CANAVESE",21,0,0,21,"2015","107"
"14655","FORNO DI ZOLDO",15,7,0,22,"2015","024"
"14656","FORNOVO DI TARO",18,409,7,434,"2015","017"
"14657","FORNOVO SAN GIOVANNI",19,633,29,681,"2015","105"
"14658","FORTUNAGO",14,0,0,14,"2015","064"
"14659","FOSSALTA DI PIAVE",7,0,0,7,"2015","015"
"14660","FOSSALTA DI PORTOGRUARO",1,925,0,926,"2015","016"
"14661","FOSSANO",15984,4393,1104,21481,"2015","089"
"14662","FOSSO'",107,25,0,132,"2015","017"
"14663","FOZA",41,36,8,85,"2015","041"
"14664","FRABOSA SOPRANA",230,184,0,414,"2015","090"
"14665","FRABOSA SOTTANA",656,0,37,693,"2015","091"
"14666","FRACONALTO",22,0,0,22,"2015","069"
"14667","FRASCARO",0,16,0,16,"2015","071"
"14668","FRASCAROLO",228,63,0,291,"2015","065"
"14669","FRASSINELLE POLESINE",307,0,0,307,"2015","023"
"14670","FRASSINELLO MONFERRATO",62,0,0,62,"2015","072"
"14671","FRASSINETO PO",35,0,0,35,"2015","073"
"14672","FRASSINETTO",133,13,0,146,"2015","108"
"14673","FRASSINO",42,4,0,46,"2015","092"
"14674","FRASSINORO",112,136,0,248,"2015","016"
"14675","FRATTA POLESINE",20,127,25,172,"2015","024"
"14676","FREGONA",12,24,0,36,"2015","030"
"14677","FRESONARA",17,0,0,17,"2015","074"
"14678","FRINCO",229,0,0,229,"2015","055"
"14679","FRONT",65,0,0,65,"2015","109"
"14680","FROSSASCO",2095,0,73,2168,"2015","110"
"14681","FRUGAROLO",166,155,0,321,"2015","075"
"14682","FUBINE",741,0,0,741,"2015","076"
"14683","FUIPIANO VALLE IMAGNA",13,37,0,50,"2015","106"
"14684","FUMANE",25,35,6,66,"2015","035"
"14685","FUSIGNANO",3,0,0,3,"2015","011"
"14686","FUSINE",9,32,0,41,"2015","030"
"14687","GABBIONETA-BINANUOVA",81,621,0,702,"2015","045"
"14688","GABIANO",25,0,0,25,"2015","077"
"14689","GADESCO-PIEVE DELMONA",68,389,57,514,"2015","046"
"14690","GAGGIANO",78,482,0,560,"2015","103"
"14691","GAGGIO MONTANO",186,374,0,560,"2015","027"
"14692","GAGLIANICO",2,0,0,2,"2015","026"
"14693","GAIARINE",538,0,1,539,"2015","031"
"14694","GAIBA",19,0,0,19,"2015","025"
"14695","GAIOLA",7,1,0,8,"2015","093"
"14696","GALBIATE",45,16,0,61,"2015","036"
"14697","GALEATA",231,0,11,242,"2015","014"
"14698","GALGAGNANO",0,876,0,876,"2015","027"
"14699","GALLARATE",6,31,0,37,"2015","070"
"14700","GALLIATE",30,10,0,40,"2015","068"
"14701","GALLIATE LOMBARDO",9,0,0,9,"2015","071"
"14702","GALLIERA",0,48,0,48,"2015","028"
"14703","GALLIERA VENETA",2933,117,0,3050,"2015","039"
"14704","GALLIO",5,239,0,244,"2015","042"
"14705","GALZIGNANO TERME",11,0,0,11,"2015","040"
"14706","GAMALERO",28,0,0,28,"2015","078"
"14707","GAMBARA",4288,2058,430,6776,"2015","073"
"14708","GAMBASCA",3,0,0,3,"2015","094"
"14709","GAMBOLO'",100,117,0,217,"2015","068"
"14710","GAMBUGLIANO",2,43,0,45,"2015","044"
"14711","GANDELLINO",19,0,0,19,"2015","107"
"14712","GANDINO",63,171,0,234,"2015","108"
"14713","GANDOSSO",6,15,0,21,"2015","109"
"14714","GARBAGNA",94,0,0,94,"2015","079"
"14715","GARBAGNA NOVARESE",2,0,0,2,"2015","069"
"14716","GARBAGNATE MILANESE",3,0,0,3,"2015",NA
"14717","GARBAGNATE MONASTERO",5,0,0,5,"2015","037"
"14718","GARDONE RIVIERA",7,0,0,7,"2015","074"
"14719","GARDONE VAL TROMPIA",28,0,0,28,"2015","075"
"14720","GARESSIO",179,0,0,179,"2015","095"
"14721","GARGALLO",4,0,0,4,"2015","070"
"14722","GARGNANO",31,0,25,56,"2015","076"
"14723","GARLASCO",9,0,5,14,"2015","069"
"14724","GARZENO",15,11,8,34,"2015","106"
"14725","GARZIGLIANA",291,0,0,291,"2015","111"
"14726","GASSINO TORINESE",38,0,0,38,"2015","112"
"14727","GATTATICO",10,2535,0,2545,"2015","022"
"14728","GATTEO",4,0,0,4,"2015","016"
"14729","GATTICO",28,143,157,328,"2015","071"
"14730","GATTINARA",26,0,0,26,"2015","061"
"14731","GAVARDO",90,476,0,566,"2015","077"
"14732","GAVELLO",65,0,0,65,"2015",NA
"14733","GAVERINA TERME",26,45,0,71,"2015","110"
"14734","GAVI",25,0,0,25,"2015","081"
"14735","GAVIRATE",50,0,0,50,"2015","072"
"14736","GAZOLDO DEGLI IPPOLITI",487,90,3,580,"2015","024"
"14737","GAZZADA SCHIANNO",11,10,0,21,"2015","073"
"14738","GAZZANIGA",22,50,0,72,"2015","111"
"14739","GAZZO",77,3018,5,3100,"2015","041"
"14740","GAZZO VERONESE",1041,273,0,1314,"2015","037"
"14741","GAZZOLA",111,1412,0,1523,"2015","022"
"14742","GAZZUOLO",577,41,10,628,"2015","025"
"14743","GEMMANO",20,35,0,55,"2015","004"
"14744","GEMONIO",3,0,3,6,"2015","074"
"14745","GENIVOLTA",79,1887,0,1966,"2015","047"
"14746","GENOLA",1887,1711,130,3728,"2015","096"
"14747","GENZONE",205,75,0,280,"2015","070"
"14748","GERA LARIO",42,221,0,263,"2015","107"
"14749","GERENZAGO",4,0,0,4,"2015","071"
"14750","GERENZANO",107,95,0,202,"2015","075"
"14751","GERMAGNANO",21,4,0,25,"2015","113"
"14752","GERMIGNAGA",7,63,0,70,"2015","076"
"14753","GEROLA ALTA",1,0,0,1,"2015","031"
"14754","GERRE DE' CAPRIOLI",0,427,0,427,"2015","048"
"14755","GESSATE",3,421,0,424,"2015","106"
"14756","GHEDI",3489,6612,37,10138,"2015","078"
"14757","GHEMME",16,0,14,30,"2015","073"
"14758","GHIFFA",1,0,0,1,"2015","033"
"14759","GHISALBA",8,704,0,712,"2015","113"
"14760","GHISLARENGO",13,0,0,13,"2015","062"
"14761","GIACCIANO CON BARUCHELLA",1,0,2,3,"2015","027"
"14762","GIAGLIONE",15,0,0,15,"2015","114"
"14763","GIANICO",109,178,126,413,"2015","079"
"14764","GIAVENO",177,417,156,750,"2015","115"
"14765","GIAVERA DEL MONTELLO",730,147,0,877,"2015","032"
"14766","GIFFLENGA",1,0,0,1,"2015","027"
"14767","GIGNESE",1,0,0,1,"2015","034"
"14768","GIUSSAGO",47,179,7,233,"2015","072"
"14769","GIUSSANO",4,0,0,4,"2015",NA
"14770","GIVOLETTO",35,0,0,35,"2015","116"
"14771","GODEGA DI SANT'URBANO",41,111,0,152,"2015","033"
"14772","GODIASCO",7,0,0,7,"2015","073"
"14773","GOITO",3039,4772,1392,9203,"2015","026"
"14774","GOLASECCA",15,39,0,54,"2015","077"
"14775","GOLFERENZO",0,0,6,6,"2015","074"
"14776","GOMBITO",7,800,0,807,"2015","049"
"14777","GONZAGA",16233,2506,4226,22965,"2015","027"
"14778","GORDONA",87,128,17,232,"2015","032"
"14779","GORGO AL MONTICANO",71,313,29,413,"2015","034"
"14780","GORGONZOLA",16,353,0,369,"2015","108"
"14781","GORLA MAGGIORE",8,0,172,180,"2015","078"
"14782","GORLA MINORE",94,0,0,94,"2015","079"
"14783","GORLAGO",45,252,1,298,"2015","114"
"14784","GORLE",5,0,0,5,"2015","115"
"14785","GORNATE-OLONA",17,0,1,18,"2015","080"
"14786","GORNO",29,78,0,107,"2015","116"
"14787","GORZEGNO",40,0,0,40,"2015","097"
"14788","GOSSOLENGO",1,660,0,661,"2015","023"
"14789","GOTTASECCA",40,0,0,40,"2015","098"
"14790","GOTTOLENGO",13078,1392,76,14546,"2015","080"
"14791","GOVONE",309,0,0,309,"2015","099"
"14792","GOZZANO",5,0,0,5,"2015","076"
"14793","GRAFFIGNANA",41,191,102,334,"2015","028"
"14794","GRAGLIA",105,5,91,201,"2015","028"
"14795","GRAGNANO TREBBIENSE",14,2326,0,2340,"2015","024"
"14796","GRANA",43,0,0,43,"2015","056"
"14797","GRANAGLIONE",21,0,0,21,"2015","029"
"14798","GRANAROLO DELL'EMILIA",25,281,100,406,"2015","030"
"14799","GRANCONA",46,144,0,190,"2015","045"
"14800","GRANDOLA ED UNITI",2,19,24,45,"2015","111"
"14801","GRANOZZO CON MONTICELLO",5,45,0,50,"2015","077"
"14802","GRANTOLA",45,0,0,45,"2015","081"
"14803","GRANTORTO",82,1044,0,1126,"2015","042"
"14804","GRANZE",908,0,0,908,"2015","043"
"14805","GRASSOBBIO",21,152,0,173,"2015","117"
"14806","GRAVEDONA ED UNITI",7,20,71,98,"2015","249"
"14807","GRAVELLONA LOMELLINA",14,22,0,36,"2015","075"
"14808","GRAVELLONA TOCE",17,0,0,17,"2015","035"
"14809","GRAVERE",4,0,0,4,"2015","117"
"14810","GRAZZANO BADOGLIO",500,0,0,500,"2015","057"
"14811","GREGGIO",1,0,0,1,"2015",NA
"14812","GREMIASCO",25,0,0,25,"2015","083"
"14813","GREZZAGO",6,0,0,6,"2015","110"
"14814","GREZZANA",153,609,0,762,"2015","038"
"14815","GRIANTE",6,0,6,12,"2015","113"
"14816","GRIGNASCO",7,48,0,55,"2015","079"
"14817","GRINZANE CAVOUR",37,0,0,37,"2015","100"
"14818","GRISIGNANO DI ZOCCO",44,434,12,490,"2015","046"
"14819","GRIZZANA MORANDI",61,0,0,61,"2015","031"
"14820","GROMO",41,84,1,126,"2015","118"
"14821","GRONDONA",8,0,0,8,"2015","085"
"14822","GRONE",30,27,0,57,"2015","119"
"14823","GRONTARDO",0,1833,101,1934,"2015","050"
"14824","GROPELLO CAIROLI",62,0,0,62,"2015","076"
"14825","GROPPARELLO",101,24,0,125,"2015","025"
"14826","GROSCAVALLO",19,0,32,51,"2015","118"
"14827","GROSIO",30,161,9,200,"2015","033"
"14828","GROSOTTO",10,55,0,65,"2015","034"
"14829","GROSSO",63,0,0,63,"2015","119"
"14830","GRUARO",10,204,0,214,"2015","018"
"14831","GRUGLIASCO",105,23,23,151,"2015","120"
"14832","GRUMELLO CREMONESE ED UNITI",14,1319,253,1586,"2015","051"
"14833","GRUMELLO DEL MONTE",105,131,1,237,"2015","120"
"14834","GRUMOLO DELLE ABBADESSE",43,271,0,314,"2015","047"
"14835","GUALTIERI",1279,494,0,1773,"2015","023"
"14836","GUANZATE",19,0,0,19,"2015","114"
"14837","GUARDA VENETA",645,0,0,645,"2015","028"
"14838","GUARDABOSONE",42,9,0,51,"2015","066"
"14839","GUARDAMIGLIO",0,65,312,377,"2015","029"
"14840","GUARENE",288,0,0,288,"2015","101"
"14841","GUASTALLA",49,1074,0,1123,"2015","024"
"14842","GUDO VISCONTI",15,0,0,15,"2015","112"
"14843","GUIDIZZOLO",1492,914,198,2604,"2015","028"
"14844","GUIGLIA",74,527,0,601,"2015","017"
"14845","GUSSAGO",141,863,0,1004,"2015","081"
"14846","GUSSOLA",4,53,1,58,"2015","052"
"14847","IDRO",3,0,0,3,"2015","082"
"14848","IESOLO",14,35,5,54,"2015","019"
"14849","IGLIANO",57,0,21,78,"2015","102"
"14850","ILLASI",1,66,0,67,"2015","039"
"14851","IMBERSAGO",3,0,0,3,"2015","039"
"14852","IMOLA",65,29,0,94,"2015","032"
"14853","INARZO",8,0,0,8,"2015","082"
"14854","INCISA SCAPACCINO",36,0,0,36,"2015","058"
"14855","INCUDINE",4,0,0,4,"2015","083"
"14856","INDUNO OLONA",18,65,0,83,"2015","083"
"14857","INTRAGNA",3,0,0,3,"2015","037"
"14858","INTROBIO",68,23,0,91,"2015","040"
"14859","INVERIGO",117,0,0,117,"2015","118"
"14860","INVERNO E MONTELEONE",80,160,0,240,"2015","077"
"14861","INVERSO PINASCA",39,0,0,39,"2015","122"
"14862","INVERUNO",3,116,0,119,"2015","113"
"14863","INVORIO",34,145,0,179,"2015","082"
"14864","INZAGO",154,761,0,915,"2015","114"
"14865","IRMA",4,0,0,4,"2015","084"
"14866","ISASCA",60,0,0,60,"2015","103"
"14867","ISEO",26,30,0,56,"2015","085"
"14868","ISOLA D'ASTI",341,0,0,341,"2015","059"
"14869","ISOLA DELLA SCALA",4893,356,0,5249,"2015","040"
"14870","ISOLA DI FONDRA",2,37,0,39,"2015","121"
"14871","ISOLA DOVARESE",0,650,0,650,"2015","053"
"14872","ISOLA RIZZA",1877,408,0,2285,"2015","041"
"14873","ISOLA VICENTINA",1792,752,19,2563,"2015","048"
"14874","ISOLABELLA",54,0,457,511,"2015","123"
"14875","ISORELLA",11531,684,86,12301,"2015","086"
"14876","ISPRA",49,132,0,181,"2015","084"
"14877","ISSIGLIO",75,21,0,96,"2015","124"
"14878","ISSO",7,1269,0,1276,"2015","122"
"14879","ISTRANA",2951,371,98,3420,"2015","035"
"14880","IVREA",165,202,0,367,"2015","125"
"14881","IZANO",15,992,0,1007,"2015","054"
"14882","JERAGO CON ORAGO",3,0,0,3,"2015","085"
"14883","JOLANDA DI SAVOIA",55,0,0,55,"2015","010"
"14884","LA CASSA",1,0,351,352,"2015","126"
"14885","LA LOGGIA",219,0,68,287,"2015","127"
"14886","LA MORRA",121,0,0,121,"2015","105"
"14887","LA VALLE AGORDINA",10,38,0,48,"2015","027"
"14888","LA VALLETTA BRIANZA",20,0,11,31,"2015",NA
"14889","LACCHIARELLA",52,12,0,64,"2015","115"
"14890","LAGLIO",0,0,1,1,"2015",NA
"14891","LAGNASCO",29,36,0,65,"2015","104"
"14892","LAGOSANTO",24,0,0,24,"2015","011"
"14893","LAINATE",11,0,6,17,"2015","116"
"14894","LAINO",2,2,0,4,"2015","120"
"14895","LALLIO",1,0,0,1,"2015",NA
"14896","LAMA MOCOGNO",99,430,0,529,"2015","018"
"14897","LAMBRUGO",0,102,0,102,"2015","121"
"14898","LAMON",23,28,0,51,"2015","026"
"14899","LAMPORO",28,0,0,28,"2015","067"
"14900","LANDRIANO",13,252,0,265,"2015","078"
"14901","LANGHIRANO",5,993,0,998,"2015","018"
"14902","LANGOSCO",8,0,0,8,"2015","079"
"14903","LANZADA",21,65,0,86,"2015","036"
"14904","LANZO D'INTELVI",12,0,4,16,"2015","122"
"14905","LANZO TORINESE",169,0,19,188,"2015","128"
"14906","LASNIGO",7,23,0,30,"2015","123"
"14907","LAURIANO",16,0,0,16,"2015","129"
"14908","LAVENA PONTE TRESA",4,0,0,4,"2015","086"
"14909","LAVENO-MOMBELLO",12,0,0,12,"2015","087"
"14910","LAVENONE",23,1,0,24,"2015","087"
"14911","LAZISE",11,149,0,160,"2015","043"
"14912","LAZZATE",21,0,0,21,"2015",NA
"14913","LECCO",14,41,3,58,"2015","042"
"14914","LEFFE",14,102,0,116,"2015","124"
"14915","LEGGIUNO",4,0,0,4,"2015","088"
"14916","LEGNAGO",91,39,0,130,"2015","044"
"14917","LEGNANO",0,57,0,57,"2015","118"
"14918","LEGNARO",100,48,65,213,"2015","044"
"14919","LEINI'",577,729,79,1385,"2015","130"
"14920","LEMIE",17,41,33,91,"2015","131"
"14921","LENDINARA",561,193,0,754,"2015","029"
"14922","LENNA",3,7,0,10,"2015","125"
"14923","LENO",6248,6995,949,14192,"2015","088"
"14924","LENTA",2,18,0,20,"2015","068"
"14925","LENTATE SUL SEVESO",8,165,2,175,"2015",NA
"14926","LENTIAI",111,132,0,243,"2015","028"
"14927","LEQUIO BERRIA",29,0,0,29,"2015","106"
"14928","LEQUIO TANARO",1803,0,0,1803,"2015","107"
"14929","LERMA",16,0,0,16,"2015","088"
"14930","LESA",5,0,0,5,"2015","084"
"14931","LESEGNO",622,0,0,622,"2015","108"
"14932","LESIGNANO DE' BAGNI",40,1140,0,1180,"2015","019"
"14933","LESMO",1,199,0,200,"2015",NA
"14934","LESSOLO",115,6,0,121,"2015","132"
"14935","LESSONA",4,16,0,20,"2015","029"
"14936","LEVATE",0,10,0,10,"2015","126"
"14937","LEVICE",91,0,0,91,"2015","109"
"14938","LEZZENO",0,0,2,2,"2015","126"
"14939","LIERNA",4,5,0,9,"2015","043"
"14940","LIGNANA",1,0,0,1,"2015","070"
"14941","LIGONCHIO",47,97,0,144,"2015","025"
"14942","LIMANA",40,162,0,202,"2015","029"
"14943","LIMBIATE",0,0,18,18,"2015",NA
"14944","LIMENA",765,698,93,1556,"2015","045"
"14945","LIMIDO COMASCO",2,31,0,33,"2015","128"
"14946","LIMONE PIEMONTE",88,0,0,88,"2015","110"
"14947","LINAROLO",4,412,0,416,"2015","081"
"14948","LIPOMO",1,0,0,1,"2015",NA
"14949","LIRIO",25,0,0,25,"2015","082"
"14950","LISCATE",9,0,0,9,"2015","122"
"14951","LISIO",73,0,0,73,"2015","111"
"14952","LISSONE",230,0,0,230,"2015",NA
"14953","LIVIGNO",66,274,10,350,"2015","037"
"14954","LIVINALLONGO DEL COL DI LANA",5,70,0,75,"2015","030"
"14955","LIVO",4,4,0,8,"2015","130"
"14956","LIVORNO FERRARIS",4,53,0,57,"2015","071"
"14957","LIVRAGA",28,1174,5,1207,"2015","030"
"14958","LIZZANO IN BELVEDERE",39,63,30,132,"2015","033"
"14959","LOAZZOLO",15,0,2,17,"2015","060"
"14960","LOCANA",160,152,0,312,"2015","134"
"14961","LOCATE DI TRIULZI",0,1115,0,1115,"2015","125"
"14962","LOCATE VARESINO",15,0,0,15,"2015","131"
"14963","LOCATELLO",38,25,0,63,"2015","127"
"14964","LODI",565,1177,48,1790,"2015","031"
"14965","LODI VECCHIO",3,990,0,993,"2015","032"
"14966","LODRINO",17,10,0,27,"2015","090"
"14967","LOGRATO",1245,586,0,1831,"2015","091"
"14968","LOIANO",14,302,0,316,"2015","034"
"14969","LOMAZZO",1,0,0,1,"2015","133"
"14970","LOMBARDORE",26,0,0,26,"2015","135"
"14971","LOMBRIASCO",83,126,0,209,"2015","136"
"14972","LOMELLO",5,131,0,136,"2015","083"
"14973","LONATE CEPPINO",2,256,0,258,"2015","089"
"14974","LONATE POZZOLO",35,0,8,43,"2015","090"
"14975","LONATO",2529,4551,358,7438,"2015","092"
"14976","LONGARE",70,246,0,316,"2015","051"
"14977","LONGARONE",2,0,0,2,"2015","031"
"14978","LONGHENA",0,344,0,344,"2015","093"
"14979","LONGIANO",19,0,0,19,"2015","018"
"14980","LONIGO",5472,482,0,5954,"2015","052"
"14981","LORANZE'",13,0,0,13,"2015","137"
"14982","LOREGGIA",331,515,4,850,"2015","046"
"14983","LOREGLIA",10,0,0,10,"2015","038"
"14984","LORENZAGO DI CADORE",4,0,0,4,"2015","032"
"14985","LOREO",961,81,0,1042,"2015","030"
"14986","LORIA",6719,28,2,6749,"2015","036"
"14987","LOSINE",0,41,0,41,"2015","094"
"14988","LOVERE",22,20,0,42,"2015","128"
"14989","LOVERO",9,9,0,18,"2015","038"
"14990","LOZIO",0,1,0,1,"2015","095"
"14991","LOZZA",0,128,0,128,"2015","091"
"14992","LOZZO ATESTINO",1577,4,1,1582,"2015","047"
"14993","LOZZO DI CADORE",2,0,0,2,"2015","033"
"14994","LOZZOLO",12,0,0,12,"2015","072"
"14995","LU",81,0,0,81,"2015","089"
"14996","LUGAGNANO VAL D'ARDA",49,207,0,256,"2015","026"
"14997","LUGNACCO",3,0,0,3,"2015","138"
"14998","LUGO",483,122,0,605,"2015","012"
"14999","LUGO DI VICENZA",17,146,0,163,"2015","053"
"15000","LUINO",15,30,0,45,"2015","092"
"15001","LUISAGO",6,0,0,6,"2015","135"
"15002","LUMEZZANE",24,0,0,24,"2015","096"
"15003","LURAGO D'ERBA",8,0,2,10,"2015","136"
"15004","LURAGO MARINONE",0,122,0,122,"2015","137"
"15005","LURANO",28,0,0,28,"2015","129"
"15006","LURATE CACCIVIO",20,0,81,101,"2015","138"
"15007","LUSERNA SAN GIOVANNI",375,76,85,536,"2015","139"
"15008","LUSERNETTA",80,0,0,80,"2015","140"
"15009","LUSIA",18,0,0,18,"2015","031"
"15010","LUSIANA",24,106,0,130,"2015","054"
"15011","LUSIGLIE'",64,0,0,64,"2015","141"
"15012","LUZZANA",15,0,0,15,"2015","130"
"15013","LUZZARA",1496,1472,4,2972,"2015","026"
"15014","MACCAGNO CON PINO E VEDDASCA",2,7,12,21,"2015",NA
"15015","MACCASTORNA",583,61,0,644,"2015","033"
"15016","MACELLO",1212,238,415,1865,"2015","142"
"15017","MACHERIO",1,0,0,1,"2015",NA
"15018","MACLODIO",15,408,0,423,"2015","097"
"15019","MACRA",2,0,0,2,"2015",NA
"15020","MACUGNAGA",3,9,0,12,"2015","039"
"15021","MADESIMO",5,1,0,6,"2015","035"
"15022","MADIGNANO",68,588,0,656,"2015","055"
"15023","MADONE",15,0,0,15,"2015","131"
"15024","MADONNA DEL SASSO",13,0,0,13,"2015","040"
"15025","MAGASA",12,13,0,25,"2015","098"
"15026","MAGENTA",46,671,0,717,"2015","130"
"15027","MAGGIORA",99,46,0,145,"2015","088"
"15028","MAGHERNO",4,86,0,90,"2015","085"
"15029","MAGLIANO ALFIERI",482,0,0,482,"2015","113"
"15030","MAGLIANO ALPI",629,111,0,740,"2015","114"
"15031","MAGNACAVALLO",49,309,416,774,"2015","029"
"15032","MAGNAGO",56,0,0,56,"2015","131"
"15033","MAGNANO",19,9,0,28,"2015","030"
"15034","MAIOLO",98,0,0,98,"2015","022"
"15035","MAIRAGO",3,526,0,529,"2015","034"
"15036","MAIRANO",333,552,14,899,"2015","099"
"15037","MALAGNINO",154,518,0,672,"2015","056"
"15038","MALCESINE",24,94,0,118,"2015","045"
"15039","MALEGNO",10,42,5,57,"2015","100"
"15040","MALEO",133,1256,0,1389,"2015","035"
"15041","MALESCO",18,0,4,22,"2015","041"
"15042","MALGESSO",56,0,0,56,"2015","095"
"15043","MALNATE",47,47,0,94,"2015","096"
"15044","MALO",1828,365,0,2193,"2015","055"
"15045","MALONNO",13,229,9,251,"2015","101"
"15046","MALVICINO",12,0,0,12,"2015","090"
"15047","MANDELLO DEL LARIO",12,0,0,12,"2015","046"
"15048","MANDELLO VITTA",1,0,0,1,"2015","090"
"15049","MANERBA DEL GARDA",20,0,10,30,"2015","102"
"15050","MANERBIO",887,1428,0,2315,"2015","103"
"15051","MANGO",33,0,0,33,"2015","115"
"15052","MANSUE'",79,359,7,445,"2015","037"
"15053","MANTA",2,0,0,2,"2015","116"
"15054","MANTELLO",5,106,0,111,"2015","039"
"15055","MANTOVA",670,933,131,1734,"2015","030"
"15056","MAPELLO",69,21,0,90,"2015","132"
"15057","MARANELLO",23,566,0,589,"2015","019"
"15058","MARANO DI VALPOLICELLA",40,74,15,129,"2015","046"
"15059","MARANO SUL PANARO",73,712,0,785,"2015","020"
"15060","MARANO TICINO",5,245,0,250,"2015","091"
"15061","MARANO VICENTINO",192,284,48,524,"2015","056"
"15062","MARCALLO CON CASONE",2,249,0,251,"2015","134"
"15063","MARCARIA",1908,3211,836,5955,"2015","031"
"15064","MARCHENO",21,14,0,35,"2015","104"
"15065","MARCHIROLO",1,0,0,1,"2015","097"
"15066","MARCIGNAGO",50,0,0,50,"2015","086"
"15067","MARCON",301,14,66,381,"2015","020"
"15068","MARENE",3426,2124,150,5700,"2015","117"
"15069","MARENO DI PIAVE",1072,218,0,1290,"2015","038"
"15070","MARENTINO",132,0,0,132,"2015","144"
"15071","MARETTO",166,0,0,166,"2015","062"
"15072","MARGARITA",743,0,0,743,"2015","118"
"15073","MARGNO",1,7,0,8,"2015","047"
"15074","MARIANA MANTOVANA",51,326,35,412,"2015","032"
"15075","MARIANO COMENSE",712,80,0,792,"2015","143"
"15076","MARMENTINO",14,14,9,37,"2015","105"
"15077","MARMIROLO",3715,2086,3286,9087,"2015","033"
"15078","MARMORA",44,53,7,104,"2015","119"
"15079","MARONE",47,17,23,87,"2015","106"
"15080","MAROSTICA",213,705,0,918,"2015","057"
"15081","MARSAGLIA",157,0,0,157,"2015","120"
"15082","MARTELLAGO",34,5,0,39,"2015","021"
"15083","MARTINENGO",328,2534,0,2862,"2015","133"
"15084","MARTINIANA PO",106,100,0,206,"2015","121"
"15085","MARUDO",0,315,0,315,"2015","036"
"15086","MARZABOTTO",21,69,0,90,"2015","036"
"15087","MARZANO",67,242,22,331,"2015","087"
"15088","MARZIO",4,0,5,9,"2015","099"
"15089","MASATE",0,0,156,156,"2015","136"
"15090","MASCIAGO PRIMO",42,0,0,42,"2015","100"
"15091","MASER",4445,56,0,4501,"2015","039"
"15092","MASERA",16,51,3,70,"2015","042"
"15093","MASERA' DI PADOVA",288,103,99,490,"2015","048"
"15094","MASERADA SUL PIAVE",2592,123,0,2715,"2015","040"
"15095","MASI",53,0,0,53,"2015","049"
"15096","MASI TORELLO",2,66,0,68,"2015","012"
"15097","MASIO",157,0,0,157,"2015","091"
"15098","MASON VICENTINO",82,418,0,500,"2015","058"
"15099","MASSA LOMBARDA",8,0,0,8,"2015","013"
"15100","MASSALENGO",0,157,0,157,"2015","037"
"15101","MASSANZAGO",569,165,0,734,"2015","050"
"15102","MASSAZZA",24,9,0,33,"2015","031"
"15103","MASSELLO",8,0,3,11,"2015","145"
"15104","MASSERANO",57,0,0,57,"2015","032"
"15105","MASSINO VISCONTI",13,2,4,19,"2015","093"
"15106","MASSIOLA",2,0,0,2,"2015","043"
"15107","MATHI",68,0,0,68,"2015","146"
"15108","MATTIE",16,0,0,16,"2015","147"
"15109","MAZZANO",78,770,5,853,"2015","107"
"15110","MAZZE'",949,0,0,949,"2015","148"
"15111","MAZZO DI VALTELLINA",12,24,2,38,"2015","040"
"15112","MEANA DI SUSA",3,0,0,3,"2015","149"
"15113","MEDE",12,62,0,74,"2015","088"
"15114","MEDESANO",105,1396,0,1501,"2015","020"
"15115","MEDICINA",163,108,0,271,"2015","037"
"15116","MEDIGLIA",4,1277,71,1352,"2015","139"
"15117","MEDOLAGO",11,0,0,11,"2015","250"
"15118","MEDOLE",857,381,548,1786,"2015","034"
"15119","MEDOLLA",0,572,0,572,"2015","021"
"15120","MEDUNA DI LIVENZA",13,20,0,33,"2015","041"
"15121","MEGLIADINO SAN FIDENZIO",889,0,0,889,"2015","051"
"15122","MEGLIADINO SAN VITALE",1306,0,0,1306,"2015","052"
"15123","MEINA",1,0,0,1,"2015","095"
"15124","MEL",58,315,0,373,"2015","034"
"15125","MELARA",264,0,0,264,"2015","032"
"15126","MELAZZO",236,0,0,236,"2015","092"
"15127","MELDOLA",148,88,0,236,"2015","019"
"15128","MELEGNANO",1,110,0,111,"2015","140"
"15129","MELETI",45,399,0,444,"2015","038"
"15130","MELLE",238,33,0,271,"2015","122"
"15131","MELLO",21,47,0,68,"2015","041"
"15132","MELZO",161,250,0,411,"2015","142"
"15133","MENAGGIO",2,0,1,3,"2015","145"
"15134","MENCONICO",4,0,0,4,"2015","089"
"15135","MEOLO",45,138,0,183,"2015","022"
"15136","MERANA",21,0,0,21,"2015","093"
"15137","MERATE",64,298,28,390,"2015","048"
"15138","MERCATO SARACENO",226,14,1,241,"2015","020"
"15139","MERCENASCO",305,0,0,305,"2015","150"
"15140","MERGOZZO",25,0,0,25,"2015","044"
"15141","MERLARA",544,13,0,557,"2015","053"
"15142","MERLINO",0,928,0,928,"2015","039"
"15143","MERONE",31,73,10,114,"2015","147"
"15144","MESE",30,27,0,57,"2015","043"
"15145","MESENZANA",1,36,0,37,"2015","102"
"15146","MESERO",1,49,0,50,"2015","144"
"15147","MESOLA",1054,281,0,1335,"2015","014"
"15148","MESTRINO",52,88,42,182,"2015","054"
"15149","MEUGLIANO",4,0,0,4,"2015","151"
"15150","MEZZANA BIGLI",125,0,0,125,"2015","090"
"15151","MEZZANE DI SOTTO",1,23,0,24,"2015","047"
"15152","MEZZANI",0,305,6,311,"2015","021"
"15153","MEZZANINO",7,0,0,7,"2015","092"
"15154","MEZZENILE",40,40,0,80,"2015","152"
"15155","MEZZOLDO",1,11,0,12,"2015","134"
"15156","MEZZOMERICO",4,0,0,4,"2015","097"
"15157","MIAGLIANO",1,0,0,1,"2015","034"
"15158","MIANE",11,9,0,20,"2015","042"
"15159","MIASINO",0,0,34,34,"2015","098"
"15160","MIAZZINA",2,0,0,2,"2015","045"
"15161","MILANO",296,52,0,348,"2015","146"
"15162","MILZANO",1,830,0,831,"2015","108"
"15163","MINERBE",1930,240,0,2170,"2015","048"
"15164","MINERBIO",68,0,0,68,"2015","038"
"15165","MIRA",1547,619,33,2199,"2015","023"
"15166","MIRABELLO MONFERRATO",69,0,0,69,"2015","094"
"15167","MIRADOLO TERME",39,42,33,114,"2015","093"
"15168","MIRANDOLA",386,1295,0,1681,"2015","022"
"15169","MIRANO",976,689,5,1670,"2015","024"
"15170","MISANO ADRIATICO",14,0,0,14,"2015","005"
"15171","MISANO DI GERA D'ADDA",23,253,18,294,"2015","135"
"15172","MISSAGLIA",11,232,245,488,"2015","049"
"15173","MODENA",853,2078,0,2931,"2015","023"
"15174","MODIGLIANA",95,1,4,100,"2015","022"
"15175","MOGLIA",3587,766,1361,5714,"2015","035"
"15176","MOGLIANO VENETO",1097,464,128,1689,"2015","043"
"15177","MOIO DE' CALVI",4,11,0,15,"2015","136"
"15178","MOIOLA",0,6,0,6,"2015","123"
"15179","MOLARE",3,0,0,3,"2015","095"
"15180","MOLINELLA",1832,157,0,1989,"2015","039"
"15181","MOLLIA",5,0,0,5,"2015","078"
"15182","MOLTENO",18,55,0,73,"2015","051"
"15183","MOLVENA",12,5,0,17,"2015","059"
"15184","MOMBALDONE",51,0,4,55,"2015","064"
"15185","MOMBARCARO",107,0,0,107,"2015","124"
"15186","MOMBARUZZO",5,0,0,5,"2015","065"
"15187","MOMBASIGLIO",119,0,0,119,"2015","125"
"15188","MOMBELLO DI TORINO",37,0,0,37,"2015","153"
"15189","MOMBELLO MONFERRATO",24,0,0,24,"2015","097"
"15190","MOMBERCELLI",46,0,0,46,"2015","066"
"15191","MOMO",175,685,0,860,"2015","100"
"15192","MOMPERONE",3,0,0,3,"2015","098"
"15193","MONALE",39,0,0,39,"2015","067"
"15194","MONASTERO BORMIDA",417,0,0,417,"2015","068"
"15195","MONASTERO DI LANZO",13,79,0,92,"2015","155"
"15196","MONASTERO DI VASCO",441,11,32,484,"2015","126"
"15197","MONASTEROLO CASOTTO",47,0,0,47,"2015","127"
"15198","MONASTEROLO DEL CASTELLO",11,16,0,27,"2015","137"
"15199","MONASTEROLO DI SAVIGLIANO",451,337,101,889,"2015","128"
"15200","MONASTIER DI TREVISO",1949,377,0,2326,"2015","044"
"15201","MONCALIERI",335,395,0,730,"2015","156"
"15202","MONCALVO",108,0,0,108,"2015","069"
"15203","MONCENISIO",4,0,0,4,"2015","157"
"15204","MONCESTINO",12,0,0,12,"2015","099"
"15205","MONCHIERO",230,0,0,230,"2015","129"
"15206","MONCHIO DELLE CORTI",31,144,0,175,"2015","022"
"15207","MONCRIVELLO",107,237,0,344,"2015","079"
"15208","MONCUCCO TORINESE",33,0,0,33,"2015","070"
"15209","MONDAINO",5,0,0,5,"2015","006"
"15210","MONDOVI'",5563,314,54,5931,"2015","130"
"15211","MONESIGLIO",108,0,0,108,"2015","131"
"15212","MONFORTE D'ALBA",240,0,0,240,"2015","132"
"15213","MONFUMO",49,220,0,269,"2015","045"
"15214","MONGARDINO",28,0,0,28,"2015","071"
"15215","MONGHIDORO",36,61,38,135,"2015","040"
"15216","MONGIARDINO LIGURE",16,0,20,36,"2015","100"
"15217","MONGRANDO",125,112,5,242,"2015","035"
"15218","MONGUZZO",14,0,0,14,"2015","153"
"15219","MONIGA DEL GARDA",0,5,0,5,"2015","109"
"15220","MONNO",8,42,1,51,"2015","110"
"15221","MONSELICE",494,50,0,544,"2015","055"
"15222","MONTA'",163,0,0,163,"2015","133"
"15223","MONTABONE",85,0,0,85,"2015","072"
"15224","MONTACUTO",23,0,0,23,"2015","102"
"15225","MONTAFIA",56,0,0,56,"2015","073"
"15226","MONTAGNA IN VALTELLINA",8,71,1,80,"2015","044"
"15227","MONTAGNANA",1468,53,0,1521,"2015","056"
"15228","MONTALDO DI MONDOVI'",117,6,0,123,"2015","134"
"15229","MONTALDO ROERO",25,0,0,25,"2015","135"
"15230","MONTALDO SCARAMPI",24,0,0,24,"2015","074"
"15231","MONTALDO TORINESE",546,0,0,546,"2015","158"
"15232","MONTALENGHE",6,0,0,6,"2015","159"
"15233","MONTALTO DORA",29,0,0,29,"2015","160"
"15234","MONTALTO PAVESE",67,0,0,67,"2015","094"
"15235","MONTANARO",164,128,17,309,"2015","161"
"15236","MONTANASO LOMBARDO",73,486,0,559,"2015","040"
"15237","MONTANERA",1644,851,116,2611,"2015","136"
"15238","MONTANO LUCINO",12,26,5,43,"2015","154"
"15239","MONTE COLOMBO",90,0,0,90,"2015","007"
"15240","MONTE CREMASCO",407,127,0,534,"2015","058"
"15241","MONTE DI MALO",957,157,0,1114,"2015","063"
"15242","MONTE ISOLA",17,0,0,17,"2015","111"
"15243","MONTE MARENZO",10,0,0,10,"2015","052"
"15244","MONTE SAN PIETRO",89,210,0,299,"2015","042"
"15245","MONTEBELLO DELLA BATTAGLIA",3,29,0,32,"2015","095"
"15246","MONTEBELLO VICENTINO",80,0,207,287,"2015","060"
"15247","MONTEBELLUNA",4121,634,35,4790,"2015","046"
"15248","MONTECALVO VERSIGGIA",5,0,0,5,"2015",NA
"15249","MONTECASTELLO",8,0,0,8,"2015","105"
"15250","MONTECCHIA DI CROSARA",838,0,0,838,"2015","049"
"15251","MONTECCHIO EMILIA",7,1363,0,1370,"2015","027"
"15252","MONTECCHIO MAGGIORE",264,38,0,302,"2015","061"
"15253","MONTECCHIO PRECALCINO",240,123,53,416,"2015","062"
"15254","MONTECHIARO D'ACQUI",42,0,0,42,"2015","106"
"15255","MONTECHIARO D'ASTI",196,0,0,196,"2015","075"
"15256","MONTECHIARUGOLO",8,3433,0,3441,"2015","023"
"15257","MONTECRESTESE",23,37,0,60,"2015","046"
"15258","MONTECRETO",7,493,0,500,"2015","024"
"15259","MONTEFIORE CONCA",23,7,0,30,"2015","008"
"15260","MONTEFIORINO",20,307,0,327,"2015","025"
"15261","MONTEFORTE D'ALPONE",826,42,0,868,"2015","050"
"15262","MONTEGALDA",180,237,0,417,"2015","064"
"15263","MONTEGALDELLA",160,238,0,398,"2015","065"
"15264","MONTEGIOCO",26,0,0,26,"2015","107"
"15265","MONTEGRIDOLFO",2,0,0,2,"2015","009"
"15266","MONTEGRINO VALTRAVAGLIA",10,0,0,10,"2015","103"
"15267","MONTEGROSSO D'ASTI",19,0,0,19,"2015","076"
"15268","MONTEGROTTO TERME",20,0,40,60,"2015","057"
"15269","MONTELLO",2,0,0,2,"2015","139"
"15270","MONTELUPO ALBESE",80,0,0,80,"2015","137"
"15271","MONTEMAGNO",93,0,0,93,"2015","077"
"15272","MONTEMALE DI CUNEO",145,0,0,145,"2015","138"
"15273","MONTEMARZINO",1,0,0,1,"2015","108"
"15274","MONTEMEZZO",1,0,0,1,"2015","155"
"15275","MONTERENZIO",359,182,0,541,"2015","041"
"15276","MONTEROSSO GRANA",5,118,0,123,"2015","139"
"15277","MONTESCANO",1,0,0,1,"2015","097"
"15278","MONTESCHENO",2,0,0,2,"2015","047"
"15279","MONTESCUDO",150,0,0,150,"2015","010"
"15280","MONTESE",82,1306,0,1388,"2015","026"
"15281","MONTESEGALE",11,0,0,11,"2015","098"
"15282","MONTEU DA PO",79,0,0,79,"2015","162"
"15283","MONTEU ROERO",620,0,0,620,"2015","140"
"15284","MONTEVECCHIA",13,0,2,15,"2015","053"
"15285","MONTEVIALE",65,16,0,81,"2015","066"
"15286","MONTEZEMOLO",189,0,0,189,"2015","141"
"15287","MONTICELLI BRUSATI",9,234,2,245,"2015","112"
"15288","MONTICELLI D'ONGINA",359,591,0,950,"2015","027"
"15289","MONTICELLI PAVESE",1416,361,0,1777,"2015","099"
"15290","MONTICELLO BRIANZA",15,0,259,274,"2015","054"
"15291","MONTICELLO CONTE OTTO",78,810,0,888,"2015","067"
"15292","MONTICELLO D'ALBA",81,0,0,81,"2015","142"
"15293","MONTICHIARI",9258,7164,436,16858,"2015","113"
"15294","MONTIGLIO MONFERRATO",254,0,0,254,"2015","121"
"15295","MONTIRONE",3732,459,0,4191,"2015","114"
"15296","MONTODINE",2,1128,0,1130,"2015","059"
"15297","MONTORFANO",14,0,0,14,"2015","157"
"15298","MONTORSO VICENTINO",487,147,4,638,"2015","068"
"15299","MONTU' BECCARIA",2,0,0,2,"2015","100"
"15300","MONVALLE",14,28,0,42,"2015","104"
"15301","MONZA",1,65,33,99,"2015",NA
"15302","MONZAMBANO",1208,660,673,2541,"2015","036"
"15303","MONZUNO",85,75,0,160,"2015","044"
"15304","MORANSENGO",141,0,0,141,"2015","079"
"15305","MORAZZONE",8,106,0,114,"2015","105"
"15306","MORBEGNO",11,119,3,133,"2015","045"
"15307","MORBELLO",2,0,0,2,"2015","110"
"15308","MORDANO",1,0,0,1,"2015","045"
"15309","MORENGO",48,64,0,112,"2015","140"
"15310","MORETTA",1531,607,209,2347,"2015","143"
"15311","MORFASSO",112,10,0,122,"2015","028"
"15312","MORGANO",1300,8,0,1308,"2015","047"
"15313","MORIAGO DELLA BATTAGLIA",2248,61,0,2309,"2015","048"
"15314","MORIMONDO",49,1485,0,1534,"2015","150"
"15315","MORIONDO TORINESE",266,0,0,266,"2015","163"
"15316","MORNAGO",13,0,0,13,"2015","106"
"15317","MORNESE",30,0,0,30,"2015","111"
"15318","MORNICO AL SERIO",438,426,95,959,"2015","141"
"15319","MORNICO LOSANA",22,0,0,22,"2015","101"
"15320","MOROZZO",2194,630,407,3231,"2015","144"
"15321","MORSASCO",143,0,0,143,"2015","112"
"15322","MORTARA",45,0,0,45,"2015","102"
"15323","MORTERONE",17,0,0,17,"2015","055"
"15324","MOSCAZZANO",13,1170,214,1397,"2015","060"
"15325","MOSSANO",560,50,0,610,"2015","069"
"15326","MOSSO",45,18,12,75,"2015","084"
"15327","MOTTA BALUFFI",6,93,0,99,"2015","061"
"15328","MOTTA DI LIVENZA",37,35,1,73,"2015","049"
"15329","MOTTA VISCONTI",7,0,0,7,"2015","151"
"15330","MOTTALCIATA",59,94,0,153,"2015","037"
"15331","MOTTEGGIANA",615,1101,672,2388,"2015","037"
"15332","MOZZANICA",203,710,0,913,"2015","142"
"15333","MOZZATE",18,101,0,119,"2015","159"
"15334","MOZZECANE",3311,825,0,4136,"2015","051"
"15335","MUGGIÒ",12,0,0,12,"2015",NA
"15336","MULAZZANO",9,1148,0,1157,"2015","041"
"15337","MURA",38,23,7,68,"2015","115"
"15338","MURAZZANO",332,0,20,352,"2015","145"
"15339","MURELLO",467,1243,192,1902,"2015","146"
"15340","MURISENGO",336,0,0,336,"2015","113"
"15341","MUSCOLINE",72,485,6,563,"2015","116"
"15342","MUSILE DI PIAVE",25,49,0,74,"2015","025"
"15343","MUSSO",4,5,3,12,"2015","160"
"15344","MUSSOLENTE",135,227,120,482,"2015","070"
"15345","MUZZANO",24,0,0,24,"2015","038"
"15346","NANTO",312,153,0,465,"2015","071"
"15347","NARZOLE",798,168,0,966,"2015","147"
"15348","NAVE",44,134,0,178,"2015","117"
"15349","NEBBIUNO",45,11,20,76,"2015","103"
"15350","NEGRAR",6,126,0,132,"2015","052"
"15351","NEIVE",29,0,0,29,"2015","148"
"15352","NEMBRO",35,0,0,35,"2015","144"
"15353","NERVESA DELLA BATTAGLIA",364,257,0,621,"2015","050"
"15354","NERVIANO",31,145,0,176,"2015","154"
"15355","NESSO",0,9,0,9,"2015","161"
"15356","NETRO",106,46,0,152,"2015","039"
"15357","NEVIANO DEGLI ARDUINI",29,1817,0,1846,"2015","024"
"15358","NIARDO",1,145,9,155,"2015","118"
"15359","NIBBIANO",229,0,0,229,"2015","029"
"15360","NIBIONNO",13,0,0,13,"2015","056"
"15361","NICHELINO",61,0,0,61,"2015","164"
"15362","NICORVO",2,0,0,2,"2015","103"
"15363","NIELLA BELBO",37,108,0,145,"2015","150"
"15364","NIELLA TANARO",520,0,0,520,"2015","151"
"15365","NIZZA MONFERRATO",102,1,0,103,"2015","080"
"15366","NOALE",398,66,12,476,"2015","026"
"15367","NOASCA",13,35,40,88,"2015","165"
"15368","NOCETO",55,3058,12,3125,"2015","025"
"15369","NOGARA",2388,447,0,2835,"2015","053"
"15370","NOGAROLE ROCCA",334,316,0,650,"2015","054"
"15371","NOGAROLE VICENTINO",14,30,0,44,"2015","072"
"15372","NOLE",226,135,0,361,"2015","166"
"15373","NONANTOLA",8,249,0,257,"2015","027"
"15374","NONE",785,812,418,2015,"2015","168"
"15375","NONIO",1,0,0,1,"2015",NA
"15376","NOSATE",8,0,0,8,"2015","155"
"15377","NOVA MILANESE",0,53,0,53,"2015",NA
"15378","NOVAFELTRIA",1082,153,0,1235,"2015","023"
"15379","NOVALESA",34,12,0,46,"2015","169"
"15380","NOVARA",46,346,0,392,"2015","106"
"15381","NOVATE MEZZOLA",1,20,6,27,"2015","046"
"15382","NOVATE MILANESE",3,0,0,3,"2015",NA
"15383","NOVE",21,272,0,293,"2015","073"
"15384","NOVEDRATE",876,0,0,876,"2015","163"
"15385","NOVELLARA",3662,2150,0,5812,"2015","028"
"15386","NOVELLO",1020,0,0,1020,"2015","152"
"15387","NOVENTA DI PIAVE",6,14,0,20,"2015","027"
"15388","NOVENTA PADOVANA",10,0,0,10,"2015","058"
"15389","NOVENTA VICENTINA",3962,0,0,3962,"2015","074"
"15390","NOVI DI MODENA",1111,772,0,1883,"2015","028"
"15391","NOVI LIGURE",472,0,0,472,"2015","114"
"15392","NOVIGLIO",14,471,0,485,"2015","158"
"15393","NUVOLENTO",10,920,0,930,"2015","119"
"15394","NUVOLERA",1185,380,0,1565,"2015","120"
"15395","OCCHIEPPO INFERIORE",8,153,0,161,"2015","040"
"15396","OCCHIEPPO SUPERIORE",38,47,34,119,"2015","041"
"15397","OCCHIOBELLO",2,133,0,135,"2015","033"
"15398","OCCIMIANO",39,0,0,39,"2015","115"
"15399","ODALENGO GRANDE",57,0,0,57,"2015","116"
"15400","ODERZO",100,366,0,466,"2015","051"
"15401","ODOLO",5,0,0,5,"2015","121"
"15402","OFFANENGO",292,491,0,783,"2015","062"
"15403","OFFLAGA",615,3541,87,4243,"2015","122"
"15404","OGGEBBIO",6,0,0,6,"2015","049"
"15405","OGGIONA CON SANTO STEFANO",2,33,0,35,"2015","107"
"15406","OGGIONO",62,75,4,141,"2015","057"
"15407","OGLIANICO",78,325,0,403,"2015","170"
"15408","OLDENICO",2,0,0,2,"2015","089"
"15409","OLEGGIO",194,885,0,1079,"2015","108"
"15410","OLEGGIO CASTELLO",2,0,0,2,"2015","109"
"15411","OLGIATE COMASCO",35,30,13,78,"2015","165"
"15412","OLGIATE MOLGORA",19,97,0,116,"2015","058"
"15413","OLGIATE OLONA",3,0,0,3,"2015","108"
"15414","OLGINATE",13,0,0,13,"2015","059"
"15415","OLIVA GESSI",4,0,0,4,"2015",NA
"15416","OLIVETO LARIO",21,0,0,21,"2015","060"
"15417","OLMENETA",17,378,127,522,"2015","063"
"15418","OLMO AL BREMBO",3,5,0,8,"2015","145"
"15419","OLMO GENTILE",30,0,6,36,"2015","081"
"15420","OLTRE IL COLLE",22,60,0,82,"2015","146"
"15421","OLTRESSENDA ALTA",2,32,0,34,"2015","147"
"15422","OLTRONA DI SAN MAMETTE",17,0,0,17,"2015","169"
"15423","OME",21,20,0,41,"2015","123"
"15424","OMEGNA",38,0,0,38,"2015","050"
"15425","ONCINO",0,0,86,86,"2015","154"
"15426","ONETA",2,43,0,45,"2015","148"
"15427","ONO SAN PIETRO",2,12,0,14,"2015","124"
"15428","ONORE",21,8,0,29,"2015","149"
"15429","OPERA",0,170,0,170,"2015","159"
"15430","OPPEANO",4013,880,0,4893,"2015","055"
"15431","ORBASSANO",617,0,197,814,"2015","171"
"15432","ORGIANO",259,17,0,276,"2015","075"
"15433","ORIGGIO",54,0,8,62,"2015","109"
"15434","ORINO",1,0,0,1,"2015","110"
"15435","ORIO CANAVESE",62,0,0,62,"2015","172"
"15436","ORIO LITTA",0,195,0,195,"2015","042"
"15437","ORMEA",126,10,0,136,"2015","155"
"15438","ORMELLE",35,146,0,181,"2015","052"
"15439","ORNAGO",19,50,0,69,"2015",NA
"15440","ORNAVASSO",8,0,5,13,"2015","051"
"15441","ORNICA",6,0,0,6,"2015","151"
"15442","ORSAGO",15,147,0,162,"2015","053"
"15443","ORSARA BORMIDA",15,0,0,15,"2015","119"
"15444","ORSENIGO",8,40,0,48,"2015","170"
"15445","ORTA SAN GIULIO",1,0,0,1,"2015","112"
"15446","ORZINUOVI",450,4486,0,4936,"2015","125"
"15447","ORZIVECCHI",18,696,0,714,"2015","126"
"15448","OSASCO",359,0,92,451,"2015","173"
"15449","OSASIO",229,148,138,515,"2015","174"
"15450","OSIO SOPRA",31,644,0,675,"2015","152"
"15451","OSIO SOTTO",24,0,0,24,"2015","153"
"15452","OSNAGO",254,90,0,344,"2015","061"
"15453","OSPEDALETTO EUGANEO",235,30,0,265,"2015","059"
"15454","OSPEDALETTO LODIGIANO",0,1065,0,1065,"2015","043"
"15455","OSPITALETTO",122,186,0,308,"2015","127"
"15456","OSSAGO LODIGIANO",43,1749,11,1803,"2015","044"
"15457","OSSIMO",1,11,2,14,"2015","128"
"15458","OSSONA",23,0,0,23,"2015","164"
"15459","OSTANA",52,0,0,52,"2015","156"
"15460","OSTELLATO",2924,4,0,2928,"2015","017"
"15461","OSTIANO",331,1388,64,1783,"2015","064"
"15462","OSTIGLIA",30,35,57,122,"2015","038"
"15463","OTTIGLIO",119,0,0,119,"2015","120"
"15464","OTTOBIANO",1,34,0,35,"2015","106"
"15465","OTTONE",108,3,0,111,"2015","030"
"15466","OULX",49,0,0,49,"2015","175"
"15467","OVADA",36,0,0,36,"2015","121"
"15468","OVIGLIO",23,13,0,36,"2015","122"
"15469","OZEGNA",146,12,0,158,"2015","176"
"15470","OZZANO DELL'EMILIA",153,249,0,402,"2015","046"
"15471","OZZANO MONFERRATO",80,0,0,80,"2015","123"
"15472","OZZERO",10,299,0,309,"2015","165"
"15473","PADENGHE SUL GARDA",48,0,59,107,"2015","129"
"15474","PADERNO D'ADDA",0,14,0,14,"2015","062"
"15475","PADERNO DEL GRAPPA",71,157,0,228,"2015","054"
"15476","PADERNO DUGNANO",21,0,2,23,"2015","166"
"15477","PADERNO FRANCIACORTA",2,139,132,273,"2015","130"
"15478","PADERNO PONCHIELLI",185,1990,91,2266,"2015","065"
"15479","PADOVA",566,322,71,959,"2015","060"
"15480","PAESANA",718,28,0,746,"2015","157"
"15481","PAESE",2173,741,124,3038,"2015","055"
"15482","PAGNO",40,0,0,40,"2015","158"
"15483","PAGNONA",15,0,11,26,"2015","063"
"15484","PAISCO LOVENO",1,13,4,18,"2015","131"
"15485","PAITONE",28,15,0,43,"2015","132"
"15486","PALADINA",1,3,0,4,"2015","155"
"15487","PALAGANO",133,643,2,778,"2015","029"
"15488","PALANZANO",11,471,0,482,"2015","026"
"15489","PALAZZAGO",98,87,0,185,"2015","156"
"15490","PALAZZO CANAVESE",17,0,0,17,"2015","177"
"15491","PALAZZO PIGNANO",19,894,0,913,"2015","066"
"15492","PALAZZOLO SULL'OGLIO",1398,1298,74,2770,"2015","133"
"15493","PALESTRO",0,0,22,22,"2015","107"
"15494","PALLANZENO",12,0,0,12,"2015","052"
"15495","PALOSCO",459,434,0,893,"2015","157"
"15496","PALU'",973,0,0,973,"2015","056"
"15497","PAMPARATO",55,0,0,55,"2015","159"
"15498","PANCALIERI",41,122,15,178,"2015","178"
"15499","PANDINO",73,3810,88,3971,"2015","067"
"15500","PAPOZZE",108,80,0,188,"2015","034"
"15501","PARABIAGO",97,35,0,132,"2015","168"
"15502","PARATICO",12,47,0,59,"2015","134"
"15503","PARETO",43,2,0,45,"2015","125"
"15504","PARLASCO",2,0,0,2,"2015","064"
"15505","PARMA",719,9476,0,10195,"2015","027"
"15506","PARODI LIGURE",21,0,16,37,"2015","126"
"15507","PAROLDO",31,0,0,31,"2015","160"
"15508","PARONA",8,0,0,8,"2015","109"
"15509","PARRE",40,62,0,102,"2015","158"
"15510","PARUZZARO",28,38,0,66,"2015","114"
"15511","PARZANICA",3,0,8,11,"2015","159"
"15512","PASPARDO",2,5,0,7,"2015","135"
"15513","PASSERANO MARMORITO",95,0,0,95,"2015","082"
"15514","PASSIRANO",137,200,3,340,"2015","136"
"15515","PASTRENGO",3,174,0,177,"2015","057"
"15516","PASTURO",50,136,19,205,"2015","065"
"15517","PAULLO",0,631,0,631,"2015","169"
"15518","PAVAROLO",63,0,0,63,"2015","180"
"15519","PAVIA",135,238,0,373,"2015","110"
"15520","PAVONE CANAVESE",129,0,0,129,"2015","181"
"15521","PAVONE DEL MELLA",1622,451,6,2079,"2015","137"
"15522","PAVULLO NEL FRIGNANO",212,3852,0,4064,"2015","030"
"15523","PECETTO DI VALENZA",28,0,0,28,"2015","128"
"15524","PECETTO TORINESE",112,0,0,112,"2015","183"
"15525","PECORARA",265,115,0,380,"2015","031"
"15526","PEDAVENA",6,124,0,130,"2015","036"
"15527","PEDEMONTE",6,5,0,11,"2015","076"
"15528","PEDEROBBA",124,164,0,288,"2015","056"
"15529","PEDRENGO",12,183,0,195,"2015","160"
"15530","PEGLIO",1,0,17,18,"2015","178"
"15531","PEGOGNAGA",2127,1829,1838,5794,"2015","039"
"15532","PEIA",11,8,2,21,"2015","161"
"15533","PELLEGRINO PARMENSE",17,678,0,695,"2015","028"
"15534","PELLIO INTELVI",9,12,27,48,"2015","179"
"15535","PENANGO",72,0,0,72,"2015","083"
"15536","PENNABILLI",292,13,0,305,"2015","024"
"15537","PERLEDO",2,0,0,2,"2015","067"
"15538","PERLETTO",216,0,0,216,"2015","161"
"15539","PERLO",42,0,0,42,"2015","162"
"15540","PERNUMIA",384,170,0,554,"2015","061"
"15541","PERO",3,0,0,3,"2015",NA
"15542","PEROSA ARGENTINA",50,11,0,61,"2015","184"
"15543","PEROSA CANAVESE",76,204,0,280,"2015","185"
"15544","PERRERO",35,0,0,35,"2015","186"
"15545","PERSICO DOSIMO",2,1953,0,1955,"2015","068"
"15546","PERTENGO",2,0,0,2,"2015","091"
"15547","PERTICA ALTA",18,4,0,22,"2015","139"
"15548","PERTICA BASSA",25,64,2,91,"2015","140"
"15549","PERTUSIO",69,0,0,69,"2015","187"
"15550","PESCANTINA",32,103,3,138,"2015","058"
"15551","PESCAROLO ED UNITI",80,781,0,861,"2015","069"
"15552","PESCHIERA BORROMEO",16,343,0,359,"2015","171"
"15553","PESCHIERA DEL GARDA",2,0,0,2,"2015",NA
"15554","PESSANO CON BORNAGO",81,91,0,172,"2015","172"
"15555","PESSINA CREMONESE",451,2795,0,3246,"2015","070"
"15556","PESSINETTO",3,0,0,3,"2015","188"
"15557","PETTENASCO",7,0,0,7,"2015","116"
"15558","PETTINENGO",7,0,27,34,"2015","042"
"15559","PETTORAZZA GRIMANI",356,263,0,619,"2015","035"
"15560","PEVERAGNO",1066,539,60,1665,"2015","163"
"15561","PEZZAZE",18,22,0,40,"2015","141"
"15562","PEZZOLO VALLE UZZONE",57,0,0,57,"2015","164"
"15563","PIACENZA",560,1310,0,1870,"2015","032"
"15564","PIACENZA D'ADIGE",585,0,0,585,"2015","062"
"15565","PIADENA",0,364,1,365,"2015","071"
"15566","PIAN CAMUNO",0,285,0,285,"2015","142"
"15567","PIANCOGNO",1,56,26,83,"2015","206"
"15568","PIANELLO DEL LARIO",4,2,8,14,"2015","183"
"15569","PIANELLO VAL TIDONE",354,75,0,429,"2015","033"
"15570","PIANENGO",1,140,0,141,"2015","072"
"15571","PIANEZZA",279,458,48,785,"2015","189"
"15572","PIANEZZE",247,30,0,277,"2015","077"
"15573","PIANFEI",818,71,40,929,"2015","165"
"15574","PIANICO",10,89,0,99,"2015","162"
"15575","PIANIGA",39,43,5,87,"2015","028"
"15576","PIANORO",130,222,1,353,"2015","047"
"15577","PIANTEDO",16,294,0,310,"2015","048"
"15578","PIARIO",0,37,0,37,"2015","163"
"15579","PIASCO",281,227,0,508,"2015","166"
"15580","PIATEDA",16,62,0,78,"2015","049"
"15581","PIATTO",24,0,0,24,"2015","043"
"15582","PIAZZA BREMBANA",0,3,0,3,"2015","164"
"15583","PIAZZATORRE",0,3,0,3,"2015","165"
"15584","PIAZZOLA SUL BRENTA",1180,1136,1,2317,"2015","063"
"15585","PIAZZOLO",11,0,0,11,"2015","166"
"15586","PIEA",60,0,0,60,"2015","084"
"15587","PIEDIMULERA",2,28,0,30,"2015","053"
"15588","PIERANICA",42,0,0,42,"2015","073"
"15589","PIETRA DE' GIORGI",21,0,0,21,"2015","111"
"15590","PIETRA MARAZZI",1,0,0,1,"2015",NA
"15591","PIEVE D'ALPAGO",18,25,0,43,"2015","038"
"15592","PIEVE D'OLMI",0,1328,371,1699,"2015","074"
"15593","PIEVE DEL CAIRO",16,65,0,81,"2015","113"
"15594","PIEVE DI CADORE",2,13,0,15,"2015","039"
"15595","PIEVE DI CORIANO",0,0,56,56,"2015","040"
"15596","PIEVE DI SOLIGO",59,151,4,214,"2015","057"
"15597","PIEVE EMANUELE",0,281,95,376,"2015","173"
"15598","PIEVE FISSIRAGA",92,1299,0,1391,"2015","045"
"15599","PIEVE PORTO MORONE",119,0,0,119,"2015","114"
"15600","PIEVE SAN GIACOMO",1,1948,0,1949,"2015","075"
"15601","PIEVE VERGONTE",31,5,39,75,"2015","054"
"15602","PIEVEPELAGO",47,102,0,149,"2015","031"
"15603","PILA",2,0,0,2,"2015",NA
"15604","PINAROLO PO",1979,0,0,1979,"2015","115"
"15605","PINASCA",88,26,0,114,"2015","190"
"15606","PINCARA",95,0,0,95,"2015","036"
"15607","PINEROLO",1860,168,131,2159,"2015","191"
"15608","PINO D'ASTI",3,0,0,3,"2015","085"
"15609","PINO TORINESE",525,0,41,566,"2015","192"
"15610","PIOBESI TORINESE",424,975,197,1596,"2015","193"
"15611","PIODE",0,13,0,13,"2015","097"
"15612","PIOLTELLO",4,0,0,4,"2015","175"
"15613","PIOMBINO DESE",5558,547,0,6105,"2015","064"
"15614","PIOSSASCO",471,460,156,1087,"2015","194"
"15615","PIOVA' MASSAIA",154,0,0,154,"2015","086"
"15616","PIOVE DI SACCO",3111,144,0,3255,"2015","065"
"15617","PIOVENE ROCCHETTE",1183,151,0,1334,"2015","078"
"15618","PIOVERA",208,239,0,447,"2015","130"
"15619","PIOZZANO",177,8,0,185,"2015","034"
"15620","PIOZZO",377,0,0,377,"2015","169"
"15621","PISCINA",1567,0,0,1567,"2015","195"
"15622","PISOGNE",6,219,13,238,"2015","143"
"15623","PIUBEGA",3033,635,51,3719,"2015","041"
"15624","PIURO",11,159,3,173,"2015","050"
"15625","PIVERONE",29,132,0,161,"2015","196"
"15626","PIZZIGHETTONE",144,3278,0,3422,"2015","076"
"15627","PLESIO",0,0,1,1,"2015","185"
"15628","POCAPAGLIA",371,32,0,403,"2015","170"
"15629","PODENZANO",110,787,0,897,"2015","035"
"15630","POGGIO RENATICO",3,424,0,427,"2015","018"
"15631","POGGIO RUSCO",197,429,109,735,"2015","042"
"15632","POGGIO TORRIANA",302,0,0,302,"2015",NA
"15633","POGGIRIDENTI",1,10,0,11,"2015","051"
"15634","POGLIANO MILANESE",1,0,0,1,"2015","176"
"15635","POGNANO",7,344,46,397,"2015","167"
"15636","POIRINO",3722,616,0,4338,"2015","197"
"15637","POJANA MAGGIORE",1364,24,0,1388,"2015","079"
"15638","POLAVENO",9,3,0,12,"2015","144"
"15639","POLESELLA",10,0,0,10,"2015","037"
"15640","POLESINE PARMENSE",7,220,0,227,"2015","029"
"15641","POLINAGO",78,706,0,784,"2015","032"
"15642","POLLONE",191,23,0,214,"2015","046"
"15643","POLONGHERA",204,156,0,360,"2015","171"
"15644","POLPENAZZE DEL GARDA",22,92,1,115,"2015","145"
"15645","POLVERARA",68,62,0,130,"2015","066"
"15646","POMARETTO",51,0,14,65,"2015","198"
"15647","POMARO MONFERRATO",3,0,203,206,"2015","131"
"15648","POMBIA",6,65,0,71,"2015","121"
"15649","POMPIANO",23,1329,0,1352,"2015","146"
"15650","POMPONESCO",0,385,8,393,"2015","043"
"15651","PONCARALE",422,804,50,1276,"2015","147"
"15652","PONDERANO",43,43,40,126,"2015","047"
"15653","PONNA",1,0,9,10,"2015","187"
"15654","PONSO",51,0,0,51,"2015","067"
"15655","PONT-CANAVESE",41,70,0,111,"2015","199"
"15656","PONTE DELL'OLIO",105,187,0,292,"2015","036"
"15657","PONTE DI LEGNO",2,9,0,11,"2015","148"
"15658","PONTE DI PIAVE",57,70,0,127,"2015","058"
"15659","PONTE IN VALTELLINA",8,9,0,17,"2015","052"
"15660","PONTE LAMBRO",2,21,0,23,"2015","188"
"15661","PONTE NELLE ALPI",28,147,0,175,"2015","040"
"15662","PONTE NIZZA",77,31,0,108,"2015","117"
"15663","PONTE NOSSA",0,25,0,25,"2015","168"
"15664","PONTE SAN NICOLO'",161,44,23,228,"2015","069"
"15665","PONTE SAN PIETRO",2,0,0,2,"2015","170"
"15666","PONTECCHIO POLESINE",967,0,0,967,"2015","038"
"15667","PONTECHIANALE",150,0,0,150,"2015","172"
"15668","PONTECURONE",3,0,0,3,"2015","132"
"15669","PONTELONGO",369,0,0,369,"2015","068"
"15670","PONTENURE",71,120,0,191,"2015","037"
"15671","PONTESTURA",8,0,0,8,"2015","133"
"15672","PONTEVICO",96,3072,402,3570,"2015","149"
"15673","PONTI",89,0,10,99,"2015","134"
"15674","PONTI SUL MINCIO",207,453,34,694,"2015","044"
"15675","PONTIDA",22,0,0,22,"2015","171"
"15676","PONTIROLO NUOVO",342,501,0,843,"2015","172"
"15677","PONTOGLIO",780,1041,129,1950,"2015","150"
"15678","PONZANO MONFERRATO",33,0,0,33,"2015","135"
"15679","PONZANO VENETO",415,238,1,654,"2015","059"
"15680","PONZONE",34,1,0,35,"2015","136"
"15681","PORLEZZA",6,52,27,85,"2015","189"
"15682","PORRETTA TERME",41,0,0,41,"2015","049"
"15683","PORTACOMARO",37,0,0,37,"2015","087"
"15684","PORTE",17,0,0,17,"2015","200"
"15685","PORTICO E SAN BENEDETTO",66,0,0,66,"2015","031"
"15686","PORTO MANTOVANO",709,713,2200,3622,"2015","045"
"15687","PORTO TOLLE",18,0,0,18,"2015","039"
"15688","PORTO VALTRAVAGLIA",6,0,0,6,"2015","114"
"15689","PORTO VIRO",3652,0,0,3652,"2015","052"
"15690","PORTOBUFFOLE'",6,0,10,16,"2015","060"
"15691","PORTOGRUARO",1150,80,4,1234,"2015","029"
"15692","PORTOMAGGIORE",327,443,0,770,"2015","019"
"15693","PORTULA",6,0,0,6,"2015","048"
"15694","POSINA",3,18,0,21,"2015","080"
"15695","POSSAGNO",12,8,0,20,"2015","061"
"15696","POSTALESIO",2,0,1,3,"2015","053"
"15697","POSTUA",0,5,0,5,"2015","102"
"15698","POVE DEL GRAPPA",12,61,0,73,"2015","081"
"15699","POVEGLIANO",62,223,76,361,"2015","062"
"15700","POVEGLIANO VERONESE",1971,635,6,2612,"2015","060"
"15701","POVIGLIO",23,1091,0,1114,"2015","029"
"15702","POZZAGLIO ED UNITI",32,2193,200,2425,"2015","077"
"15703","POZZO D'ADDA",184,0,0,184,"2015","177"
"15704","POZZOL GROPPO",44,0,0,44,"2015","137"
"15705","POZZOLENGO",629,632,46,1307,"2015","151"
"15706","POZZOLEONE",430,1801,0,2231,"2015","082"
"15707","POZZOLO FORMIGARO",17,0,112,129,"2015","138"
"15708","POZZONOVO",1445,0,0,1445,"2015","070"
"15709","POZZUOLO MARTESANA",29,869,0,898,"2015","178"
"15710","PRADALUNGA",22,0,0,22,"2015","173"
"15711","PRADLEVES",1,17,0,18,"2015","173"
"15712","PRAGELATO",7,0,4,11,"2015","201"
"15713","PRALBOINO",1276,811,12,2099,"2015","152"
"15714","PRALI",38,0,0,38,"2015","202"
"15715","PRALORMO",1207,337,0,1544,"2015","203"
"15716","PRALUNGO",80,0,33,113,"2015","049"
"15717","PRAMAGGIORE",11,35,0,46,"2015","030"
"15718","PRAMOLLO",8,0,1,9,"2015","204"
"15719","PRAROSTINO",34,7,0,41,"2015","205"
"15720","PRASCO",26,0,0,26,"2015","139"
"15721","PRASCORSANO",5,0,0,5,"2015","206"
"15722","PRATA CAMPORTACCIO",29,142,13,184,"2015","054"
"15723","PRATIGLIONE",3,0,0,3,"2015","207"
"15724","PRATO SESIA",0,10,0,10,"2015","122"
"15725","PRAY",55,0,0,55,"2015","050"
"15726","PRAZZO",175,42,17,234,"2015","174"
"15727","PREDAPPIO",135,38,0,173,"2015","032"
"15728","PREDORE",12,0,0,12,"2015","174"
"15729","PREDOSA",139,86,0,225,"2015","140"
"15730","PREGANZIOL",16,175,0,191,"2015","063"
"15731","PREGNANA MILANESE",1,114,0,115,"2015","179"
"15732","PREMANA",13,3,2,18,"2015","069"
"15733","PREMENO",7,0,0,7,"2015","055"
"15734","PREMIA",19,210,0,229,"2015","056"
"15735","PREMILCUORE",282,0,35,317,"2015","033"
"15736","PREMOLO",21,17,0,38,"2015","175"
"15737","PREMOSELLO-CHIOVENDA",20,0,2,22,"2015","057"
"15738","PRESEGLIE",47,0,0,47,"2015","153"
"15739","PRESEZZO",3,0,0,3,"2015",NA
"15740","PRESSANA",4064,122,0,4186,"2015","061"
"15741","PRESTINE",7,89,5,101,"2015","154"
"15742","PREVALLE",102,561,27,690,"2015","155"
"15743","PRIERO",21,0,0,21,"2015","175"
"15744","PRIGNANO SULLA SECCHIA",121,1151,26,1298,"2015","033"
"15745","PRIMALUNA",16,64,2,82,"2015","070"
"15746","PRIOCCA",693,0,0,693,"2015","176"
"15747","PRIOLA",64,0,0,64,"2015","177"
"15748","PROSERPIO",5,4,0,9,"2015","192"
"15749","PROVAGLIO D'ISEO",83,196,8,287,"2015","156"
"15750","PROVAGLIO VAL SABBIA",33,0,3,36,"2015","157"
"15751","PRUNETTO",77,0,0,77,"2015","178"
"15752","PUEGNAGO SUL GARDA",10,113,2,125,"2015","158"
"15753","PUMENENGO",1403,507,164,2074,"2015","177"
"15754","PUOS D'ALPAGO",5,114,0,119,"2015","041"
"15755","PUSIANO",0,0,2,2,"2015","193"
"15756","QUAGLIUZZO",11,0,0,11,"2015","208"
"15757","QUAREGNA",2,0,0,2,"2015","051"
"15758","QUARGNENTO",1000,0,0,1000,"2015","141"
"15759","QUARNA SOPRA",2,0,0,2,"2015","058"
"15760","QUARNA SOTTO",7,0,0,7,"2015","059"
"15761","QUARONA",17,5,0,22,"2015","107"
"15762","QUARTO D'ALTINO",15,88,0,103,"2015","031"
"15763","QUASSOLO",22,26,18,66,"2015","209"
"15764","QUATTORDIO",553,0,0,553,"2015","142"
"15765","QUATTRO CASTELLA",26,1368,0,1394,"2015","030"
"15766","QUERO VAS",47,68,15,130,"2015",NA
"15767","QUINCINETTO",28,39,0,67,"2015","210"
"15768","QUINGENTOLE",74,82,102,258,"2015","046"
"15769","QUINTANO",0,262,4,266,"2015","078"
"15770","QUINTO DI TREVISO",124,216,40,380,"2015","064"
"15771","QUINTO VERCELLESE",44,0,0,44,"2015","108"
"15772","QUINTO VICENTINO",66,641,44,751,"2015","083"
"15773","QUINZANO D'OGLIO",279,2954,0,3233,"2015","159"
"15774","QUISTELLO",157,1809,674,2640,"2015","047"
"15775","QUITTENGO",2,0,0,2,"2015","052"
"15776","RACCONIGI",2083,2161,91,4335,"2015","179"
"15777","RAMISETO",40,245,0,285,"2015","031"
"15778","RAMPONIO VERNA",10,9,0,19,"2015","194"
"15779","RANCIO VALCUVIA",8,0,0,8,"2015","115"
"15780","RANCO",0,0,38,38,"2015","116"
"15781","RANICA",19,19,0,38,"2015","178"
"15782","RANZANICO",7,25,0,32,"2015","179"
"15783","RASSA",0,31,0,31,"2015","110"
"15784","RASURA",0,1,0,1,"2015","055"
"15785","RAVENNA",1035,1308,0,2343,"2015","014"
"15786","RE",26,0,0,26,"2015","060"
"15787","REANO",24,0,0,24,"2015","211"
"15788","RECOARO TERME",87,94,0,181,"2015","084"
"15789","REDAVALLE",44,0,0,44,"2015","120"
"15790","REDONDESCO",120,398,565,1083,"2015","048"
"15791","REFRANCORE",46,0,0,46,"2015","089"
"15792","REFRONTOLO",24,41,0,65,"2015","065"
"15793","REGGIO NELL'EMILIA",52,11305,11,11368,"2015","033"
"15794","REGGIOLO",1203,2391,0,3594,"2015","032"
"15795","REMEDELLO",6973,2518,46,9537,"2015","160"
"15796","RENATE",5,0,1,6,"2015",NA
"15797","RESANA",2744,58,19,2821,"2015","066"
"15798","REVELLO",6124,2113,0,8237,"2015","180"
"15799","REVERE",1,175,2,178,"2015","049"
"15800","REVIGLIASCO D'ASTI",282,0,0,282,"2015","090"
"15801","REVINE LAGO",14,32,0,46,"2015","067"
"15802","REZZATO",474,621,0,1095,"2015","161"
"15803","RHO",4,430,0,434,"2015","182"
"15804","RIBORDONE",7,0,0,7,"2015","212"
"15805","RICCIONE",2,0,0,2,"2015","013"
"15806","RICENGO",42,2044,67,2153,"2015","079"
"15807","RIESE PIO X",8118,425,34,8577,"2015","068"
"15808","RIFREDDO",1081,97,0,1178,"2015","181"
"15809","RIMA SAN GIUSEPPE",6,0,0,6,"2015","111"
"15810","RIMASCO",0,2,0,2,"2015","112"
"15811","RIMELLA",2,6,7,15,"2015","113"
"15812","RIMINI",107,109,1,217,"2015","014"
"15813","RIO SALICETO",693,304,0,997,"2015","034"
"15814","RIOLO TERME",326,0,0,326,"2015","015"
"15815","RIOLUNATO",54,33,0,87,"2015","035"
"15816","RIPALTA ARPINA",2,274,50,326,"2015","080"
"15817","RIPALTA CREMASCA",4,219,0,223,"2015","081"
"15818","RIPALTA GUERINA",1,522,0,523,"2015","082"
"15819","RIVA DI SOLTO",7,1,0,8,"2015","180"
"15820","RIVA PRESSO CHIERI",3207,142,0,3349,"2015","215"
"15821","RIVA VALDOBBIA",4,21,3,28,"2015","114"
"15822","RIVALBA",74,0,0,74,"2015","213"
"15823","RIVALTA DI TORINO",129,4,0,133,"2015","214"
"15824","RIVAMONTE AGORDINO",28,3,0,31,"2015","043"
"15825","RIVANAZZANO",155,0,0,155,"2015","122"
"15826","RIVARA",90,119,0,209,"2015","216"
"15827","RIVAROLO CANAVESE",1092,564,348,2004,"2015","217"
"15828","RIVAROLO DEL RE ED UNITI",3088,334,0,3422,"2015","083"
"15829","RIVAROLO MANTOVANO",81,1093,246,1420,"2015","050"
"15830","RIVAROSSA",6,138,0,144,"2015","218"
"15831","RIVERGARO",105,979,0,1084,"2015","038"
"15832","RIVOLI",1568,0,107,1675,"2015","219"
"15833","RIVOLI VERONESE",113,24,0,137,"2015","062"
"15834","RIVOLTA D'ADDA",1866,2752,149,4767,"2015","084"
"15835","RO",10,54,0,64,"2015","020"
"15836","ROANA",38,418,8,464,"2015","085"
"15837","ROASCIO",15,0,0,15,"2015","184"
"15838","ROASIO",16,0,0,16,"2015","116"
"15839","ROATTO",105,0,0,105,"2015","091"
"15840","ROBASSOMERO",50,63,0,113,"2015","220"
"15841","ROBBIO",5,233,0,238,"2015","123"
"15842","ROBECCHETTO CON INDUNO",182,242,0,424,"2015","183"
"15843","ROBECCO D'OGLIO",8,2870,0,2878,"2015","085"
"15844","ROBECCO SUL NAVIGLIO",76,472,171,719,"2015","184"
"15845","ROBELLA",297,0,0,297,"2015","092"
"15846","ROBILANTE",142,0,0,142,"2015","185"
"15847","ROBURENT",27,0,0,27,"2015","186"
"15848","ROCCA CANAVESE",65,0,0,65,"2015","221"
"15849","ROCCA CIGLIE'",40,0,0,40,"2015","188"
"15850","ROCCA D'ARAZZO",413,0,0,413,"2015","093"
"15851","ROCCA DE' BALDI",2534,1369,408,4311,"2015","189"
"15852","ROCCA GRIMALDA",17,0,0,17,"2015","147"
"15853","ROCCA PIETORE",0,7,0,7,"2015","044"
"15854","ROCCA SAN CASCIANO",165,0,0,165,"2015","036"
"15855","ROCCA SUSELLA",3,0,0,3,"2015",NA
"15856","ROCCABIANCA",0,643,0,643,"2015","030"
"15857","ROCCABRUNA",123,0,46,169,"2015","187"
"15858","ROCCAFORTE LIGURE",29,0,0,29,"2015","146"
"15859","ROCCAFORTE MONDOVI'",730,10,0,740,"2015","190"
"15860","ROCCAFRANCA",1756,1311,60,3127,"2015","162"
"15861","ROCCASPARVERA",186,0,0,186,"2015","191"
"15862","ROCCAVERANO",174,0,0,174,"2015","094"
"15863","ROCCAVIONE",30,0,0,30,"2015","192"
"15864","ROCCHETTA LIGURE",25,0,0,25,"2015","148"
"15865","ROCCHETTA PALAFEA",7,0,0,7,"2015","095"
"15866","ROCCHETTA TANARO",330,0,0,330,"2015","096"
"15867","RODANO",28,137,0,165,"2015","185"
"15868","RODDI",85,35,0,120,"2015","194"
"15869","RODDINO",91,0,0,91,"2015","195"
"15870","RODELLO",109,0,0,109,"2015","196"
"15871","RODENGO-SAIANO",11,239,187,437,"2015","163"
"15872","RODERO",6,5,0,11,"2015",NA
"15873","RODIGO",996,695,1552,3243,"2015","051"
"15874","ROE' VOLCIANO",13,0,0,13,"2015","164"
"15875","ROGENO",84,253,0,337,"2015","072"
"15876","ROGNANO",25,0,0,25,"2015","127"
"15877","ROGNO",16,79,0,95,"2015","182"
"15878","ROGOLO",4,19,0,23,"2015","056"
"15879","ROLETTO",202,79,0,281,"2015","222"
"15880","ROLO",0,247,0,247,"2015","035"
"15881","ROMAGNANO SESIA",36,0,0,36,"2015","130"
"15882","ROMAGNESE",118,0,0,118,"2015","128"
"15883","ROMANENGO",0,2038,0,2038,"2015","086"
"15884","ROMANO CANAVESE",21,0,0,21,"2015","223"
"15885","ROMANO D'EZZELINO",265,355,10,630,"2015","086"
"15886","ROMANO DI LOMBARDIA",205,3216,0,3421,"2015","183"
"15887","ROMENTINO",11,0,0,11,"2015","131"
"15888","RONAGO",1,59,0,60,"2015","199"
"15889","RONCA'",6,5,0,11,"2015","063"
"15890","RONCADE",2452,122,0,2574,"2015","069"
"15891","RONCADELLE",334,623,0,957,"2015","165"
"15892","RONCARO",1,0,0,1,"2015","129"
"15893","RONCELLO",1,0,0,1,"2015",NA
"15894","RONCO ALL'ADIGE",6536,0,0,6536,"2015","064"
"15895","RONCO BIELLESE",5,71,0,76,"2015","053"
"15896","RONCO BRIANTINO",0,137,0,137,"2015",NA
"15897","RONCO CANAVESE",80,0,0,80,"2015","224"
"15898","RONCOFERRARO",2385,461,574,3420,"2015","052"
"15899","RONCOFREDDO",12,39,0,51,"2015","037"
"15900","RONCOLA",38,44,0,82,"2015","185"
"15901","RONDISSONE",7,0,0,7,"2015","225"
"15902","RONSECCO",6,0,0,6,"2015",NA
"15903","ROPPOLO",7,0,0,7,"2015","054"
"15904","RORA'",21,0,0,21,"2015","226"
"15905","ROSA'",149,895,0,1044,"2015","087"
"15906","ROSASCO",2,0,0,2,"2015","130"
"15907","ROSATE",3157,525,0,3682,"2015","188"
"15908","ROSIGNANO MONFERRATO",81,0,0,81,"2015","149"
"15909","ROSOLINA",7,0,0,7,"2015","040"
"15910","ROSSA",2,3,0,5,"2015","121"
"15911","ROSSANA",76,152,0,228,"2015","197"
"15912","ROSSANO VENETO",309,191,9,509,"2015","088"
"15913","ROSTA",11,0,91,102,"2015","228"
"15914","ROTA D'IMAGNA",20,30,1,51,"2015","186"
"15915","ROTTOFRENO",441,806,0,1247,"2015","039"
"15916","ROTZO",79,0,0,79,"2015","089"
"15917","ROURE",7,0,0,7,"2015","227"
"15918","ROVASENDA",19,0,0,19,"2015","122"
"15919","ROVATO",1736,2091,126,3953,"2015","166"
"15920","ROVELLASCA",14,63,0,77,"2015","201"
"15921","ROVELLO PORRO",3,0,0,3,"2015",NA
"15922","ROVERBELLA",12070,604,367,13041,"2015","053"
"15923","ROVERCHIARA",3891,6,0,3897,"2015","065"
"15924","ROVERE' VERONESE",278,1172,0,1450,"2015","067"
"15925","ROVEREDO DI GUA'",1455,80,0,1535,"2015","066"
"15926","ROVESCALA",11,0,0,11,"2015","131"
"15927","ROVETTA",36,107,0,143,"2015","187"
"15928","ROVIGO",1302,0,0,1302,"2015","041"
"15929","ROVOLON",211,27,73,311,"2015","071"
"15930","RUBANO",36,49,45,130,"2015","072"
"15931","RUBIANA",3,0,0,3,"2015","229"
"15932","RUBIERA",0,519,0,519,"2015","036"
"15933","RUDIANO",519,1109,28,1656,"2015","167"
"15934","RUEGLIO",98,90,0,188,"2015","230"
"15935","RUFFIA",218,315,0,533,"2015","198"
"15936","RUINO",104,0,0,104,"2015","132"
"15937","RUSSI",14,124,0,138,"2015","016"
"15938","SABBIO CHIESE",25,24,7,56,"2015","168"
"15939","SABBIONETA",9,102,30,141,"2015","054"
"15940","SACCOLONGO",65,541,67,673,"2015","073"
"15941","SAGLIANO MICCA",36,0,0,36,"2015","056"
"15942","SALA BAGANZA",4,98,0,102,"2015","031"
"15943","SALA BIELLESE",2,0,0,2,"2015","057"
"15944","SALA BOLOGNESE",270,71,0,341,"2015","050"
"15945","SALA COMACINA",0,0,3,3,"2015","203"
"15946","SALA MONFERRATO",86,0,0,86,"2015","150"
"15947","SALARA",5,0,0,5,"2015","042"
"15948","SALASSA",11,0,0,11,"2015","231"
"15949","SALBERTRAND",39,0,0,39,"2015","232"
"15950","SALCEDO",389,64,0,453,"2015","090"
"15951","SALE",13,0,0,13,"2015","151"
"15952","SALE DELLE LANGHE",60,0,0,60,"2015","199"
"15953","SALE MARASINO",61,24,0,85,"2015","169"
"15954","SALE SAN GIOVANNI",62,0,0,62,"2015","200"
"15955","SALERANO CANAVESE",1,0,0,1,"2015",NA
"15956","SALERANO SUL LAMBRO",5,227,0,232,"2015","046"
"15957","SALETTO",8,65,0,73,"2015","074"
"15958","SALGAREDA",1984,331,0,2315,"2015","070"
"15959","SALICETO",88,0,0,88,"2015","201"
"15960","SALIZZOLE",2515,494,6,3015,"2015","068"
"15961","SALMOUR",211,0,0,211,"2015","202"
"15962","SALO'",1,45,0,46,"2015","170"
"15963","SALSOMAGGIORE TERME",10,1180,13,1203,"2015","032"
"15964","SALTRIO",37,0,0,37,"2015","117"
"15965","SALUDECIO",96,61,0,157,"2015","015"
"15966","SALUGGIA",473,165,0,638,"2015","128"
"15967","SALUSSOLA",356,89,0,445,"2015","058"
"15968","SALUZZO",2956,3843,48,6847,"2015","203"
"15969","SALVIROLA",674,94,0,768,"2015","087"
"15970","SALZANO",117,22,2,141,"2015","032"
"15971","SAMARATE",38,0,0,38,"2015","118"
"15972","SAMBUCO",21,0,0,21,"2015","204"
"15973","SAMOLACO",137,696,38,871,"2015","057"
"15974","SAMONE",18,0,0,18,"2015","235"
"15975","SAMPEYRE",215,50,23,288,"2015","205"
"15976","SAN BARTOLOMEO VAL CAVARGNA",8,0,6,14,"2015","204"
"15977","SAN BASSANO",8,1470,0,1478,"2015","088"
"15978","SAN BELLINO",1446,0,0,1446,"2015","043"
"15979","SAN BENEDETTO BELBO",35,70,0,105,"2015","206"
"15980","SAN BENEDETTO PO",507,1714,1128,3349,"2015","055"
"15981","SAN BENEDETTO VAL DI SAMBRO",271,95,0,366,"2015","051"
"15982","SAN BENIGNO CANAVESE",218,0,40,258,"2015","236"
"15983","SAN BERNARDINO VERBANO",2,0,0,2,"2015","061"
"15984","SAN BIAGIO DI CALLALTA",102,52,0,154,"2015","071"
"15985","SAN BONIFACIO",2160,0,0,2160,"2015","069"
"15986","SAN CARLO CANAVESE",193,269,0,462,"2015","237"
"15987","SAN CESARIO SUL PANARO",33,643,0,676,"2015","036"
"15988","SAN CIPRIANO PO",55,0,0,55,"2015","133"
"15989","SAN CLEMENTE",20,0,0,20,"2015","016"
"15990","SAN COLOMBANO AL LAMBRO",17,256,0,273,"2015","191"
"15991","SAN COLOMBANO BELMONTE",3,19,0,22,"2015","238"
"15992","SAN CRISTOFORO",19,0,0,19,"2015","152"
"15993","SAN DAMIANO D'ASTI",4208,0,0,4208,"2015","097"
"15994","SAN DAMIANO MACRA",44,0,0,44,"2015","207"
"15995","SAN DANIELE PO",36,1570,0,1606,"2015","089"
"15996","SAN DIDERO",0,8,0,8,"2015","239"
"15997","SAN DONA' DI PIAVE",258,448,11,717,"2015","033"
"15998","SAN DONATO MILANESE",8,0,0,8,"2015","192"
"15999","SAN FEDELE INTELVI",27,19,9,55,"2015","205"
"16000","SAN FELICE DEL BENACO",3,0,0,3,"2015","171"
"16001","SAN FELICE SUL PANARO",0,864,0,864,"2015","037"
"16002","SAN FERMO DELLA BATTAGLIA",9,0,18,27,"2015","206"
"16003","SAN FIOR",34,59,0,93,"2015","072"
"16004","SAN FIORANO",1,130,0,131,"2015","047"
"16005","SAN FRANCESCO AL CAMPO",494,339,0,833,"2015","240"
"16006","SAN GENESIO ED UNITI",5,459,0,464,"2015","135"
"16007","SAN GERMANO CHISONE",57,29,0,86,"2015","242"
"16008","SAN GERMANO DEI BERICI",306,252,0,558,"2015","092"
"16009","SAN GERMANO VERCELLESE",13,0,0,13,"2015","131"
"16010","SAN GERVASIO BRESCIANO",1,256,0,257,"2015","172"
"16011","SAN GIACOMO DELLE SEGNATE",305,128,213,646,"2015","056"
"16012","SAN GIACOMO FILIPPO",1,0,2,3,"2015","058"
"16013","SAN GIACOMO VERCELLESE",1933,0,0,1933,"2015","035"
"16014","SAN GILLIO",140,76,0,216,"2015","243"
"16015","SAN GIORGIO CANAVESE",339,32,0,371,"2015","244"
"16016","SAN GIORGIO DELLE PERTICHE",278,106,2,386,"2015","075"
"16017","SAN GIORGIO DI LOMELLINA",9,0,0,9,"2015","136"
"16018","SAN GIORGIO DI MANTOVA",286,110,2,398,"2015","057"
"16019","SAN GIORGIO DI PIANO",18,0,0,18,"2015","052"
"16020","SAN GIORGIO IN BOSCO",279,864,9,1152,"2015","076"
"16021","SAN GIORGIO MONFERRATO",15,0,0,15,"2015","153"
"16022","SAN GIORGIO PIACENTINO",295,716,0,1011,"2015","040"
"16023","SAN GIORGIO SCARAMPI",53,0,0,53,"2015","098"
"16024","SAN GIORIO DI SUSA",0,31,0,31,"2015","245"
"16025","SAN GIOVANNI BIANCO",56,26,3,85,"2015","188"
"16026","SAN GIOVANNI DEL DOSSO",0,293,79,372,"2015","058"
"16027","SAN GIOVANNI ILARIONE",720,16,0,736,"2015","070"
"16028","SAN GIOVANNI IN CROCE",0,428,2,430,"2015","090"
"16029","SAN GIOVANNI IN MARIGNANO",11,0,0,11,"2015","017"
"16030","SAN GIOVANNI IN PERSICETO",27,808,0,835,"2015","053"
"16031","SAN GIOVANNI LUPATOTO",548,22,0,570,"2015","071"
"16032","SAN GIULIANO MILANESE",9,519,0,528,"2015","195"
"16033","SAN GIUSTO CANAVESE",116,22,0,138,"2015","246"
"16034","SAN GREGORIO NELLE ALPI",25,64,0,89,"2015","045"
"16035","SAN LAZZARO DI SAVENA",21,10,0,31,"2015","054"
"16036","SAN LEO",247,245,0,492,"2015","025"
"16037","SAN MARTINO ALFIERI",15,0,0,15,"2015","099"
"16038","SAN MARTINO BUON ALBERGO",223,974,0,1197,"2015","073"
"16039","SAN MARTINO CANAVESE",38,0,0,38,"2015","247"
"16040","SAN MARTINO DALL'ARGINE",345,770,39,1154,"2015","059"
"16041","SAN MARTINO DEL LAGO",10,0,0,10,"2015","091"
"16042","SAN MARTINO DI LUPARI",2092,350,0,2442,"2015","077"
"16043","SAN MARTINO IN RIO",0,743,0,743,"2015","037"
"16044","SAN MARTINO IN STRADA",0,1014,0,1014,"2015","048"
"16045","SAN MARTINO SICCOMARIO",0,1,0,1,"2015","137"
"16046","SAN MARZANO OLIVETO",41,0,0,41,"2015","100"
"16047","SAN MAURIZIO CANAVESE",173,579,29,781,"2015","248"
"16048","SAN MAURIZIO D'OPAGLIO",14,0,0,14,"2015","133"
"16049","SAN MAURO DI SALINE",105,328,32,465,"2015","074"
"16050","SAN MAURO PASCOLI",2,0,0,2,"2015","041"
"16051","SAN MAURO TORINESE",16,0,0,16,"2015","249"
"16052","SAN MICHELE AL TAGLIAMENTO",2013,33,0,2046,"2015","034"
"16053","SAN MICHELE MONDOVI'",155,0,0,155,"2015","210"
"16054","SAN NAZARIO",13,0,0,13,"2015","093"
"16055","SAN NAZZARO SESIA",116,0,0,116,"2015","134"
"16056","SAN NAZZARO VAL CAVARGNA",5,0,8,13,"2015","207"
"16057","SAN NICOLO' DI COMELICO",2,7,0,9,"2015","046"
"16058","SAN PAOLO",475,2067,19,2561,"2015","138"
"16059","SAN PAOLO D'ARGON",30,31,0,61,"2015","189"
"16060","SAN PAOLO SOLBRITO",15,0,0,15,"2015","101"
"16061","SAN PELLEGRINO TERME",57,30,0,87,"2015","190"
"16062","SAN PIETRO DI CADORE",0,53,0,53,"2015","047"
"16063","SAN PIETRO DI FELETTO",27,16,0,43,"2015","073"
"16064","SAN PIETRO IN CASALE",34,114,0,148,"2015","055"
"16065","SAN PIETRO IN CERRO",99,650,0,749,"2015","041"
"16066","SAN PIETRO IN GU",785,3206,0,3991,"2015","078"
"16067","SAN PIETRO MOSEZZO",7,0,0,7,"2015","135"
"16068","SAN PIETRO MUSSOLINO",16,0,0,16,"2015","094"
"16069","SAN PIETRO VAL LEMINA",3,0,0,3,"2015","250"
"16070","SAN PIETRO VIMINARIO",329,208,0,537,"2015","079"
"16071","SAN POLO D'ENZA",5,632,0,637,"2015","038"
"16072","SAN POLO DI PIAVE",661,81,0,742,"2015","074"
"16073","SAN PONSO",2,28,0,30,"2015","251"
"16074","SAN POSSIDONIO",488,420,0,908,"2015","038"
"16075","SAN PROSPERO",1,441,0,442,"2015","039"
"16076","SAN RAFFAELE CIMENA",30,0,0,30,"2015","252"
"16077","SAN ROCCO AL PORTO",237,551,0,788,"2015","049"
"16078","SAN SALVATORE MONFERRATO",166,0,0,166,"2015","154"
"16079","SAN SEBASTIANO CURONE",27,0,0,27,"2015","155"
"16080","SAN SEBASTIANO DA PO",361,0,0,361,"2015","253"
"16081","SAN SECONDO DI PINEROLO",560,57,84,701,"2015","254"
"16082","SAN SECONDO PARMENSE",8,1559,0,1567,"2015","033"
"16083","SAN SIRO",1,0,7,8,"2015","248"
"16084","SAN VENDEMIANO",75,150,7,232,"2015","076"
"16085","SAN VITO DI LEGUZZANO",426,112,0,538,"2015","096"
"16086","SAN VITTORE OLONA",23,31,0,54,"2015","201"
"16087","SAN ZENO DI MONTAGNA",129,229,63,421,"2015","079"
"16088","SAN ZENO NAVIGLIO",3,554,0,557,"2015","173"
"16089","SAN ZENONE AL LAMBRO",0,730,0,730,"2015","202"
"16090","SAN ZENONE DEGLI EZZELINI",1896,584,1,2481,"2015","077"
"16091","SANDIGLIANO",42,82,0,124,"2015","059"
"16092","SANDRIGO",1759,1595,0,3354,"2015","091"
"16093","SANFRE'",725,76,0,801,"2015","208"
"16094","SANFRONT",1895,227,6,2128,"2015","209"
"16095","SANGANO",99,0,31,130,"2015","241"
"16096","SANGIANO",5,28,0,33,"2015","141"
"16097","SANGUINETTO",5,128,0,133,"2015","072"
"16098","SANNAZZARO DE' BURGONDI",9,44,0,53,"2015","138"
"16099","SANT'AGATA BOLOGNESE",6,506,0,512,"2015","056"
"16100","SANT'AGATA FELTRIA",178,61,0,239,"2015","026"
"16101","SANT'AGATA FOSSILI",75,0,0,75,"2015","156"
"16102","SANT'AGATA SUL SANTERNO",25,0,0,25,"2015","017"
"16103","SANT'AGOSTINO",2,0,0,2,"2015","021"
"16104","SANT'ALBANO STURA",4071,667,126,4864,"2015","211"
"16105","SANT'AMBROGIO DI TORINO",58,14,23,95,"2015","255"
"16106","SANT'AMBROGIO DI VALPOLICELLA",2,40,0,42,"2015","077"
"16107","SANT'ANGELO DI PIOVE DI SACCO",268,58,0,326,"2015","082"
"16108","SANT'ANGELO LODIGIANO",47,299,0,346,"2015","050"
"16109","SANT'ANGELO LOMELLINA",0,298,0,298,"2015","144"
"16110","SANT'ANNA D'ALFAEDO",191,1481,46,1718,"2015","078"
"16111","SANT'ANTONINO DI SUSA",6,40,28,74,"2015","256"
"16112","SANT'ELENA",58,0,0,58,"2015","083"
"16113","SANT'ILARIO D'ENZA",2,735,0,737,"2015","039"
"16114","SANT'OMOBONO TERME",90,18,0,108,"2015","192"
"16115","SANT'URBANO",451,0,1,452,"2015","084"
"16116","SANTA BRIGIDA",4,35,0,39,"2015","191"
"16117","SANTA CRISTINA E BISSONE",16,156,0,172,"2015","139"
"16118","SANTA GIULETTA",5,0,0,5,"2015","140"
"16119","SANTA GIUSTINA",259,134,0,393,"2015","048"
"16120","SANTA GIUSTINA IN COLLE",1080,369,3,1452,"2015","080"
"16121","SANTA LUCIA DI PIAVE",53,109,6,168,"2015","075"
"16122","SANTA MARGHERITA D'ADIGE",691,0,28,719,"2015","081"
"16123","SANTA MARGHERITA DI STAFFORA",62,0,2,64,"2015","142"
"16124","SANTA MARIA DELLA VERSA",4,0,0,4,"2015","143"
"16125","SANTA MARIA DI SALA",75,174,12,261,"2015","035"
"16126","SANTA MARIA HOE'",8,0,0,8,"2015","074"
"16127","SANTA MARIA MAGGIORE",28,0,14,42,"2015","062"
"16128","SANTA SOFIA",247,0,8,255,"2015","043"
"16129","SANTA VITTORIA D'ALBA",54,0,0,54,"2015","212"
"16130","SANTARCANGELO DI ROMAGNA",25,0,0,25,"2015","018"
"16131","SANTENA",515,0,0,515,"2015","257"
"16132","SANTHIA'",243,88,0,331,"2015","133"
"16133","SANTO STEFANO BELBO",14,0,0,14,"2015","213"
"16134","SANTO STEFANO DI CADORE",5,21,0,26,"2015","050"
"16135","SANTO STEFANO LODIGIANO",27,316,1,344,"2015","051"
"16136","SANTO STEFANO ROERO",121,0,0,121,"2015","214"
"16137","SANTO STEFANO TICINO",0,0,47,47,"2015","200"
"16138","SANTO STINO DI LIVENZA",2811,95,0,2906,"2015","036"
"16139","SANTORSO",457,209,0,666,"2015","095"
"16140","SAONARA",160,9,2,171,"2015","085"
"16141","SAPPADA",8,64,0,72,"2015","052"
"16142","SARCEDO",1668,341,0,2009,"2015","097"
"16143","SARDIGLIANO",4,0,0,4,"2015","157"
"16144","SAREGO",371,24,0,395,"2015","098"
"16145","SAREZZANO",3,0,0,3,"2015",NA
"16146","SAREZZO",16,11,0,27,"2015","174"
"16147","SARMATO",7,244,0,251,"2015","042"
"16148","SARMEDE",47,57,0,104,"2015","078"
"16149","SARNICO",10,0,0,10,"2015","193"
"16150","SARONNO",1,0,7,8,"2015","119"
"16151","SARSINA",153,0,6,159,"2015","044"
"16152","SARTIRANA LOMELLINA",5,0,0,5,"2015","146"
"16153","SASSO MARCONI",40,0,0,40,"2015","057"
"16154","SASSUOLO",27,403,0,430,"2015","040"
"16155","SAUZE D'OULX",69,0,0,69,"2015","259"
"16156","SAUZE DI CESANA",22,0,0,22,"2015","258"
"16157","SAVIGLIANO",9357,5106,139,14602,"2015","215"
"16158","SAVIGNANO SUL PANARO",59,94,0,153,"2015","041"
"16159","SAVIGNANO SUL RUBICONE",48,0,0,48,"2015","045"
"16160","SAVIORE DELL'ADAMELLO",3,39,3,45,"2015","175"
"16161","SCAGNELLO",159,0,0,159,"2015","216"
"16162","SCALDASOLE",15,82,0,97,"2015","147"
"16163","SCALENGHE",1450,2030,316,3796,"2015","260"
"16164","SCANDIANO",50,1451,11,1512,"2015","040"
"16165","SCANDOLARA RAVARA",0,700,0,700,"2015","092"
"16166","SCANDOLARA RIPA D'OGLIO",15,1008,86,1109,"2015","093"
"16167","SCANZOROSCIATE",46,0,0,46,"2015","194"
"16168","SCARMAGNO",5,0,0,5,"2015","261"
"16169","SCARNAFIGI",1176,1698,0,2874,"2015","217"
"16170","SCHIAVON",1904,1734,0,3638,"2015","099"
"16171","SCHIGNANO",2,8,14,24,"2015","211"
"16172","SCHILPARIO",0,61,0,61,"2015","195"
"16173","SCHIO",353,247,0,600,"2015","100"
"16174","SCHIVENOGLIA",0,9,0,9,"2015","060"
"16175","SCIOLZE",144,0,0,144,"2015","262"
"16176","SCOPA",2,0,0,2,"2015","134"
"16177","SCOPELLO",13,3,0,16,"2015","135"
"16178","SCORZE'",3229,35,86,3350,"2015","037"
"16179","SECUGNAGO",15,1320,0,1335,"2015","052"
"16180","SEDICO",1313,145,0,1458,"2015","053"
"16181","SEDRIANO",24,525,137,686,"2015","204"
"16182","SEDRINA",19,13,0,32,"2015","196"
"16183","SEGRATE",16,0,0,16,"2015","205"
"16184","SEGUSINO",10,71,0,81,"2015","079"
"16185","SELLERO",4,26,3,33,"2015","176"
"16186","SELVA DI CADORE",0,14,0,14,"2015","054"
"16187","SELVA DI PROGNO",57,633,70,760,"2015","080"
"16188","SELVAZZANO DENTRO",14,0,78,92,"2015","086"
"16189","SELVINO",4,0,0,4,"2015","197"
"16190","SENAGO",1,0,0,1,"2015",NA
"16191","SENIGA",2040,1919,0,3959,"2015","177"
"16192","SENNA COMASCO",45,181,13,239,"2015","212"
"16193","SENNA LODIGIANA",9,882,0,891,"2015","053"
"16194","SEREGNO",6,0,0,6,"2015",NA
"16195","SEREN DEL GRAPPA",65,16,183,264,"2015","055"
"16196","SERGNANO",6,1350,188,1544,"2015","094"
"16197","SERIATE",101,85,0,186,"2015","198"
"16198","SERINA",25,86,0,111,"2015","199"
"16199","SERLE",36,23,20,79,"2015","178"
"16200","SERMIDE",2,178,168,348,"2015","061"
"16201","SERNAGLIA DELLA BATTAGLIA",483,17,4,504,"2015","080"
"16202","SERNIO",1,0,0,1,"2015","059"
"16203","SEROLE",77,0,2,79,"2015","104"
"16204","SERRALUNGA D'ALBA",27,0,0,27,"2015","218"
"16205","SERRALUNGA DI CREA",13,0,0,13,"2015","159"
"16206","SERRAMAZZONI",27,1565,0,1592,"2015","042"
"16207","SERRAVALLE A PO",0,30,101,131,"2015","062"
"16208","SERRAVALLE LANGHE",97,0,0,97,"2015","219"
"16209","SERRAVALLE SCRIVIA",4,0,0,4,"2015","160"
"16210","SERRAVALLE SESIA",2,0,0,2,"2015","137"
"16211","SESTO CALENDE",35,0,0,35,"2015","120"
"16212","SESTO ED UNITI",3,1208,382,1593,"2015","095"
"16213","SESTOLA",65,399,0,464,"2015","043"
"16214","SETTALA",46,197,0,243,"2015","210"
"16215","SETTIME",199,0,0,199,"2015","106"
"16216","SETTIMO MILANESE",52,294,4,350,"2015","211"
"16217","SETTIMO ROTTARO",13,31,0,44,"2015","264"
"16218","SETTIMO TORINESE",389,253,103,745,"2015","265"
"16219","SETTIMO VITTONE",198,193,0,391,"2015","266"
"16220","SEZZADIO",53,0,0,53,"2015","161"
"16221","SILEA",6,131,0,137,"2015","081"
"16222","SILLAVENGO",22,101,0,123,"2015","138"
"16223","SILVANO D'ORBA",5,0,0,5,"2015","162"
"16224","SINIO",23,9,0,32,"2015","220"
"16225","SIRONE",7,80,2,89,"2015","075"
"16226","SIRTORI",8,0,0,8,"2015","076"
"16227","SISSA TRECASALI",18,943,0,961,"2015",NA
"16228","SIZIANO",52,89,0,141,"2015","150"
"16229","SIZZANO",218,12,148,378,"2015","139"
"16230","SOAVE",29,0,0,29,"2015","081"
"16231","SOGLIANO AL RUBICONE",231,53,0,284,"2015","046"
"16232","SOGLIO",1,0,0,1,"2015","107"
"16233","SOIANO DEL LAGO",5,0,0,5,"2015","180"
"16234","SOLAGNA",0,15,0,15,"2015","101"
"16235","SOLARO",0,14,0,14,"2015","213"
"16236","SOLAROLO",4,0,0,4,"2015","018"
"16237","SOLAROLO RAINERIO",15,277,0,292,"2015","096"
"16238","SOLBIATE",2,106,1,109,"2015","215"
"16239","SOLERO",306,0,0,306,"2015","163"
"16240","SOLESINO",7,0,0,7,"2015","087"
"16241","SOLFERINO",645,219,202,1066,"2015","063"
"16242","SOLIERA",31,865,0,896,"2015","044"
"16243","SOLIGNANO",10,322,0,332,"2015","035"
"16244","SOLONGHELLO",100,0,0,100,"2015","164"
"16245","SOLTO COLLINA",23,0,0,23,"2015","200"
"16246","SOMAGLIA",16,921,0,937,"2015","054"
"16247","SOMANO",35,0,0,35,"2015","221"
"16248","SOMMA LOMBARDO",19,9,0,28,"2015","123"
"16249","SOMMACAMPAGNA",1594,431,76,2101,"2015","082"
"16250","SOMMARIVA DEL BOSCO",1350,506,116,1972,"2015","222"
"16251","SOMMARIVA PERNO",21,0,0,21,"2015","223"
"16252","SOMMO",22,0,0,22,"2015","151"
"16253","SONA",2618,603,1,3222,"2015","083"
"16254","SONCINO",720,5023,29,5772,"2015","097"
"16255","SONDALO",30,91,11,132,"2015","060"
"16256","SONDRIO",22,41,0,63,"2015","061"
"16257","SONGAVAZZO",1,0,0,1,"2015","201"
"16258","SONICO",4,71,16,91,"2015","181"
"16259","SORAGNA",13,1892,0,1905,"2015","036"
"16260","SORBOLO",0,1413,0,1413,"2015","037"
"16261","SORDEVOLO",133,31,8,172,"2015","063"
"16262","SORDIO",0,222,0,222,"2015","055"
"16263","SORESINA",43,1477,38,1558,"2015","098"
"16264","SORGA'",1678,61,0,1739,"2015","084"
"16265","SORICO",6,14,63,83,"2015","216"
"16266","SORISO",7,0,0,7,"2015","140"
"16267","SORISOLE",58,45,0,103,"2015","202"
"16268","SORMANO",20,0,0,20,"2015","217"
"16269","SOSPIRO",37,384,0,421,"2015","099"
"16270","SOSPIROLO",18,95,0,113,"2015","056"
"16271","SOSSANO",24,468,0,492,"2015","102"
"16272","SOSTEGNO",1,8,0,9,"2015","064"
"16273","SOTTO IL MONTE GIOVANNI XXIII",62,78,0,140,"2015","203"
"16274","SOVERE",48,48,9,105,"2015","204"
"16275","SOVERZENE",2,0,0,2,"2015","057"
"16276","SOVICO",1,0,0,1,"2015",NA
"16277","SOVIZZO",463,93,0,556,"2015","103"
"16278","SOVRAMONTE",16,82,6,104,"2015","058"
"16279","SOZZAGO",6,0,0,6,"2015","141"
"16280","SPARONE",39,61,0,100,"2015","267"
"16281","SPESSA",9,0,0,9,"2015","152"
"16282","SPIGNO MONFERRATO",143,14,55,212,"2015","165"
"16283","SPILAMBERTO",1878,1375,0,3253,"2015","045"
"16284","SPINADESCO",2,0,0,2,"2015","100"
"16285","SPINEA",22,190,0,212,"2015","038"
"16286","SPINEDA",4,784,0,788,"2015","101"
"16287","SPINETO SCRIVIA",189,0,0,189,"2015","166"
"16288","SPINO D'ADDA",608,2118,0,2726,"2015","102"
"16289","SPINONE AL LAGO",13,0,0,13,"2015","205"
"16290","SPIRANO",17,1085,0,1102,"2015","206"
"16291","SPRESIANO",116,202,2,320,"2015","082"
"16292","STAGNO LOMBARDO",8,5996,205,6209,"2015","103"
"16293","STANGHELLA",284,0,0,284,"2015","088"
"16294","STAZZANO",23,0,3,26,"2015","167"
"16295","STAZZONA",11,11,7,29,"2015","218"
"16296","STEZZANO",150,288,171,609,"2015","207"
"16297","STIENTA",48,0,5,53,"2015","045"
"16298","STRA",0,0,6,6,"2015","039"
"16299","STRADELLA",23,27,0,50,"2015","153"
"16300","STRAMBINO",162,0,0,162,"2015","269"
"16301","STRESA",55,0,0,55,"2015","064"
"16302","STREVI",42,0,0,42,"2015","168"
"16303","STRONA",1,0,0,1,"2015","065"
"16304","STROPPO",11,0,0,11,"2015","224"
"16305","STROZZA",2,0,0,2,"2015","208"
"16306","SUARDI",6,0,0,6,"2015","154"
"16307","SUEGLIO",4,0,0,4,"2015","077"
"16308","SUELLO",6,0,7,13,"2015","078"
"16309","SUISIO",5,72,0,77,"2015","209"
"16310","SULBIATE",12,0,0,12,"2015",NA
"16311","SULZANO",28,226,0,254,"2015","182"
"16312","SUMIRAGO",56,102,0,158,"2015","124"
"16313","SUNO",44,425,0,469,"2015","143"
"16314","SUSA",129,28,0,157,"2015","270"
"16315","SUSEGANA",746,77,0,823,"2015","083"
"16316","SUSTINENTE",481,667,98,1246,"2015","064"
"16317","SUZZARA",1430,1285,1110,3825,"2015","065"
"16318","TACENO",13,0,6,19,"2015","079"
"16319","TAGLIO DI PO",6389,0,0,6389,"2015","046"
"16320","TAGLIOLO MONFERRATO",51,0,0,51,"2015","169"
"16321","TAIBON AGORDINO",5,38,0,43,"2015","059"
"16322","TAINO",35,118,21,174,"2015","125"
"16323","TALAMELLO",1,0,0,1,"2015","027"
"16324","TALAMONA",12,154,3,169,"2015","063"
"16325","TALEGGIO",66,17,0,83,"2015","210"
"16326","TAMBRE",24,121,0,145,"2015","060"
"16327","TARANTASCA",1968,310,275,2553,"2015","225"
"16328","TARTANO",16,9,0,25,"2015","064"
"16329","TARZO",25,23,0,48,"2015","084"
"16330","TASSAROLO",1,0,0,1,"2015","170"
"16331","TAVAGNASCO",99,10,0,109,"2015","271"
"16332","TAVAZZANO CON VILLAVESCO",2,1002,75,1079,"2015","056"
"16333","TAVERNOLA BERGAMASCA",7,12,0,19,"2015","211"
"16334","TAVERNOLE SUL MELLA",15,54,1,70,"2015","183"
"16335","TAVIGLIANO",43,0,0,43,"2015","066"
"16336","TEGLIO",35,252,39,326,"2015","065"
"16337","TELGATE",2011,241,0,2252,"2015","212"
"16338","TEMU'",9,8,0,17,"2015","184"
"16339","TEOLO",17,37,20,74,"2015","089"
"16340","TERDOBBIATE",4,135,0,139,"2015","144"
"16341","TERENZO",99,626,7,732,"2015","038"
"16342","TERNO D'ISOLA",3,61,0,64,"2015","213"
"16343","TERRANOVA DEI PASSERINI",23,557,0,580,"2015","057"
"16344","TERRASSA PADOVANA",1335,0,0,1335,"2015","090"
"16345","TERRAZZO",1,23,0,24,"2015","085"
"16346","TERRUGGIA",11,0,13,24,"2015","171"
"16347","TERZO",27,0,5,32,"2015","172"
"16348","TEZZE SUL BRENTA",97,321,0,418,"2015","104"
"16349","THIENE",238,398,0,636,"2015","105"
"16350","TICENGO",0,409,0,409,"2015","104"
"16351","TIGLIOLE",927,0,0,927,"2015","108"
"16352","TIGNALE",8,0,2,10,"2015","185"
"16353","TIRANO",12,4,6,22,"2015","066"
"16354","TIZZANO VAL PARMA",0,885,0,885,"2015","039"
"16355","TOANO",29,1832,6,1867,"2015","041"
"16356","TOCENO",16,7,12,35,"2015","065"
"16357","TOLLEGNO",2,17,0,19,"2015","068"
"16358","TOMBOLO",954,74,0,1028,"2015","091"
"16359","TONCO",566,0,0,566,"2015","109"
"16360","TONENGO",114,0,0,114,"2015","110"
"16361","TONEZZA DEL CIMONE",4,0,0,4,"2015","106"
"16362","TORBOLE CASAGLIA",2,949,27,978,"2015","186"
"16363","TORINO",165,0,12,177,"2015","272"
"16364","TORLINO VIMERCATI",0,469,0,469,"2015","105"
"16365","TORNATA",3,153,0,156,"2015","106"
"16366","TORNOLO",75,6,0,81,"2015","040"
"16367","TORRAZZA COSTE",8,0,0,8,"2015","155"
"16368","TORRAZZA PIEMONTE",213,12,0,225,"2015","273"
"16369","TORRAZZO",13,0,0,13,"2015","069"
"16370","TORRE BERETTI E CASTELLARO",11,327,0,338,"2015","156"
"16371","TORRE BOLDONE",6,0,0,6,"2015","214"
"16372","TORRE BORMIDA",0,14,0,14,"2015","226"
"16373","TORRE D'ARESE",4,0,0,4,"2015","157"
"16374","TORRE D'ISOLA",4,481,0,485,"2015","159"
"16375","TORRE DE' BUSI",9,0,1,10,"2015","080"
"16376","TORRE DE' NEGRI",12,77,156,245,"2015","158"
"16377","TORRE DE' PICENARDI",2,1198,0,1200,"2015","107"
"16378","TORRE DE' ROVERI",5,0,0,5,"2015","216"
"16379","TORRE DI MOSTO",30,487,0,517,"2015","041"
"16380","TORRE DI SANTA MARIA",25,2,0,27,"2015","067"
"16381","TORRE MONDOVI'",1,0,0,1,"2015","227"
"16382","TORRE PALLAVICINA",310,408,0,718,"2015","217"
"16383","TORRE PELLICE",81,0,0,81,"2015","275"
"16384","TORRE SAN GIORGIO",64,59,0,123,"2015","228"
"16385","TORREBELVICINO",906,12,0,918,"2015","107"
"16386","TORREGLIA",7,0,0,7,"2015","092"
"16387","TORRESINA",2,0,0,2,"2015","229"
"16388","TORREVECCHIA PIA",72,13,2,87,"2015","160"
"16389","TORRI DEL BENACO",3,0,0,3,"2015",NA
"16390","TORRI DI QUARTESOLO",40,150,9,199,"2015","108"
"16391","TORRILE",0,2454,0,2454,"2015","041"
"16392","TORTONA",2563,227,0,2790,"2015","174"
"16393","TOSCOLANO-MADERNO",10,0,3,13,"2015","187"
"16394","TOVO DI SANT'AGATA",1,70,5,76,"2015","068"
"16395","TRADATE",46,0,6,52,"2015","127"
"16396","TRANA",46,79,33,158,"2015","276"
"16397","TRAONA",67,116,76,259,"2015","069"
"16398","TRAREGO VIGGIONA",3,0,0,3,"2015","066"
"16399","TRASQUERA",12,0,4,16,"2015","067"
"16400","TRAUSELLA",16,31,0,47,"2015","277"
"16401","TRAVAGLIATO",906,500,0,1406,"2015","188"
"16402","TRAVEDONA-MONATE",18,0,29,47,"2015","128"
"16403","TRAVERSELLA",72,32,3,107,"2015","278"
"16404","TRAVERSETOLO",33,905,0,938,"2015","042"
"16405","TRAVES",8,0,0,8,"2015","279"
"16406","TRAVO",45,36,0,81,"2015","043"
"16407","TREBASELEGHE",7969,164,0,8133,"2015","093"
"16408","TRECATE",5,182,0,187,"2015","149"
"16409","TRECENTA",1583,183,0,1766,"2015","047"
"16410","TREDOZIO",127,0,0,127,"2015","049"
"16411","TREGNAGO",663,157,0,820,"2015","087"
"16412","TREMENICO",0,0,2,2,"2015","081"
"16413","TREMEZZINA",13,21,53,87,"2015",NA
"16414","TREMOSINE",27,368,11,406,"2015","189"
"16415","TRENZANO",986,1340,103,2429,"2015","190"
"16416","TRESCORE BALNEARIO",35,45,26,106,"2015","218"
"16417","TRESCORE CREMASCO",96,416,0,512,"2015","109"
"16418","TRESIGALLO",7,0,0,7,"2015","024"
"16419","TRESIVIO",3,46,0,49,"2015","070"
"16420","TREVENZUOLO",89,764,30,883,"2015","088"
"16421","TREVIGLIO",952,1492,0,2444,"2015","219"
"16422","TREVIGNANO",1942,178,4,2124,"2015","085"
"16423","TREVILLE",9,0,0,9,"2015","175"
"16424","TREVIOLO",94,180,0,274,"2015","220"
"16425","TREVISO",593,156,7,756,"2015","086"
"16426","TREVISO BRESCIANO",10,54,0,64,"2015","191"
"16427","TREZZANO SUL NAVIGLIO",0,263,0,263,"2015","220"
"16428","TREZZO SULL'ADDA",4,362,0,366,"2015","221"
"16429","TREZZO TINELLA",37,0,0,37,"2015","231"
"16430","TREZZONE",3,0,0,3,"2015","226"
"16431","TRIBANO",2,0,0,2,"2015","094"
"16432","TRIBIANO",0,34,0,34,"2015","222"
"16433","TRICHIANA",121,406,0,527,"2015","061"
"16434","TRIGOLO",2,1626,0,1628,"2015","110"
"16435","TRINITA'",2549,310,395,3254,"2015","232"
"16436","TRINO",2,164,0,166,"2015","148"
"16437","TRISOBBIO",118,0,0,118,"2015","176"
"16438","TRISSINO",50,369,0,419,"2015","110"
"16439","TRIUGGIO",77,265,4,346,"2015",NA
"16440","TRIVERO",13,38,0,51,"2015","070"
"16441","TROFARELLO",706,77,0,783,"2015","280"
"16442","TROMELLO",21,103,256,380,"2015","164"
"16443","TRONTANO",7,28,11,46,"2015","068"
"16444","TRONZANO LAGO MAGGIORE",3,0,0,3,"2015","129"
"16445","TRONZANO VERCELLESE",151,26,0,177,"2015","150"
"16446","TROVO",3,51,0,54,"2015","165"
"16447","TRUCCAZZANO",83,1699,0,1782,"2015","224"
"16448","TURANO LODIGIANO",48,1786,0,1834,"2015","058"
"16449","TURATE",113,0,3,116,"2015","227"
"16450","TURBIGO",2,52,0,54,"2015","226"
"16451","UBIALE CLANEZZO",3,0,0,3,"2015","221"
"16452","UBOLDO",12,0,0,12,"2015","130"
"16453","UGGIATE-TREVANO",12,53,12,77,"2015","228"
"16454","URAGO D'OGLIO",408,1153,0,1561,"2015","192"
"16455","URBANA",669,0,0,669,"2015","095"
"16456","URGNANO",321,232,0,553,"2015","222"
"16457","USMATE VELATE",9,77,0,86,"2015",NA
"16458","USSEAUX",36,96,2,134,"2015","281"
"16459","USSEGLIO",26,0,0,26,"2015","282"
"16460","VAIANO CREMASCO",11,389,0,400,"2015","111"
"16461","VAIE",1,11,71,83,"2015","283"
"16462","VAILATE",3,491,0,494,"2015","112"
"16463","VAL BREMBILLA",79,52,1,132,"2015",NA
"16464","VAL DELLA TORRE",343,0,0,343,"2015","284"
"16465","VAL MASINO",3,13,0,16,"2015","074"
"16466","VAL REZZO",6,3,9,18,"2015","233"
"16467","VALBONDIONE",2,11,0,13,"2015","223"
"16468","VALBREMBO",49,3,0,52,"2015","224"
"16469","VALBRONA",6,0,1,7,"2015","229"
"16470","VALDAGNO",43,175,0,218,"2015","111"
"16471","VALDASTICO",1140,20,0,1160,"2015","112"
"16472","VALDENGO",20,47,0,67,"2015","071"
"16473","VALDIDENTRO",34,121,18,173,"2015","071"
"16474","VALDISOTTO",39,117,8,164,"2015","072"
"16475","VALDOBBIADENE",114,443,1,558,"2015","087"
"16476","VALDUGGIA",6,0,0,6,"2015","152"
"16477","VALEGGIO",60,0,0,60,"2015","167"
"16478","VALEGGIO SUL MINCIO",2060,2159,81,4300,"2015","089"
"16479","VALENZA",57,0,0,57,"2015","177"
"16480","VALERA FRATTA",156,257,0,413,"2015","059"
"16481","VALFENERA",1047,103,172,1322,"2015","112"
"16482","VALFURVA",12,117,10,139,"2015","073"
"16483","VALGANNA",17,0,1,18,"2015","131"
"16484","VALGIOIE",2,0,0,2,"2015",NA
"16485","VALGOGLIO",17,60,0,77,"2015","225"
"16486","VALGRANA",95,0,0,95,"2015","234"
"16487","VALGREGHENTINO",2,0,0,2,"2015","082"
"16488","VALLADA AGORDINA",3,0,0,3,"2015","062"
"16489","VALLE DI CADORE",4,0,0,4,"2015","063"
"16490","VALLE LOMELLINA",13,706,0,719,"2015","168"
"16491","VALLE MOSSO",1,0,0,1,"2015","073"
"16492","VALLE SALIMBENE",0,87,0,87,"2015","169"
"16493","VALLE SAN NICOLAO",5,0,0,5,"2015","074"
"16494","VALLEVE",0,11,0,11,"2015","226"
"16495","VALLI DEL PASUBIO",8,3,0,11,"2015","113"
"16496","VALLIO TERME",5,0,0,5,"2015","193"
"16497","VALLO TORINESE",18,0,0,18,"2015","286"
"16498","VALMADRERA",37,0,2,39,"2015","083"
"16499","VALMOREA",5,32,0,37,"2015","232"
"16500","VALMOZZOLA",37,4,0,41,"2015","044"
"16501","VALPERGA",177,224,0,401,"2015","287"
"16502","VALPRATO SOANA",50,0,0,50,"2015","288"
"16503","VALSAMOGGIA",342,825,3,1170,"2015",NA
"16504","VALSOLDA",6,11,6,23,"2015","234"
"16505","VALSTAGNA",1,0,0,1,"2015","114"
"16506","VALSTRONA",19,0,0,19,"2015","069"
"16507","VALTORTA",8,36,0,44,"2015","229"
"16508","VALVESTINO",4,9,0,13,"2015","194"
"16509","VANZAGO",33,0,22,55,"2015","229"
"16510","VAPRIO D'ADDA",18,326,0,344,"2015","230"
"16511","VARALLO",38,53,0,91,"2015","156"
"16512","VARALLO POMBIA",1,0,0,1,"2015","154"
"16513","VARANO BORGHI",2,0,0,2,"2015","132"
"16514","VARANO DE' MELEGARI",27,347,0,374,"2015","045"
"16515","VARESE",99,116,0,215,"2015","133"
"16516","VARISELLA",7,0,0,7,"2015","289"
"16517","VARSI",5,430,0,435,"2015","046"
"16518","VARZI",83,5,0,88,"2015","171"
"16519","VARZO",9,21,7,37,"2015","071"
"16520","VAUDA CANAVESE",46,0,0,46,"2015","290"
"16521","VAZZOLA",1325,242,4,1571,"2015","088"
"16522","VEDANO OLONA",120,133,0,253,"2015","134"
"16523","VEDELAGO",18705,435,94,19234,"2015","089"
"16524","VEDESETA",2,142,0,144,"2015","230"
"16525","VEGGIANO",75,91,53,219,"2015","096"
"16526","VEGLIO",28,0,0,28,"2015","075"
"16527","VELESO",0,0,6,6,"2015","236"
"16528","VELEZZO LOMELLINA",1,0,0,1,"2015","172"
"16529","VELLEZZO BELLINI",20,360,0,380,"2015","173"
"16530","VELO D'ASTICO",1048,31,0,1079,"2015","115"
"16531","VELO VERONESE",453,1830,0,2283,"2015","090"
"16532","VENARIA REALE",74,17,270,361,"2015","292"
"16533","VENASCA",61,0,0,61,"2015","237"
"16534","VENAUS",18,41,8,67,"2015","291"
"16535","VENDROGNO",12,9,1,22,"2015","085"
"16536","VENEGONO INFERIORE",0,101,1,102,"2015","136"
"16537","VENEGONO SUPERIORE",0,3,13,16,"2015","137"
"16538","VENEZIA",1377,101,125,1603,"2015","042"
"16539","VENIANO",42,110,0,152,"2015","238"
"16540","VERANO BRIANZA",3,0,0,3,"2015",NA
"16541","VERBANIA",61,0,0,61,"2015","072"
"16542","VERCANA",5,8,1,14,"2015","239"
"16543","VERCEIA",8,0,7,15,"2015","075"
"16544","VERCELLI",70,193,0,263,"2015","158"
"16545","VERDELLINO",1,69,0,70,"2015","232"
"16546","VERDELLO",174,65,0,239,"2015","233"
"16547","VERDERIO",0,0,37,37,"2015",NA
"16548","VERDUNO",104,0,0,104,"2015","238"
"16549","VERGATO",67,0,8,75,"2015","059"
"16550","VERGHERETO",562,0,54,616,"2015","050"
"16551","VERGIATE",54,0,0,54,"2015","138"
"16552","VERMEZZO",0,474,0,474,"2015","235"
"16553","VERNANTE",242,57,0,299,"2015","239"
"16554","VERNASCA",79,66,0,145,"2015","044"
"16555","VERNATE",6,81,0,87,"2015","236"
"16556","VEROLANUOVA",1524,2032,123,3679,"2015","195"
"16557","VEROLAVECCHIA",45,3293,517,3855,"2015","196"
"16558","VEROLENGO",245,167,0,412,"2015","293"
"16559","VERONA",2471,971,38,3480,"2015","091"
"16560","VERONELLA",4985,291,0,5276,"2015","092"
"16561","VERRONE",54,0,0,54,"2015","076"
"16562","VERRUA SAVOIA",606,0,0,606,"2015","294"
"16563","VERTEMATE CON MINOPRIO",2,0,0,2,"2015","242"
"16564","VERTOVA",20,39,0,59,"2015","234"
"16565","VERUCCHIO",140,19,0,159,"2015","020"
"16566","VERUNO",5,0,0,5,"2015","157"
"16567","VERVIO",7,2,0,9,"2015","076"
"16568","VERZUOLO",20,21,0,41,"2015","240"
"16569","VESCOVANA",6,0,0,6,"2015","097"
"16570","VESCOVATO",2508,724,545,3777,"2015","113"
"16571","VESIME",517,0,0,517,"2015","113"
"16572","VESPOLATE",41,106,0,147,"2015","158"
"16573","VESTENANOVA",553,169,0,722,"2015","093"
"16574","VESTIGNE'",7,73,0,80,"2015","295"
"16575","VESTONE",7,0,0,7,"2015","197"
"16576","VESTRENO",1,0,0,1,"2015","089"
"16577","VETTO",26,405,0,431,"2015","042"
"16578","VEZZA D'OGLIO",1,202,22,225,"2015","198"
"16579","VEZZANO SUL CROSTOLO",25,146,0,171,"2015","043"
"16580","VIADANA",280,1355,107,1742,"2015","066"
"16581","VIADANICA",11,37,0,48,"2015","235"
"16582","VIALE",288,0,0,288,"2015","114"
"16583","VIALFRE'",13,0,0,13,"2015","296"
"16584","VIANO",8,818,0,826,"2015","044"
"16585","VIARIGI",22,0,0,22,"2015","115"
"16586","VICENZA",196,1031,4,1231,"2015","116"
"16587","VICO CANAVESE",145,133,0,278,"2015","297"
"16588","VICOFORTE",472,0,0,472,"2015","242"
"16589","VICOLUNGO",1,0,0,1,"2015","159"
"16590","VIDIGULFO",26,393,0,419,"2015","176"
"16591","VIDOR",34,365,0,399,"2015","090"
"16592","VIGANELLA",2,0,0,2,"2015",NA
"16593","VIGANO SAN MARTINO",10,0,0,10,"2015","236"
"16594","VIGASIO",679,543,0,1222,"2015","094"
"16595","VIGEVANO",101,63,108,272,"2015","177"
"16596","VIGGIU'",20,55,0,75,"2015","139"
"16597","VIGHIZZOLO D'ESTE",109,24,0,133,"2015","098"
"16598","VIGLIANO BIELLESE",1,39,0,40,"2015","077"
"16599","VIGLIANO D'ASTI",40,0,0,40,"2015","116"
"16600","VIGNALE MONFERRATO",170,0,0,170,"2015","179"
"16601","VIGNATE",12,391,0,403,"2015","237"
"16602","VIGNOLA",1,127,0,128,"2015","046"
"16603","VIGNOLE BORBERA",28,0,0,28,"2015","180"
"16604","VIGNOLO",614,0,0,614,"2015","243"
"16605","VIGNONE",3,0,0,3,"2015","074"
"16606","VIGO DI CADORE",2,5,6,13,"2015","065"
"16607","VIGODARZERE",303,85,0,388,"2015","099"
"16608","VIGOLO",20,123,0,143,"2015","237"
"16609","VIGOLZONE",101,398,0,499,"2015","045"
"16610","VIGONE",1313,1150,177,2640,"2015","299"
"16611","VIGONOVO",24,0,3,27,"2015","043"
"16612","VIGONZA",633,316,0,949,"2015","100"
"16613","VIGUZZOLO",2,0,0,2,"2015",NA
"16614","VILLA BARTOLOMEA",139,0,0,139,"2015","095"
"16615","VILLA CARCINA",5,0,0,5,"2015","199"
"16616","VILLA CORTESE",137,0,0,137,"2015","248"
"16617","VILLA D'ADDA",9,0,0,9,"2015","238"
"16618","VILLA D'ALME'",62,17,0,79,"2015","239"
"16619","VILLA D'OGNA",3,51,0,54,"2015","241"
"16620","VILLA DEL BOSCO",2,0,0,2,"2015","078"
"16621","VILLA DEL CONTE",692,743,2,1437,"2015","101"
"16622","VILLA DI CHIAVENNA",4,1,3,8,"2015","077"
"16623","VILLA DI SERIO",5,0,0,5,"2015","240"
"16624","VILLA DI TIRANO",8,116,65,189,"2015","078"
"16625","VILLA ESTENSE",237,0,0,237,"2015","102"
"16626","VILLA GUARDIA",151,0,0,151,"2015","245"
"16627","VILLA MINOZZO",42,759,0,801,"2015","045"
"16628","VILLA POMA",0,630,109,739,"2015","067"
"16629","VILLA SAN SECONDO",8,0,0,8,"2015","119"
"16630","VILLACHIARA",487,1717,871,3075,"2015","200"
"16631","VILLADEATI",14,0,0,14,"2015","182"
"16632","VILLADOSE",681,0,110,791,"2015","048"
"16633","VILLADOSSOLA",13,0,0,13,"2015","075"
"16634","VILLAFALLETTO",2050,668,426,3144,"2015","244"
"16635","VILLAFRANCA D'ASTI",273,0,0,273,"2015","117"
"16636","VILLAFRANCA DI VERONA",7013,3258,68,10339,"2015","096"
"16637","VILLAFRANCA PADOVANA",706,1923,14,2643,"2015","103"
"16638","VILLAFRANCA PIEMONTE",2557,2000,491,5048,"2015","300"
"16639","VILLAGA",89,156,140,385,"2015","117"
"16640","VILLALVERNIA",1,0,0,1,"2015",NA
"16641","VILLAMARZANA",263,79,0,342,"2015","049"
"16642","VILLAMIROGLIO",31,0,0,31,"2015","184"
"16643","VILLANOVA BIELLESE",320,0,0,320,"2015","079"
"16644","VILLANOVA CANAVESE",45,22,0,67,"2015","301"
"16645","VILLANOVA D'ARDENGHI",13,0,2,15,"2015","179"
"16646","VILLANOVA D'ASTI",3965,111,0,4076,"2015","118"
"16647","VILLANOVA DEL GHEBBO",45,0,0,45,"2015","050"
"16648","VILLANOVA DEL SILLARO",0,1169,7,1176,"2015","060"
"16649","VILLANOVA DI CAMPOSAMPIERO",26,37,5,68,"2015","104"
"16650","VILLANOVA MARCHESANA",2,63,0,65,"2015","051"
"16651","VILLANOVA MONDOVI'",1862,564,97,2523,"2015","245"
"16652","VILLANOVA MONFERRATO",0,75,0,75,"2015","185"
"16653","VILLANOVA SOLARO",188,680,7,875,"2015","246"
"16654","VILLANOVA SULL'ARDA",152,1357,0,1509,"2015","046"
"16655","VILLANTERIO",4,0,266,270,"2015","180"
"16656","VILLANUOVA SUL CLISI",10,0,0,10,"2015","201"
"16657","VILLAR DORA",40,0,39,79,"2015","303"
"16658","VILLAR FOCCHIARDO",21,26,76,123,"2015","305"
"16659","VILLAR PELLICE",205,42,8,255,"2015","306"
"16660","VILLAR PEROSA",10,0,15,25,"2015","307"
"16661","VILLAR SAN COSTANZO",309,241,96,646,"2015","247"
"16662","VILLARBASSE",217,19,0,236,"2015","302"
"16663","VILLARBOIT",2,0,0,2,"2015","163"
"16664","VILLAREGGIA",58,25,0,83,"2015","304"
"16665","VILLAROMAGNANO",36,0,0,36,"2015","186"
"16666","VILLASTELLONE",1145,585,0,1730,"2015","308"
"16667","VILLATA",16,34,0,50,"2015","164"
"16668","VILLAVERLA",82,1252,0,1334,"2015","118"
"16669","VILLETTE",49,0,0,49,"2015","076"
"16670","VILLIMPENTA",581,83,33,697,"2015","068"
"16671","VILLONGO",14,0,0,14,"2015","242"
"16672","VILLORBA",115,8,0,123,"2015","091"
"16673","VILMINORE DI SCALVE",17,178,0,195,"2015","243"
"16674","VIMERCATE",6,38,0,44,"2015",NA
"16675","VINADIO",189,0,0,189,"2015","248"
"16676","VINCHIO",21,0,0,21,"2015","120"
"16677","VINOVO",321,105,21,447,"2015","309"
"16678","VINZAGLIO",16,41,0,57,"2015","164"
"16679","VIOLA",71,0,0,71,"2015","249"
"16680","VIONE",3,34,5,42,"2015","202"
"16681","VIRLE PIEMONTE",260,246,145,651,"2015","310"
"16682","VISANO",2089,601,74,2764,"2015","203"
"16683","VISCHE",9,0,0,9,"2015","311"
"16684","VISONE",58,0,0,58,"2015","187"
"16685","VISTARINO",41,0,4,45,"2015","181"
"16686","VISTRORIO",18,0,0,18,"2015","312"
"16687","VITTORIO VENETO",228,163,15,406,"2015","092"
"16688","VITTUONE",1,184,0,185,"2015","243"
"16689","VIU'",52,39,42,133,"2015","313"
"16690","VIVERONE",41,0,0,41,"2015","080"
"16691","VIZZOLO PREDABISSI",22,43,0,65,"2015","244"
"16692","VO'",93,74,0,167,"2015","105"
"16693","VOBARNO",40,85,2,127,"2015","204"
"16694","VOCCA",0,16,0,16,"2015","166"
"16695","VODO CADORE",0,0,25,25,"2015","066"
"16696","VOGHERA",40,0,0,40,"2015","182"
"16697","VOGHIERA",9,0,0,9,"2015","023"
"16698","VOGOGNA",7,6,0,13,"2015","077"
"16699","VOLONGO",26,0,0,26,"2015","114"
"16700","VOLPAGO DEL MONTELLO",359,596,15,970,"2015","093"
"16701","VOLPEDO",1,0,0,1,"2015","188"
"16702","VOLPIANO",303,60,125,488,"2015","314"
"16703","VOLTA MANTOVANA",2144,1382,800,4326,"2015","070"
"16704","VOLTAGGIO",9,87,0,96,"2015","190"
"16705","VOLTAGO AGORDINO",1,0,0,1,"2015",NA
"16706","VOLTIDO",0,332,0,332,"2015","115"
"16707","VOLVERA",1432,175,0,1607,"2015","315"
"16708","VOTTIGNASCO",1840,99,78,2017,"2015","250"
"16709","ZANDOBBIO",13,33,0,46,"2015","244"
"16710","ZANE'",357,154,0,511,"2015","119"
"16711","ZANICA",321,1222,0,1543,"2015","245"
"16712","ZAVATTARELLO",76,0,0,76,"2015","184"
"16713","ZECCONE",0,264,0,264,"2015","185"
"16714","ZELBIO",0,0,9,9,"2015","246"
"16715","ZELO BUON PERSICO",0,1069,23,1092,"2015","061"
"16716","ZELO SURRIGONE",0,209,0,209,"2015","246"
"16717","ZEME",68,38,0,106,"2015","186"
"16718","ZENEVREDO",6,0,0,6,"2015","187"
"16719","ZENSON DI PIAVE",9,0,0,9,"2015","094"
"16720","ZERBOLO'",0,205,0,205,"2015","189"
"16721","ZERMEGHEDO",0,60,0,60,"2015","120"
"16722","ZERO BRANCO",246,206,4,456,"2015","095"
"16723","ZEVIO",3595,722,63,4380,"2015","097"
"16724","ZIANO PIACENTINO",82,0,0,82,"2015","048"
"16725","ZIBELLO",1,1074,0,1075,"2015","048"
"16726","ZIBIDO SAN GIACOMO",56,431,0,487,"2015","247"
"16727","ZIMELLA",6925,514,75,7514,"2015","098"
"16728","ZINASCO",15,0,0,15,"2015","190"
"16729","ZOCCA",90,786,0,876,"2015","047"
"16730","ZOGNO",101,62,0,163,"2015","246"
"16731","ZOLA PREDOSA",27,187,0,214,"2015","060"
"16732","ZOLDO ALTO",17,0,0,17,"2015","068"
"16733","ZONE",4,44,0,48,"2015","205"
"16734","ZOVENCEDO",6,0,0,6,"2015","121"
"16735","ZUBIENA",26,5,6,37,"2015","082"
"16736","ZUGLIANO",397,195,17,609,"2015","122"
"16737","ZUMAGLIA",21,0,0,21,"2015","083"
"16738","ABANO TERME",18,162,51,231,"2016","001"
"16739","ABBADIA CERRETO",0,1144,0,1144,"2016","001"
"16740","ABBADIA LARIANA",15,20,0,35,"2016","001"
"16741","ABBIATEGRASSO",77,1503,37,1617,"2016","002"
"16742","ACCEGLIO",96,0,0,96,"2016","001"
"16743","ACQUAFREDDA",1623,210,0,1833,"2016","001"
"16744","ACQUANEGRA CREMONESE",8,122,582,712,"2016","001"
"16745","ACQUANEGRA SUL CHIESE",2353,724,122,3199,"2016","001"
"16746","ACQUI TERME",239,0,0,239,"2016","001"
"16747","ADRARA SAN MARTINO",31,22,2,55,"2016","001"
"16748","ADRARA SAN ROCCO",1,6,0,7,"2016","002"
"16749","ADRIA",2545,288,0,2833,"2016","001"
"16750","ADRO",512,17,0,529,"2016","002"
"16751","AGAZZANO",150,476,0,626,"2016","001"
"16752","AGLIANO TERME",68,0,0,68,"2016","001"
"16753","AGLIE'",197,16,0,213,"2016","001"
"16754","AGNA",384,0,0,384,"2016","002"
"16755","AGNADELLO",21,1278,146,1445,"2016","002"
"16756","AGNOSINE",14,41,1,56,"2016","003"
"16757","AGORDO",3,27,0,30,"2016","001"
"16758","AGRA",0,1,0,1,"2016",NA
"16759","AGRATE CONTURBIA",55,0,0,55,"2016","001"
"16760","AGUGLIARO",372,83,0,455,"2016","001"
"16761","AICURZIO",4,55,0,59,"2016",NA
"16762","AILOCHE",0,9,0,9,"2016","001"
"16763","AIRASCA",1035,386,108,1529,"2016","002"
"16764","AIRUNO",8,0,0,8,"2016","002"
"16765","AISONE",40,0,0,40,"2016","002"
"16766","ALA DI STURA",31,30,0,61,"2016","003"
"16767","ALAGNA VALSESIA",20,14,0,34,"2016","002"
"16768","ALANO DI PIAVE",48,59,0,107,"2016","002"
"16769","ALBA",793,0,0,793,"2016","003"
"16770","ALBAIRATE",31,732,0,763,"2016","005"
"16771","ALBANO SANT'ALESSANDRO",12,0,0,12,"2016","003"
"16772","ALBAREDO D'ADIGE",10980,181,0,11161,"2016","002"
"16773","ALBAREDO PER SAN MARCO",6,25,0,31,"2016","001"
"16774","ALBARETO",127,101,0,228,"2016","001"
"16775","ALBARETTO DELLA TORRE",29,0,0,29,"2016","004"
"16776","ALBAVILLA",2,0,0,2,"2016","003"
"16777","ALBERA LIGURE",23,0,0,23,"2016","002"
"16778","ALBESE CON CASSANO",0,0,5,5,"2016","004"
"16779","ALBETTONE",2116,576,24,2716,"2016","002"
"16780","ALBIANO D'IVREA",146,38,0,184,"2016","004"
"16781","ALBIATE",378,0,0,378,"2016",NA
"16782","ALBIGNASEGO",159,76,104,339,"2016","003"
"16783","ALBINEA",6,1309,0,1315,"2016","001"
"16784","ALBINO",67,43,3,113,"2016","004"
"16785","ALBIOLO",29,0,0,29,"2016","005"
"16786","ALBIZZATE",5,0,0,5,"2016","002"
"16787","ALBOSAGGIA",32,51,26,109,"2016","002"
"16788","ALBUGNANO",60,0,0,60,"2016","002"
"16789","ALBUZZANO",22,0,0,22,"2016","004"
"16790","ALESSANDRIA",9027,2255,0,11282,"2016","003"
"16791","ALFIANELLO",7,568,2,577,"2016","004"
"16792","ALFIANO NATTA",25,0,0,25,"2016","004"
"16793","ALFONSINE",34,0,0,34,"2016","001"
"16794","ALGUA",4,5,0,9,"2016","248"
"16795","ALICE BEL COLLE",3,0,0,3,"2016","005"
"16796","ALICE CASTELLO",635,26,0,661,"2016","004"
"16797","ALICE SUPERIORE",29,0,0,29,"2016","005"
"16798","ALLEGHE",10,0,0,10,"2016","003"
"16799","ALLUVIONI CAMBIO'",19,0,0,19,"2016","006"
"16800","ALME'",2,0,4,6,"2016","005"
"16801","ALMENNO SAN BARTOLOMEO",42,0,0,42,"2016","006"
"16802","ALMENNO SAN SALVATORE",8,0,0,8,"2016","007"
"16803","ALMESE",60,26,0,86,"2016","006"
"16804","ALONTE",714,13,0,727,"2016","003"
"16805","ALPAGO",28,287,0,315,"2016",NA
"16806","ALPIGNANO",309,150,28,487,"2016","008"
"16807","ALSENO",485,763,0,1248,"2016","002"
"16808","ALSERIO",4,0,0,4,"2016","006"
"16809","ALTAVILLA MONFERRATO",85,0,0,85,"2016","007"
"16810","ALTAVILLA VICENTINA",111,0,0,111,"2016","004"
"16811","ALTISSIMO",30,59,0,89,"2016","005"
"16812","ALTIVOLE",11418,90,2,11510,"2016","001"
"16813","ALTO RENO TERME",55,0,0,55,"2016",NA
"16814","ALZANO LOMBARDO",20,51,0,71,"2016","008"
"16815","ALZANO SCRIVIA",4,0,0,4,"2016","008"
"16816","ALZATE BRIANZA",14,126,0,140,"2016","007"
"16817","AMBIVERE",2,0,0,2,"2016","009"
"16818","AMENO",24,6,14,44,"2016","002"
"16819","ANDALO VALTELLINO",15,0,0,15,"2016",NA
"16820","ANDEZENO",386,0,0,386,"2016","009"
"16821","ANDORNO MICCA",21,0,37,58,"2016","002"
"16822","ANDRATE",47,0,0,47,"2016","010"
"16823","ANFO",7,13,0,20,"2016","005"
"16824","ANGERA",71,225,0,296,"2016","003"
"16825","ANGOLO TERME",4,55,6,65,"2016","006"
"16826","ANGROGNA",98,0,18,116,"2016","011"
"16827","ANGUILLARA VENETA",6,0,0,6,"2016","004"
"16828","ANNICCO",36,812,262,1110,"2016","003"
"16829","ANNONE DI BRIANZA",37,17,0,54,"2016","003"
"16830","ANNONE VENETO",21,65,0,86,"2016","001"
"16831","ANTEGNATE",766,1489,0,2255,"2016","010"
"16832","ANTIGNANO",95,0,0,95,"2016","003"
"16833","ANTRONA SCHIERANCO",10,0,0,10,"2016","001"
"16834","ANZANO DEL PARCO",1,145,0,146,"2016","009"
"16835","ANZOLA D'OSSOLA",2,107,0,109,"2016","002"
"16836","ANZOLA DELL'EMILIA",57,214,0,271,"2016","001"
"16837","APPIANO GENTILE",70,303,33,406,"2016","010"
"16838","APRICA",3,6,0,9,"2016","004"
"16839","ARAMENGO",212,0,0,212,"2016","004"
"16840","ARCADE",1207,81,0,1288,"2016","002"
"16841","ARCENE",5,352,0,357,"2016","011"
"16842","ARCISATE",64,527,302,893,"2016","004"
"16843","ARCOLE",995,152,0,1147,"2016","004"
"16844","ARCONATE",21,108,0,129,"2016","007"
"16845","ARCORE",36,14,0,50,"2016",NA
"16846","ARCUGNANO",69,6,0,75,"2016","006"
"16847","ARDENNO",28,40,0,68,"2016","005"
"16848","ARDESIO",98,43,0,141,"2016","012"
"16849","ARENA PO",83,415,82,580,"2016","005"
"16850","ARESE",0,101,0,101,"2016","009"
"16851","ARGEGNO",4,0,0,4,"2016","011"
"16852","ARGELATO",88,54,0,142,"2016","002"
"16853","ARGENTA",1575,9,0,1584,"2016","001"
"16854","ARGUELLO",59,0,0,59,"2016","007"
"16855","ARIANO NEL POLESINE",585,169,0,754,"2016","002"
"16856","ARIGNANO",580,0,0,580,"2016","012"
"16857","ARLUNO",51,202,8,261,"2016","010"
"16858","ARMENO",62,71,0,133,"2016","006"
"16859","AROLA",6,0,10,16,"2016","004"
"16860","ARONA",4,0,0,4,"2016","008"
"16861","AROSIO",1,4,0,5,"2016","012"
"16862","ARQUA' PETRARCA",159,0,0,159,"2016","005"
"16863","ARQUA' POLESINE",906,4,0,910,"2016","003"
"16864","ARQUATA SCRIVIA",9,0,0,9,"2016","009"
"16865","ARRE",2,19,0,21,"2016","006"
"16866","ARSAGO SEPRIO",9,0,0,9,"2016","005"
"16867","ARSIE'",16,6,415,437,"2016","004"
"16868","ARSIERO",2,21,0,23,"2016","007"
"16869","ARTOGNE",8,382,31,421,"2016","007"
"16870","ARZAGO D'ADDA",235,873,0,1108,"2016","013"
"16871","ARZERGRANDE",380,203,1,584,"2016","007"
"16872","ARZIGNANO",223,251,0,474,"2016","008"
"16873","ASIAGO",61,1232,0,1293,"2016","009"
"16874","ASIGLIANO VENETO",58,0,0,58,"2016","010"
"16875","ASIGLIANO VERCELLESE",26,0,0,26,"2016","007"
"16876","ASOLA",8679,1687,1500,11866,"2016","002"
"16877","ASOLO",9593,578,0,10171,"2016","003"
"16878","ASSO",32,0,5,37,"2016","013"
"16879","ASTI",2462,10,0,2472,"2016","005"
"16880","AURANO",6,0,0,6,"2016","005"
"16881","AURONZO DI CADORE",10,15,0,25,"2016","005"
"16882","AVERARA",0,4,0,4,"2016","014"
"16883","AVIATICO",1,20,0,21,"2016","015"
"16884","AVIGLIANA",186,42,9,237,"2016","013"
"16885","AVOLASCA",124,0,0,124,"2016","010"
"16886","AZEGLIO",62,17,75,154,"2016","014"
"16887","AZZANELLO",2,318,0,320,"2016","004"
"16888","AZZANO MELLA",332,911,0,1243,"2016","008"
"16889","AZZANO SAN PAOLO",18,147,0,165,"2016","016"
"16890","AZZATE",18,17,0,35,"2016","006"
"16891","AZZIO",9,97,0,106,"2016","007"
"16892","AZZONE",1,1,0,2,"2016","017"
"16893","BACENO",7,20,12,39,"2016","006"
"16894","BADIA CALAVENA",1206,210,45,1461,"2016","005"
"16895","BADIA PAVESE",5,0,0,5,"2016","006"
"16896","BADIA POLESINE",164,0,0,164,"2016","004"
"16897","BAGNACAVALLO",37,0,0,37,"2016","002"
"16898","BAGNARA DI ROMAGNA",10,0,0,10,"2016","003"
"16899","BAGNARIA",13,0,0,13,"2016","007"
"16900","BAGNASCO",109,0,0,109,"2016","008"
"16901","BAGNATICA",4,136,0,140,"2016","018"
"16902","BAGNO DI ROMAGNA",886,19,0,905,"2016","001"
"16903","BAGNOLI DI SOPRA",1024,9,0,1033,"2016","008"
"16904","BAGNOLO CREMASCO",6,1651,40,1697,"2016","005"
"16905","BAGNOLO IN PIANO",0,602,0,602,"2016","002"
"16906","BAGNOLO MELLA",200,2920,404,3524,"2016","009"
"16907","BAGNOLO PIEMONTE",957,0,129,1086,"2016","009"
"16908","BAGNOLO SAN VITO",107,2549,1195,3851,"2016","003"
"16909","BAGOLINO",4,331,7,342,"2016","010"
"16910","BAIRO",68,89,0,157,"2016","015"
"16911","BAISO",18,869,0,887,"2016","003"
"16912","BALANGERO",165,95,21,281,"2016","016"
"16913","BALDICHIERI D'ASTI",47,0,0,47,"2016","007"
"16914","BALDISSERO CANAVESE",0,64,0,64,"2016","017"
"16915","BALDISSERO D'ALBA",602,0,0,602,"2016","010"
"16916","BALDISSERO TORINESE",180,0,0,180,"2016","018"
"16917","BALLABIO",27,71,0,98,"2016","004"
"16918","BALME",11,0,0,11,"2016","019"
"16919","BALOCCO",74,7,44,125,"2016","009"
"16920","BANCHETTE",3,0,0,3,"2016","020"
"16921","BANNIO ANZINO",46,0,1,47,"2016","007"
"16922","BAONE",13,0,0,13,"2016","009"
"16923","BARBANIA",29,197,73,299,"2016","021"
"16924","BARBARANO VICENTINO",264,353,0,617,"2016","011"
"16925","BARBARESCO",25,0,0,25,"2016","011"
"16926","BARBARIGA",1047,1348,0,2395,"2016","011"
"16927","BARBATA",0,834,0,834,"2016","019"
"16928","BARBIANELLO",113,3,0,116,"2016","008"
"16929","BARBONA",266,4,0,270,"2016","010"
"16930","BARDELLO",16,0,0,16,"2016","009"
"16931","BARDI",49,684,0,733,"2016","002"
"16932","BARDOLINO",24,86,0,110,"2016","006"
"16933","BARDONECCHIA",15,48,0,63,"2016","022"
"16934","BAREGGIO",42,145,43,230,"2016","012"
"16935","BARENGO",3,113,0,116,"2016","012"
"16936","BARGE",3997,1511,703,6211,"2016","012"
"16937","BARGHE",4,16,0,20,"2016","012"
"16938","BARIANO",18,352,0,370,"2016","020"
"16939","BARNI",9,5,6,20,"2016","015"
"16940","BAROLO",44,0,0,44,"2016","013"
"16941","BARONE CANAVESE",147,57,0,204,"2016","023"
"16942","BARZAGO",281,18,0,299,"2016","005"
"16943","BARZANA",2,0,0,2,"2016",NA
"16944","BARZANO'",15,0,0,15,"2016","006"
"16945","BARZIO",9,44,3,56,"2016","007"
"16946","BASALUZZO",94,0,0,94,"2016","012"
"16947","BASCAPE'",4,827,0,831,"2016","009"
"16948","BASIGLIO",0,68,0,68,"2016","015"
"16949","BASSANO BRESCIANO",26,106,0,132,"2016","013"
"16950","BASSANO DEL GRAPPA",251,180,6,437,"2016","012"
"16951","BASSIGNANA",7,0,0,7,"2016","013"
"16952","BASTIA MONDOVI'",630,0,0,630,"2016","014"
"16953","BASTIDA PANCARANA",2,0,0,2,"2016","011"
"16954","BASTIGLIA",90,0,0,90,"2016","001"
"16955","BATTAGLIA TERME",6,0,0,6,"2016","011"
"16956","BEDERO VALCUVIA",15,0,0,15,"2016","010"
"16957","BEDIZZOLE",3651,1325,7,4983,"2016","014"
"16958","BEDONIA",224,139,0,363,"2016","003"
"16959","BEDULITA",14,0,0,14,"2016","022"
"16960","BEE",4,0,0,4,"2016","009"
"16961","BEINASCO",26,0,0,26,"2016","024"
"16962","BEINETTE",740,363,15,1118,"2016","016"
"16963","BELFIORE",2303,0,0,2303,"2016","007"
"16964","BELGIOIOSO",1,106,0,107,"2016","013"
"16965","BELLAGIO",3,69,23,95,"2016","019"
"16966","BELLANO",5,0,0,5,"2016","008"
"16967","BELLARIA-IGEA MARINA",9,0,0,9,"2016","001"
"16968","BELLINO",120,0,0,120,"2016","017"
"16969","BELLINZAGO LOMBARDO",67,1313,0,1380,"2016","016"
"16970","BELLINZAGO NOVARESE",504,559,0,1063,"2016","016"
"16971","BELLUNO",669,338,95,1102,"2016","006"
"16972","BELVEDERE LANGHE",148,0,68,216,"2016","018"
"16973","BEMA",0,7,0,7,"2016","006"
"16974","BENE LARIO",1,14,52,67,"2016","021"
"16975","BENE VAGIENNA",1749,465,0,2214,"2016","019"
"16976","BENEVELLO",178,0,0,178,"2016","020"
"16977","BENNA",12,23,25,60,"2016","003"
"16978","BENTIVOGLIO",6,294,0,300,"2016","005"
"16979","BERBENNO",15,29,0,44,"2016","023"
"16980","BERBENNO DI VALTELLINA",31,144,1,176,"2016","007"
"16981","BERCETO",58,56,0,114,"2016","004"
"16982","BEREGAZZO CON FIGLIARO",12,0,0,12,"2016","022"
"16983","BEREGUARDO",9,627,76,712,"2016","014"
"16984","BERGAMASCO",60,0,0,60,"2016","015"
"16985","BERGAMO",145,133,0,278,"2016","024"
"16986","BERLINGO",3197,288,34,3519,"2016","015"
"16987","BERNAREGGIO",1,14,0,15,"2016",NA
"16988","BERNATE TICINO",33,153,0,186,"2016","019"
"16989","BERNEZZO",274,59,15,348,"2016","022"
"16990","BERRA",1722,65,0,1787,"2016","002"
"16991","BERTINORO",163,7,0,170,"2016","003"
"16992","BERTONICO",50,2684,0,2734,"2016","002"
"16993","BERZANO DI SAN PIETRO",17,0,0,17,"2016","009"
"16994","BERZO DEMO",8,59,7,74,"2016","016"
"16995","BERZO INFERIORE",7,142,1,150,"2016","017"
"16996","BERZO SAN FERMO",677,77,33,787,"2016","025"
"16997","BESANA IN BRIANZA",986,51,6,1043,"2016",NA
"16998","BESANO",14,0,10,24,"2016","011"
"16999","BESATE",181,0,0,181,"2016","022"
"17000","BESENZONE",115,1516,0,1631,"2016","003"
"17001","BESNATE",2,189,0,191,"2016","012"
"17002","BESOZZO",12,68,0,80,"2016","013"
"17003","BETTOLA",291,127,0,418,"2016","004"
"17004","BEURA-CARDEZZA",12,6,0,18,"2016","011"
"17005","BEVILACQUA",180,47,0,227,"2016","008"
"17006","BIANDRONNO",7,0,7,14,"2016","014"
"17007","BIANZANO",3,9,0,12,"2016","026"
"17008","BIANZE'",86,398,0,484,"2016","011"
"17009","BIANZONE",4,22,2,28,"2016","008"
"17010","BIASSONO",2,0,0,2,"2016",NA
"17011","BIBBIANO",11,2239,0,2250,"2016","004"
"17012","BIBIANA",535,0,0,535,"2016","025"
"17013","BIELLA",186,30,127,343,"2016","004"
"17014","BIENNO",2,86,1,89,"2016","018"
"17015","BIGARELLO",1437,252,711,2400,"2016","004"
"17016","BINAGO",37,91,74,202,"2016","023"
"17017","BIOGLIO",5,0,0,5,"2016","005"
"17018","BIONE",19,8,1,28,"2016","019"
"17019","BISTAGNO",16,0,0,16,"2016","017"
"17020","BISUSCHIO",3,0,0,3,"2016","015"
"17021","BIZZARONE",13,13,0,26,"2016","024"
"17022","BLELLO",17,29,0,46,"2016","027"
"17023","BLESSAGNO",0,0,4,4,"2016","025"
"17024","BOARA PISANI",1,0,0,1,"2016","012"
"17025","BOBBIO",130,97,0,227,"2016","005"
"17026","BOBBIO PELLICE",66,16,125,207,"2016","026"
"17027","BOCA",1,0,0,1,"2016","019"
"17028","BOCCIOLETO",5,0,0,5,"2016","014"
"17029","BOFFALORA D'ADDA",40,339,4,383,"2016","003"
"17030","BOFFALORA SOPRA TICINO",53,112,13,178,"2016","026"
"17031","BOGOGNO",1,0,0,1,"2016",NA
"17032","BOLGARE",53,302,0,355,"2016","028"
"17033","BOLLATE",2,247,3,252,"2016","027"
"17034","BOLLENGO",89,48,0,137,"2016","027"
"17035","BOLOGNA",21,28,0,49,"2016","006"
"17036","BOLTIERE",18,67,0,85,"2016","029"
"17037","BOLZANO NOVARESE",0,16,0,16,"2016","022"
"17038","BOLZANO VICENTINO",235,1230,57,1522,"2016","013"
"17039","BOMPORTO",1240,104,0,1344,"2016","002"
"17040","BONATE SOPRA",244,0,0,244,"2016","030"
"17041","BONATE SOTTO",68,0,0,68,"2016","031"
"17042","BONAVIGO",3128,31,61,3220,"2016","009"
"17043","BONDENO",554,354,0,908,"2016","003"
"17044","BONEMERSE",24,153,0,177,"2016","006"
"17045","BORCA DI CADORE",1,0,0,1,"2016",NA
"17046","BORDOLANO",20,502,0,522,"2016","007"
"17047","BORE",49,9,0,58,"2016","005"
"17048","BORETTO",0,284,0,284,"2016","005"
"17049","BORGARELLO",0,0,1,1,"2016","015"
"17050","BORGARO TORINESE",59,85,0,144,"2016","028"
"17051","BORGHETTO DI BORBERA",80,0,2,82,"2016","018"
"17052","BORGHETTO LODIGIANO",12,1633,31,1676,"2016","004"
"17053","BORGHI",1460,0,0,1460,"2016","004"
"17054","BORGIALLO",2,26,0,28,"2016","029"
"17055","BORGO D'ALE",217,0,0,217,"2016","015"
"17056","BORGO DI TERZO",4,0,0,4,"2016","032"
"17057","BORGO PRIOLO",4,0,0,4,"2016","016"
"17058","BORGO SAN DALMAZZO",463,0,77,540,"2016","025"
"17059","BORGO SAN GIACOMO",1672,3897,9,5578,"2016","020"
"17060","BORGO SAN GIOVANNI",8,887,0,895,"2016","005"
"17061","BORGO SAN SIRO",2,719,0,721,"2016","018"
"17062","BORGO TICINO",19,0,0,19,"2016","025"
"17063","BORGO TOSSIGNANO",9,0,0,9,"2016","007"
"17064","BORGO VAL DI TARO",126,238,0,364,"2016","006"
"17065","BORGO VERCELLI",2,0,0,2,"2016","017"
"17066","BORGO VIRGILIO",64,3900,1964,5928,"2016",NA
"17067","BORGOFRANCO D'IVREA",161,18,0,179,"2016","030"
"17068","BORGOFRANCO SUL PO",1,18,51,70,"2016","006"
"17069","BORGOLAVEZZARO",2,0,0,2,"2016","023"
"17070","BORGOMALE",34,0,0,34,"2016","024"
"17071","BORGOMANERO",99,28,0,127,"2016","024"
"17072","BORGOMASINO",88,0,0,88,"2016","031"
"17073","BORGOMEZZAVALLE",2,0,0,2,"2016",NA
"17074","BORGONE SUSA",28,29,0,57,"2016","032"
"17075","BORGONOVO VAL TIDONE",648,2135,0,2783,"2016","006"
"17076","BORGORATTO ALESSANDRINO",15,0,0,15,"2016","019"
"17077","BORGORATTO MORMOROLO",12,0,0,12,"2016","017"
"17078","BORGORICCO",75,34,0,109,"2016","013"
"17079","BORGOSATOLLO",2,602,11,615,"2016","021"
"17080","BORGOSESIA",71,36,0,107,"2016","016"
"17081","BORMIO",15,395,14,424,"2016","009"
"17082","BORNASCO",140,474,16,630,"2016","019"
"17083","BORNO",1,112,58,171,"2016","022"
"17084","BORRIANA",70,43,33,146,"2016","006"
"17085","BORSO DEL GRAPPA",136,175,7,318,"2016","004"
"17086","BOSARO",1,0,0,1,"2016","007"
"17087","BOSCHI SANT'ANNA",2,0,59,61,"2016","010"
"17088","BOSCO CHIESANUOVA",291,1414,0,1705,"2016","011"
"17089","BOSCO MARENGO",50,27,0,77,"2016","021"
"17090","BOSCONERO",73,28,0,101,"2016","033"
"17091","BOSIA",424,0,0,424,"2016","026"
"17092","BOSIO",32,0,5,37,"2016","022"
"17093","BOSISIO PARINI",4,131,1,136,"2016","009"
"17094","BOSSICO",32,77,0,109,"2016","033"
"17095","BOSSOLASCO",66,85,0,151,"2016","027"
"17096","BOTTANUCO",14,234,369,617,"2016","034"
"17097","BOTTICINO",36,0,0,36,"2016","023"
"17098","BOVEGNO",49,78,59,186,"2016","024"
"17099","BOVES",779,739,132,1650,"2016","028"
"17100","BOVEZZO",1,0,0,1,"2016","025"
"17101","BOVOLENTA",3568,311,0,3879,"2016","014"
"17102","BOVOLONE",3285,281,0,3566,"2016","012"
"17103","BOZZOLO",59,1127,9,1195,"2016","007"
"17104","BRA",3475,1386,159,5020,"2016","029"
"17105","BRACCA",5,0,0,5,"2016","035"
"17106","BRALLO DI PREGOLA",26,19,0,45,"2016","021"
"17107","BRANDICO",1,574,0,575,"2016","026"
"17108","BRANDIZZO",0,0,89,89,"2016","034"
"17109","BRANZI",1,35,6,42,"2016","036"
"17110","BRAONE",0,36,0,36,"2016","027"
"17111","BREBBIA",24,0,2,26,"2016","017"
"17112","BREDA DI PIAVE",48,413,3,464,"2016","005"
"17113","BREGANO",2,0,0,2,"2016","018"
"17114","BREGANZE",445,773,183,1401,"2016","014"
"17115","BREGNANO",5,92,0,97,"2016","028"
"17116","BREIA",3,0,0,3,"2016","019"
"17117","BREMBATE",91,0,211,302,"2016","037"
"17118","BREMBATE DI SOPRA",1,264,0,265,"2016","038"
"17119","BREMBIO",165,1718,112,1995,"2016","006"
"17120","BREME",22,0,0,22,"2016","022"
"17121","BRENDOLA",275,102,4,381,"2016","015"
"17122","BRENNA",3,0,0,3,"2016","029"
"17123","BRENO",13,263,8,284,"2016","028"
"17124","BRENTA",4,0,0,4,"2016","019"
"17125","BRENTINO BELLUNO",2,0,0,2,"2016","013"
"17126","BRENZONE",5,0,0,5,"2016","014"
"17127","BRESCELLO",0,40,0,40,"2016","006"
"17128","BRESCIA",77,609,0,686,"2016","029"
"17129","BRESSANA BOTTARONE",2,0,0,2,"2016","023"
"17130","BRESSANVIDO",49,1350,2,1401,"2016","016"
"17131","BRESSO",8,0,0,8,"2016",NA
"17132","BREZZO DI BEDERO",2,0,0,2,"2016","020"
"17133","BRIAGLIA",56,0,0,56,"2016","030"
"17134","BRICHERASIO",1071,71,18,1160,"2016","035"
"17135","BRIGA NOVARESE",11,68,0,79,"2016","026"
"17136","BRIGNANO GERA D'ADDA",222,1661,0,1883,"2016","040"
"17137","BRIGNANO-FRASCATA",6,0,0,6,"2016","024"
"17138","BRINZIO",7,0,0,7,"2016","021"
"17139","BRIONA",8,1662,0,1670,"2016","027"
"17140","BRIONE",8,0,0,8,"2016","030"
"17141","BRIOSCO",11,0,0,11,"2016",NA
"17142","BRISIGHELLA",338,73,0,411,"2016","004"
"17143","BRISSAGO-VALTRAVAGLIA",5,0,0,5,"2016","022"
"17144","BRIVIO",39,78,0,117,"2016","010"
"17145","BROGLIANO",62,33,0,95,"2016","017"
"17146","BRONDELLO",4,0,0,4,"2016","032"
"17147","BRONI",106,0,0,106,"2016","024"
"17148","BROSSASCO",71,0,0,71,"2016","033"
"17149","BROSSO",28,18,10,56,"2016","036"
"17150","BROVELLO-CARPUGNINO",19,0,9,28,"2016","013"
"17151","BROZOLO",46,0,0,46,"2016","037"
"17152","BRUGHERIO",7,311,0,318,"2016",NA
"17153","BRUGINE",4097,102,48,4247,"2016","015"
"17154","BRUINO",121,0,0,121,"2016","038"
"17155","BRUMANO",13,16,0,29,"2016","041"
"17156","BRUNELLO",17,0,0,17,"2016","023"
"17157","BRUNO",10,0,0,10,"2016","010"
"17158","BRUSAPORTO",40,0,35,75,"2016","042"
"17159","BRUSASCO",108,0,0,108,"2016","039"
"17160","BRUSNENGO",15,0,0,15,"2016","007"
"17161","BRUZOLO",91,22,4,117,"2016","040"
"17162","BUBBIANO",3,28,0,31,"2016","035"
"17163","BUBBIO",65,0,0,65,"2016","011"
"17164","BUCCINASCO",16,423,0,439,"2016","036"
"17165","BUDRIO",245,328,0,573,"2016","008"
"17166","BUGLIO IN MONTE",28,198,34,260,"2016","010"
"17167","BUGUGGIATE",5,0,0,5,"2016","025"
"17168","BULCIAGO",10,0,182,192,"2016","011"
"17169","BULGAROGRASSO",43,341,0,384,"2016","034"
"17170","BURIASCO",1171,758,186,2115,"2016","041"
"17171","BUROLO",11,0,0,11,"2016","042"
"17172","BURONZO",1,15,0,16,"2016","021"
"17173","BUSANO",19,52,0,71,"2016","043"
"17174","BUSCA",4556,1420,456,6432,"2016","034"
"17175","BUSCATE",90,0,0,90,"2016","038"
"17176","BUSNAGO",18,2,0,20,"2016",NA
"17177","BUSSERO",0,543,0,543,"2016","040"
"17178","BUSSETO",17,3689,0,3706,"2016","007"
"17179","BUSSOLENGO",548,140,104,792,"2016","015"
"17180","BUSSOLENO",36,248,0,284,"2016","044"
"17181","BUSTO ARSIZIO",8,211,51,270,"2016","026"
"17182","BUSTO GAROLFO",93,208,9,310,"2016","041"
"17183","BUTTAPIETRA",3,153,0,156,"2016","016"
"17184","BUTTIGLIERA ALTA",91,49,0,140,"2016","045"
"17185","BUTTIGLIERA D'ASTI",1720,101,74,1895,"2016","012"
"17186","CA' D'ANDREA",3,1377,0,1380,"2016","008"
"17187","CABELLA LIGURE",102,0,0,102,"2016","025"
"17188","CADEGLIANO-VICONAGO",7,0,0,7,"2016","027"
"17189","CADELBOSCO DI SOPRA",9,1635,0,1644,"2016","008"
"17190","CADEO",84,2755,0,2839,"2016","007"
"17191","CADONEGHE",12,0,12,24,"2016","016"
"17192","CADORAGO",11,0,71,82,"2016","036"
"17193","CADREZZATE",5,0,0,5,"2016","028"
"17194","CAERANO DI SAN MARCO",197,86,38,321,"2016","006"
"17195","CAFASSE",68,34,0,102,"2016","046"
"17196","CAGLIO",26,0,0,26,"2016","037"
"17197","CAGNO",0,42,0,42,"2016","038"
"17198","CAINO",5,0,0,5,"2016","031"
"17199","CAIOLO",2,112,0,114,"2016","011"
"17200","CAIRATE",3,0,0,3,"2016","029"
"17201","CALAMANDRANA",89,0,0,89,"2016","013"
"17202","CALASCA-CASTIGLIONE",20,0,0,20,"2016","014"
"17203","CALCINATE",313,247,0,560,"2016","043"
"17204","CALCINATO",3184,1530,1659,6373,"2016","032"
"17205","CALCIO",206,1355,0,1561,"2016","044"
"17206","CALCO",18,190,0,208,"2016","012"
"17207","CALDERARA DI RENO",46,60,0,106,"2016","009"
"17208","CALDIERO",1,0,0,1,"2016","017"
"17209","CALDOGNO",175,368,9,552,"2016","018"
"17210","CALENDASCO",161,390,0,551,"2016","008"
"17211","CALESTANO",19,411,0,430,"2016","008"
"17212","CALLABIANA",14,0,0,14,"2016","008"
"17213","CALLIANO",222,0,0,222,"2016","014"
"17214","CALOLZIOCORTE",12,0,16,28,"2016","013"
"17215","CALOSSO",10,0,0,10,"2016","015"
"17216","CALTIGNAGA",1022,275,0,1297,"2016","030"
"17217","CALTO",21,0,0,21,"2016","008"
"17218","CALTRANO",2065,0,0,2065,"2016","019"
"17219","CALUSCO D'ADDA",7,0,0,7,"2016","046"
"17220","CALUSO",886,172,0,1058,"2016","047"
"17221","CALVAGESE DELLA RIVIERA",90,201,20,311,"2016","033"
"17222","CALVATONE",21,119,0,140,"2016","009"
"17223","CALVENE",10,51,0,61,"2016","020"
"17224","CALVENZANO",30,487,0,517,"2016","047"
"17225","CALVIGNASCO",1,34,0,35,"2016","042"
"17226","CALVISANO",14696,4433,116,19245,"2016","034"
"17227","CAMAGNA MONFERRATO",24,0,0,24,"2016","026"
"17228","CAMAIRAGO",0,1376,0,1376,"2016","007"
"17229","CAMANDONA",8,0,0,8,"2016","009"
"17230","CAMBIAGO",16,89,0,105,"2016","044"
"17231","CAMBIANO",377,0,0,377,"2016","048"
"17232","CAMBIASCA",10,0,0,10,"2016","015"
"17233","CAMBURZANO",104,0,10,114,"2016","010"
"17234","CAMERANA",292,0,0,292,"2016","035"
"17235","CAMERANO CASASCO",22,0,0,22,"2016","016"
"17236","CAMERATA CORNELLO",6,80,0,86,"2016","048"
"17237","CAMERI",93,595,0,688,"2016","032"
"17238","CAMINATA",27,0,0,27,"2016","009"
"17239","CAMISANO",288,2598,227,3113,"2016","010"
"17240","CAMISANO VICENTINO",334,1630,8,1972,"2016","021"
"17241","CAMPAGNA LUPIA",112,95,0,207,"2016","002"
"17242","CAMPAGNOLA CREMASCA",61,499,88,648,"2016","011"
"17243","CAMPAGNOLA EMILIA",11,735,0,746,"2016","009"
"17244","CAMPEGINE",2,1111,0,1113,"2016","010"
"17245","CAMPERTOGNO",122,47,0,169,"2016","025"
"17246","CAMPIGLIA CERVO",3,0,9,12,"2016","011"
"17247","CAMPIGLIA DEI BERICI",710,117,2,829,"2016","022"
"17248","CAMPIGLIONE-FENILE",622,5,83,710,"2016","049"
"17249","CAMPO SAN MARTINO",268,79,0,347,"2016","020"
"17250","CAMPODARSEGO",608,54,1,663,"2016","017"
"17251","CAMPODORO",76,243,0,319,"2016","018"
"17252","CAMPOGALLIANO",1,594,0,595,"2016","003"
"17253","CAMPOLONGO MAGGIORE",35,66,0,101,"2016","003"
"17254","CAMPOLONGO SUL BRENTA",19,0,0,19,"2016","023"
"17255","CAMPONOGARA",166,43,0,209,"2016","004"
"17256","CAMPOSAMPIERO",162,70,0,232,"2016","019"
"17257","CAMUGNANO",262,127,0,389,"2016","010"
"17258","CANALE",662,0,0,662,"2016","037"
"17259","CANARO",208,33,0,241,"2016","009"
"17260","CANDA",20,0,0,20,"2016","010"
"17261","CANDELO",12,84,75,171,"2016","012"
"17262","CANDIA CANAVESE",25,0,0,25,"2016","050"
"17263","CANDIANA",10544,202,0,10746,"2016","021"
"17264","CANDIOLO",484,122,164,770,"2016","051"
"17265","CANELLI",14,0,0,14,"2016","017"
"17266","CANEVINO",36,0,0,36,"2016","028"
"17267","CANISCHIO",5,22,0,27,"2016","052"
"17268","CANNERO RIVIERA",1,0,0,1,"2016","016"
"17269","CANNETO SULL'OGLIO",1432,1504,1188,4124,"2016","008"
"17270","CANNOBIO",12,0,0,12,"2016","017"
"17271","CANONICA D'ADDA",23,379,0,402,"2016","049"
"17272","CANOSIO",13,0,63,76,"2016","038"
"17273","CANOSSA",34,273,0,307,"2016","018"
"17274","CANTALUPA",44,0,0,44,"2016","053"
"17275","CANTALUPO LIGURE",12,0,0,12,"2016","028"
"17276","CANTARANA",96,0,0,96,"2016","018"
"17277","CANTELLO",138,177,0,315,"2016","030"
"17278","CANTOIRA",55,0,24,79,"2016","054"
"17279","CANTU'",252,249,19,520,"2016","041"
"17280","CANZO",8,0,8,16,"2016","042"
"17281","CAORLE",669,80,0,749,"2016","005"
"17282","CAORSO",3,489,0,492,"2016","010"
"17283","CAPERGNANICA",180,1094,0,1274,"2016","012"
"17284","CAPIAGO INTIMIANO",1,30,1,32,"2016","043"
"17285","CAPIZZONE",33,25,0,58,"2016","050"
"17286","CAPO DI PONTE",19,180,9,208,"2016","035"
"17287","CAPONAGO",100,0,0,100,"2016",NA
"17288","CAPOVALLE",15,0,7,22,"2016","036"
"17289","CAPPELLA CANTONE",0,413,0,413,"2016","013"
"17290","CAPPELLA DE' PICENARDI",2,415,0,417,"2016","014"
"17291","CAPPELLA MAGGIORE",15,21,1,37,"2016","007"
"17292","CAPRALBA",0,1404,0,1404,"2016","015"
"17293","CAPRAUNA",3,0,0,3,"2016","039"
"17294","CAPRIANO DEL COLLE",16,355,0,371,"2016","037"
"17295","CAPRIATA D'ORBA",25,0,0,25,"2016","029"
"17296","CAPRIATE SAN GERVASIO",1,0,0,1,"2016",NA
"17297","CAPRIE",28,0,0,28,"2016","055"
"17298","CAPRIGLIO",2,0,0,2,"2016","019"
"17299","CAPRILE",30,2,0,32,"2016","013"
"17300","CAPRINO BERGAMASCO",18,24,0,42,"2016","052"
"17301","CAPRINO VERONESE",97,677,87,861,"2016","018"
"17302","CAPRIOLO",249,43,43,335,"2016","038"
"17303","CARAGLIO",3426,809,357,4592,"2016","040"
"17304","CARAMAGNA PIEMONTE",1285,681,65,2031,"2016","041"
"17305","CARATE BRIANZA",28,0,0,28,"2016",NA
"17306","CARAVAGGIO",529,2910,58,3497,"2016","053"
"17307","CARAVATE",6,133,0,139,"2016","031"
"17308","CARBONARA AL TICINO",0,289,0,289,"2016","030"
"17309","CARBONARA DI PO",0,311,241,552,"2016","009"
"17310","CARBONARA SCRIVIA",29,0,0,29,"2016","030"
"17311","CARBONATE",164,52,12,228,"2016","045"
"17312","CARBONERA",61,298,0,359,"2016","008"
"17313","CARCERI",1032,0,0,1032,"2016","022"
"17314","CARCOFORO",0,0,9,9,"2016","029"
"17315","CARDANO AL CAMPO",9,0,0,9,"2016","032"
"17316","CARDE'",2712,1896,26,4634,"2016","042"
"17317","CAREMA",90,5,0,95,"2016","057"
"17318","CARENNO",28,0,3,31,"2016","014"
"17319","CARENTINO",89,638,0,727,"2016","031"
"17320","CARESANA",1,0,0,1,"2016","030"
"17321","CAREZZANO",2,0,0,2,"2016","032"
"17322","CARIGNANO",2609,1646,274,4529,"2016","058"
"17323","CARISIO",28,0,0,28,"2016","032"
"17324","CARLAZZO",19,52,41,112,"2016","047"
"17325","CARMAGNOLA",6521,3113,0,9634,"2016","059"
"17326","CARMIGNANO DI BRENTA",330,1419,0,1749,"2016","023"
"17327","CARNAGO",16,57,0,73,"2016","033"
"17328","CAROBBIO DEGLI ANGELI",98,32,0,130,"2016","055"
"17329","CARONNO PERTUSELLA",3,0,0,3,"2016","034"
"17330","CARONNO VARESINO",40,0,0,40,"2016","035"
"17331","CARPANETO PIACENTINO",96,4358,0,4454,"2016","011"
"17332","CARPENEDOLO",1624,4384,2,6010,"2016","039"
"17333","CARPENETO",125,0,0,125,"2016","033"
"17334","CARPI",11,1942,0,1953,"2016","005"
"17335","CARPIANO",127,1365,231,1723,"2016","050"
"17336","CARPIGNANO SESIA",147,0,0,147,"2016","036"
"17337","CARPINETI",109,1516,0,1625,"2016","011"
"17338","CARRE'",429,116,0,545,"2016","024"
"17339","CARREGA LIGURE",41,0,0,41,"2016","034"
"17340","CARRU'",690,45,86,821,"2016","043"
"17341","CARTIGLIANO",20,36,0,56,"2016","025"
"17342","CARTIGNANO",176,61,0,237,"2016","044"
"17343","CARTOSIO",51,0,0,51,"2016","036"
"17344","CARTURA",411,33,0,444,"2016","026"
"17345","CARUGATE",0,116,0,116,"2016","051"
"17346","CARUGO",6,0,0,6,"2016","048"
"17347","CARVICO",6,0,0,6,"2016","057"
"17348","CASAL CERMELLI",2,0,0,2,"2016","037"
"17349","CASALBELTRAME",1,0,152,153,"2016","037"
"17350","CASALBORGONE",50,0,0,50,"2016","060"
"17351","CASALBUTTANO ED UNITI",7,1282,0,1289,"2016","016"
"17352","CASALE CORTE CERRO",9,0,0,9,"2016","019"
"17353","CASALE CREMASCO-VIDOLASCO",0,1848,0,1848,"2016","017"
"17354","CASALE DI SCODOSIA",647,0,0,647,"2016","027"
"17355","CASALE LITTA",25,164,8,197,"2016","036"
"17356","CASALE MONFERRATO",122,179,0,301,"2016","039"
"17357","CASALE SUL SILE",399,103,12,514,"2016","009"
"17358","CASALEGGIO BOIRO",1,0,0,1,"2016","038"
"17359","CASALEONE",14,0,0,14,"2016","019"
"17360","CASALETTO CEREDANO",14,11,0,25,"2016","018"
"17361","CASALETTO DI SOPRA",18,304,0,322,"2016","019"
"17362","CASALETTO LODIGIANO",12,400,18,430,"2016","008"
"17363","CASALETTO VAPRIO",159,669,0,828,"2016","020"
"17364","CASALFIUMANESE",317,148,0,465,"2016","012"
"17365","CASALGRANDE",31,1119,0,1150,"2016","012"
"17366","CASALGRASSO",295,292,0,587,"2016","045"
"17367","CASALINO",2,265,0,267,"2016","040"
"17368","CASALMAGGIORE",17,704,0,721,"2016","021"
"17369","CASALMAIOCCO",21,575,0,596,"2016","009"
"17370","CASALMORANO",100,2231,0,2331,"2016","022"
"17371","CASALMORO",646,0,555,1201,"2016","010"
"17372","CASALNOCETO",26,0,0,26,"2016","040"
"17373","CASALOLDO",895,1210,962,3067,"2016","011"
"17374","CASALPUSTERLENGO",339,1263,0,1602,"2016","010"
"17375","CASALROMANO",293,276,214,783,"2016","012"
"17376","CASALSERUGO",91,11,57,159,"2016","028"
"17377","CASALVOLONE",18,62,0,80,"2016","041"
"17378","CASALZUIGNO",0,112,0,112,"2016","037"
"17379","CASARGO",5,24,0,29,"2016","015"
"17380","CASARILE",21,17,0,38,"2016","055"
"17381","CASATENOVO",376,28,0,404,"2016","016"
"17382","CASAZZA",8,5,1,14,"2016","058"
"17383","CASCIAGO",21,0,33,54,"2016","038"
"17384","CASEI GEROLA",523,0,0,523,"2016","033"
"17385","CASELETTE",95,319,42,456,"2016","062"
"17386","CASELLE LANDI",239,490,0,729,"2016","011"
"17387","CASELLE LURANI",76,277,0,353,"2016","012"
"17388","CASELLE TORINESE",362,1352,29,1743,"2016","063"
"17389","CASIER",18,108,0,126,"2016","010"
"17390","CASINA",69,995,0,1064,"2016","013"
"17391","CASIRATE D'ADDA",178,359,0,537,"2016","059"
"17392","CASLINO D'ERBA",0,0,16,16,"2016","052"
"17393","CASNATE CON BERNATE",19,0,0,19,"2016","053"
"17394","CASNIGO",49,157,0,206,"2016","060"
"17395","CASOLA VALSENIO",153,86,0,239,"2016","005"
"17396","CASORATE PRIMO",11,125,0,136,"2016","034"
"17397","CASOREZZO",0,138,0,138,"2016","058"
"17398","CASORZO",2,0,0,2,"2016","020"
"17399","CASPOGGIO",1,36,0,37,"2016","013"
"17400","CASSAGO BRIANZA",4,44,2,50,"2016","017"
"17401","CASSANO D'ADDA",153,227,0,380,"2016","059"
"17402","CASSANO MAGNAGO",13,170,19,202,"2016","040"
"17403","CASSANO SPINOLA",320,0,0,320,"2016","042"
"17404","CASSANO VALCUVIA",3,0,0,3,"2016","041"
"17405","CASSINA DE' PECCHI",0,338,0,338,"2016","060"
"17406","CASSINA VALSASSINA",3,43,0,46,"2016","018"
"17407","CASSINASCO",29,21,0,50,"2016","021"
"17408","CASSINE",197,0,0,197,"2016","043"
"17409","CASSINELLE",5,0,0,5,"2016","044"
"17410","CASSINETTA DI LUGAGNANO",6,216,0,222,"2016","061"
"17411","CASSOLA",633,29,0,662,"2016","026"
"17412","CASSOLNOVO",16,42,0,58,"2016","035"
"17413","CASTAGNARO",134,0,0,134,"2016","020"
"17414","CASTAGNETO PO",65,0,0,65,"2016","064"
"17415","CASTAGNITO",179,0,0,179,"2016","046"
"17416","CASTAGNOLE DELLE LANZE",223,0,0,223,"2016","022"
"17417","CASTAGNOLE MONFERRATO",59,0,0,59,"2016","023"
"17418","CASTAGNOLE PIEMONTE",1423,818,59,2300,"2016","065"
"17419","CASTANA",1,0,0,1,"2016","036"
"17420","CASTANO PRIMO",72,0,0,72,"2016","062"
"17421","CASTEGGIO",51,0,0,51,"2016","037"
"17422","CASTEGNATO",20,1096,38,1154,"2016","040"
"17423","CASTEGNERO",109,38,0,147,"2016","027"
"17424","CASTEL BOGLIONE",40,0,0,40,"2016","024"
"17425","CASTEL BOLOGNESE",27,0,0,27,"2016","006"
"17426","CASTEL D'AIANO",30,521,37,588,"2016","013"
"17427","CASTEL D'ARIO",0,100,564,664,"2016","014"
"17428","CASTEL D'AZZANO",1716,147,0,1863,"2016","021"
"17429","CASTEL DEL RIO",4,14,0,18,"2016","014"
"17430","CASTEL DI CASIO",58,19,0,77,"2016","015"
"17431","CASTEL GABBIANO",0,1724,0,1724,"2016","024"
"17432","CASTEL GOFFREDO",1793,637,568,2998,"2016","015"
"17433","CASTEL GUELFO DI BOLOGNA",90,264,0,354,"2016","016"
"17434","CASTEL MAGGIORE",1,0,0,1,"2016","019"
"17435","CASTEL MELLA",2,379,0,381,"2016","042"
"17436","CASTEL ROCCHERO",14,0,0,14,"2016","032"
"17437","CASTEL ROZZONE",4,35,0,39,"2016","063"
"17438","CASTEL SAN GIOVANNI",128,816,0,944,"2016","013"
"17439","CASTEL SAN PIETRO TERME",392,288,0,680,"2016","020"
"17440","CASTELBELFORTE",1564,59,63,1686,"2016","013"
"17441","CASTELCOVATI",6,328,0,334,"2016","041"
"17442","CASTELCUCCO",53,133,71,257,"2016","011"
"17443","CASTELDELCI",199,0,0,199,"2016","021"
"17444","CASTELDELFINO",70,0,0,70,"2016","047"
"17445","CASTELDIDONE",56,0,0,56,"2016","023"
"17446","CASTELFRANCO EMILIA",1075,2834,0,3909,"2016","006"
"17447","CASTELFRANCO VENETO",4972,193,11,5176,"2016","012"
"17448","CASTELGOMBERTO",409,427,0,836,"2016","028"
"17449","CASTELGUGLIELMO",501,0,0,501,"2016","011"
"17450","CASTELL'ALFERO",404,0,0,404,"2016","025"
"17451","CASTELL'ARQUATO",50,712,0,762,"2016","012"
"17452","CASTELLAMONTE",400,268,0,668,"2016","066"
"17453","CASTELLANIA",3,0,0,3,"2016",NA
"17454","CASTELLAR",6,0,0,6,"2016","048"
"17455","CASTELLARANO",31,285,0,316,"2016","014"
"17456","CASTELLAZZO BORMIDA",119,4,0,123,"2016","047"
"17457","CASTELLAZZO NOVARESE",2,0,0,2,"2016","042"
"17458","CASTELLEONE",751,3728,0,4479,"2016","025"
"17459","CASTELLETTO CERVO",17,34,0,51,"2016","015"
"17460","CASTELLETTO D'ORBA",14,0,0,14,"2016","049"
"17461","CASTELLETTO DI BRANDUZZO",11,0,0,11,"2016","038"
"17462","CASTELLETTO MERLI",54,0,0,54,"2016","050"
"17463","CASTELLETTO MONFERRATO",187,0,0,187,"2016","051"
"17464","CASTELLETTO SOPRA TICINO",107,52,0,159,"2016","043"
"17465","CASTELLETTO STURA",1272,52,96,1420,"2016","049"
"17466","CASTELLETTO UZZONE",9,0,0,9,"2016","050"
"17467","CASTELLI CALEPIO",40,269,0,309,"2016","062"
"17468","CASTELLINALDO D'ALBA",835,0,0,835,"2016",NA
"17469","CASTELLINO TANARO",192,0,0,192,"2016","052"
"17470","CASTELLO CABIAGLIO",13,0,0,13,"2016","043"
"17471","CASTELLO D'ARGILE",44,59,0,103,"2016","017"
"17472","CASTELLO DELL'ACQUA",20,8,0,28,"2016","014"
"17473","CASTELLO DI ANNONE",129,0,0,129,"2016","028"
"17474","CASTELLO DI BRIANZA",13,0,0,13,"2016","019"
"17475","CASTELLO DI GODEGO",4779,144,3,4926,"2016","013"
"17476","CASTELLUCCHIO",893,1451,1784,4128,"2016","016"
"17477","CASTELMAGNO",64,11,12,87,"2016","053"
"17478","CASTELMARTE",12,0,2,14,"2016","058"
"17479","CASTELMASSA",3,117,0,120,"2016","012"
"17480","CASTELNOVO BARIANO",1005,44,0,1049,"2016","013"
"17481","CASTELNOVO DI SOTTO",4,1048,0,1052,"2016","015"
"17482","CASTELNOVO NE' MONTI",76,1642,0,1718,"2016","016"
"17483","CASTELNUOVO BELBO",10,0,0,10,"2016","029"
"17484","CASTELNUOVO BOCCA D'ADDA",3086,258,0,3344,"2016","013"
"17485","CASTELNUOVO BORMIDA",10,0,0,10,"2016","052"
"17486","CASTELNUOVO BOZZENTE",3,19,0,22,"2016","059"
"17487","CASTELNUOVO CALCEA",10,0,0,10,"2016","030"
"17488","CASTELNUOVO DEL GARDA",3197,251,18,3466,"2016","022"
"17489","CASTELNUOVO DON BOSCO",193,0,0,193,"2016","031"
"17490","CASTELNUOVO NIGRA",54,0,0,54,"2016","067"
"17491","CASTELNUOVO RANGONE",10,739,0,749,"2016","007"
"17492","CASTELNUOVO SCRIVIA",129,0,15,144,"2016","053"
"17493","CASTELSEPRIO",1,0,2,3,"2016","044"
"17494","CASTELSPINA",10,0,0,10,"2016","054"
"17495","CASTELVECCANA",7,0,0,7,"2016","045"
"17496","CASTELVERDE",85,3365,116,3566,"2016","026"
"17497","CASTELVETRO DI MODENA",23,1266,0,1289,"2016","008"
"17498","CASTELVETRO PIACENTINO",665,1089,0,1754,"2016","014"
"17499","CASTELVISCONTI",16,1663,0,1679,"2016","027"
"17500","CASTENASO",46,223,0,269,"2016","021"
"17501","CASTENEDOLO",831,1651,0,2482,"2016","043"
"17502","CASTIGLIONE D'ADDA",5,411,0,416,"2016","014"
"17503","CASTIGLIONE D'INTELVI",4,11,6,21,"2016","060"
"17504","CASTIGLIONE DEI PEPOLI",114,97,0,211,"2016","022"
"17505","CASTIGLIONE DELLE STIVIERE",3647,1749,1152,6548,"2016","017"
"17506","CASTIGLIONE FALLETTO",29,0,0,29,"2016","055"
"17507","CASTIGLIONE OLONA",3,0,10,13,"2016","046"
"17508","CASTIGLIONE TINELLA",34,0,0,34,"2016","056"
"17509","CASTIGLIONE TORINESE",18,0,0,18,"2016","068"
"17510","CASTINO",137,0,0,137,"2016","057"
"17511","CASTIONE ANDEVENNO",18,37,2,57,"2016","015"
"17512","CASTIONE DELLA PRESOLANA",47,6,0,53,"2016","064"
"17513","CASTIRAGA VIDARDO",4,299,0,303,"2016","015"
"17514","CASTO",30,37,0,67,"2016","044"
"17515","CASTREZZATO",385,1129,68,1582,"2016","045"
"17516","CASTROCARO TERME E TERRA DEL SOLE",14,1,2,17,"2016","005"
"17517","CASTRONNO",3,0,0,3,"2016","047"
"17518","CAVACURTA",117,522,1,640,"2016","016"
"17519","CAVAGLIA'",1234,202,0,1436,"2016","016"
"17520","CAVAGLIETTO",7,194,0,201,"2016","044"
"17521","CAVAGNOLO",28,0,0,28,"2016","069"
"17522","CAVAION VERONESE",12,0,0,12,"2016","023"
"17523","CAVALLASCA",0,0,6,6,"2016","061"
"17524","CAVALLERLEONE",363,1228,70,1661,"2016","058"
"17525","CAVALLERMAGGIORE",1906,2350,39,4295,"2016","059"
"17526","CAVALLINO-TREPORTI",15,0,0,15,"2016","044"
"17527","CAVALLIRIO",2,0,0,2,"2016","047"
"17528","CAVARGNA",0,0,12,12,"2016","062"
"17529","CAVARIA CON PREMEZZO",2,0,0,2,"2016","048"
"17530","CAVARZERE",5631,0,4,5635,"2016","006"
"17531","CAVASO DEL TOMBA",91,69,0,160,"2016","014"
"17532","CAVENAGO D'ADDA",15,806,188,1009,"2016","017"
"17533","CAVERNAGO",1,0,0,1,"2016","066"
"17534","CAVEZZO",0,359,0,359,"2016","009"
"17535","CAVOUR",3452,390,837,4679,"2016","070"
"17536","CAVRIAGO",19,648,0,667,"2016","017"
"17537","CAVRIANA",2116,1473,440,4029,"2016","018"
"17538","CAZZAGO SAN MARTINO",4530,235,149,4914,"2016","046"
"17539","CAZZANO DI TRAMIGNA",4,0,0,4,"2016","024"
"17540","CAZZANO SANT'ANDREA",267,0,0,267,"2016","067"
"17541","CECIMA",12,0,0,12,"2016","042"
"17542","CEDEGOLO",0,13,4,17,"2016","047"
"17543","CEDRASCO",0,39,0,39,"2016","016"
"17544","CEGGIA",12,2,0,14,"2016","007"
"17545","CELLA DATI",714,127,19,860,"2016","028"
"17546","CELLA MONTE",126,0,0,126,"2016","056"
"17547","CELLARENGO",269,75,113,457,"2016","033"
"17548","CELLATICA",2,60,6,68,"2016","048"
"17549","CELLE DI MACRA",125,0,13,138,"2016","060"
"17550","CELLE ENOMONDO",195,0,0,195,"2016","034"
"17551","CELLIO",13,0,0,13,"2016","038"
"17552","CENATE SOPRA",5,0,8,13,"2016","068"
"17553","CENATE SOTTO",17,0,0,17,"2016","069"
"17554","CENCENIGHE AGORDINO",0,5,0,5,"2016","010"
"17555","CENE",46,51,0,97,"2016","070"
"17556","CENESELLI",0,220,19,239,"2016","014"
"17557","CENTALLO",5482,634,376,6492,"2016","061"
"17558","CENTO",1,0,0,1,"2016","004"
"17559","CEPPO MORELLI",24,0,0,24,"2016","021"
"17560","CERANO",66,0,0,66,"2016","049"
"17561","CERANO D'INTELVI",8,0,33,41,"2016","063"
"17562","CERANOVA",0,612,0,612,"2016","043"
"17563","CERCENASCO",144,241,0,385,"2016","071"
"17564","CERCINO",16,52,0,68,"2016","017"
"17565","CEREA",987,212,0,1199,"2016","025"
"17566","CERES",11,0,0,11,"2016","072"
"17567","CERESARA",1519,429,135,2083,"2016","019"
"17568","CERESETO",98,0,0,98,"2016","057"
"17569","CERESOLE ALBA",3205,694,0,3899,"2016","062"
"17570","CERESOLE REALE",0,33,0,33,"2016","073"
"17571","CERETE",8,191,0,199,"2016","071"
"17572","CERIANO LAGHETTO",0,41,0,41,"2016",NA
"17573","CERIGNALE",36,0,0,36,"2016","015"
"17574","CERMENATE",1,173,6,180,"2016","064"
"17575","CERNOBBIO",1,0,0,1,"2016",NA
"17576","CERNUSCO LOMBARDONE",7,0,0,7,"2016","020"
"17577","CERNUSCO SUL NAVIGLIO",8,167,0,175,"2016","070"
"17578","CERRETO CASTELLO",56,76,0,132,"2016","017"
"17579","CERRETO D'ASTI",1,0,0,1,"2016","035"
"17580","CERRETO GRUE",21,0,0,21,"2016","058"
"17581","CERRETTO LANGHE",11,0,0,11,"2016","063"
"17582","CERRINA MONFERRATO",44,0,45,89,"2016","059"
"17583","CERRIONE",96,292,0,388,"2016","018"
"17584","CERRO AL LAMBRO",1,790,0,791,"2016","071"
"17585","CERRO MAGGIORE",3,93,0,96,"2016","072"
"17586","CERRO TANARO",194,0,0,194,"2016","036"
"17587","CERRO VERONESE",15,171,0,186,"2016","026"
"17588","CERTOSA DI PAVIA",9,0,0,9,"2016","046"
"17589","CERVARESE SANTA CROCE",38,224,29,291,"2016","030"
"17590","CERVASCA",978,297,31,1306,"2016","064"
"17591","CERVATTO",16,0,0,16,"2016",NA
"17592","CERVENO",2,13,3,18,"2016","049"
"17593","CERVERE",1511,183,181,1875,"2016","065"
"17594","CERVIA",1,0,0,1,"2016","007"
"17595","CERVIGNANO D'ADDA",0,842,0,842,"2016","018"
"17596","CESANA BRIANZA",5,24,0,29,"2016","021"
"17597","CESANA TORINESE",43,0,47,90,"2016","074"
"17598","CESANO BOSCONE",0,67,0,67,"2016","074"
"17599","CESANO MADERNO",2,0,0,2,"2016",NA
"17600","CESARA",2,0,0,2,"2016","022"
"17601","CESENA",101,22,0,123,"2016","007"
"17602","CESENATICO",5,80,0,85,"2016","008"
"17603","CESIOMAGGIORE",198,132,0,330,"2016","011"
"17604","CESSALTO",26,129,0,155,"2016","015"
"17605","CESSOLE",168,0,0,168,"2016","037"
"17606","CETO",4,20,27,51,"2016","050"
"17607","CEVA",961,0,0,961,"2016","066"
"17608","CEVO",25,6,2,33,"2016","051"
"17609","CHERASCO",4459,977,87,5523,"2016","067"
"17610","CHIALAMBERTO",10,1,55,66,"2016","075"
"17611","CHIAMPO",26,73,0,99,"2016","029"
"17612","CHIANOCCO",118,0,0,118,"2016","076"
"17613","CHIARANO",15,548,2,565,"2016","016"
"17614","CHIARI",1459,5352,101,6912,"2016","052"
"17615","CHIAVENNA",5,4,11,20,"2016","018"
"17616","CHIAVERANO",23,0,0,23,"2016","077"
"17617","CHIERI",2712,493,53,3258,"2016","078"
"17618","CHIES D'ALPAGO",26,0,0,26,"2016","012"
"17619","CHIESA IN VALMALENCO",20,50,0,70,"2016","019"
"17620","CHIESANUOVA",47,72,0,119,"2016","079"
"17621","CHIEVE",93,883,0,976,"2016","029"
"17622","CHIGNOLO D'ISOLA",42,365,0,407,"2016","072"
"17623","CHIGNOLO PO",21,65,0,86,"2016","048"
"17624","CHIOGGIA",2356,0,0,2356,"2016","008"
"17625","CHIOMONTE",3,24,0,27,"2016","080"
"17626","CHIUDUNO",38,0,0,38,"2016","073"
"17627","CHIUPPANO",4,34,0,38,"2016","030"
"17628","CHIURO",3,84,0,87,"2016","020"
"17629","CHIUSA DI PESIO",1630,421,93,2144,"2016","068"
"17630","CHIUSA DI SAN MICHELE",0,0,55,55,"2016","081"
"17631","CHIUSANO D'ASTI",37,0,0,37,"2016","038"
"17632","CHIVASSO",1310,275,0,1585,"2016","082"
"17633","CICOGNOLO",0,927,0,927,"2016","030"
"17634","CICONIO",98,95,0,193,"2016","083"
"17635","CIGLIANO",299,77,45,421,"2016","042"
"17636","CIGLIE'",429,0,0,429,"2016","069"
"17637","CIGOGNOLA",5,0,0,5,"2016","049"
"17638","CIGOLE",1942,1467,0,3409,"2016","053"
"17639","CILAVEGNA",13,35,0,48,"2016","050"
"17640","CIMADOLMO",8,45,0,53,"2016","017"
"17641","CIMBERGO",2,3,0,5,"2016","054"
"17642","CINAGLIO",698,0,0,698,"2016","039"
"17643","CINGIA DE' BOTTI",0,848,0,848,"2016","031"
"17644","CINO",11,16,0,27,"2016","021"
"17645","CINTANO",34,0,0,34,"2016","084"
"17646","CINTO CAOMAGGIORE",443,6,30,479,"2016","009"
"17647","CINTO EUGANEO",82,42,0,124,"2016","031"
"17648","CINZANO",14,0,0,14,"2016","085"
"17649","CIRIE'",382,257,0,639,"2016","086"
"17650","CIRIMIDO",5,24,0,29,"2016","068"
"17651","CISANO BERGAMASCO",10,0,0,10,"2016","074"
"17652","CISERANO",13,42,1,56,"2016","075"
"17653","CISLAGO",2,0,0,2,"2016","050"
"17654","CISLIANO",226,496,0,722,"2016","078"
"17655","CISMON DEL GRAPPA",3,20,2,25,"2016","031"
"17656","CISON DI VALMARINO",79,11,1,91,"2016","018"
"17657","CISSONE",9,0,0,9,"2016","070"
"17658","CISTERNA D'ASTI",79,0,0,79,"2016","040"
"17659","CITTADELLA",2625,1123,119,3867,"2016","032"
"17660","CITTIGLIO",7,14,0,21,"2016","051"
"17661","CIVATE",9,0,0,9,"2016","022"
"17662","CIVIASCO",2,7,0,9,"2016","043"
"17663","CIVIDATE AL PIANO",1031,562,0,1593,"2016","076"
"17664","CIVIDATE CAMUNO",6,0,0,6,"2016","055"
"17665","CIVITELLA DI ROMAGNA",462,0,13,475,"2016","009"
"17666","CIVO",7,15,0,22,"2016","022"
"17667","CLAINO CON OSTENO",0,0,3,3,"2016","071"
"17668","CLAVESANA",393,0,0,393,"2016","071"
"17669","CLIVIO",8,60,0,68,"2016","052"
"17670","CLUSONE",70,190,0,260,"2016","077"
"17671","COASSOLO TORINESE",23,53,1,77,"2016","088"
"17672","COAZZE",27,0,11,38,"2016","089"
"17673","COAZZOLO",38,0,0,38,"2016","041"
"17674","COCCAGLIO",251,742,4,997,"2016","056"
"17675","COCCONATO",83,0,0,83,"2016","042"
"17676","COCQUIO-TREVISAGO",16,0,0,16,"2016","053"
"17677","CODEVIGO",444,123,7,574,"2016","033"
"17678","CODIGORO",3564,212,0,3776,"2016","005"
"17679","CODOGNE'",46,255,2,303,"2016","019"
"17680","CODOGNO",37,909,0,946,"2016","019"
"17681","COGGIOLA",5,0,0,5,"2016","019"
"17682","COGLIATE",78,0,0,78,"2016",NA
"17683","COGOLLO DEL CENGIO",354,134,27,515,"2016","032"
"17684","COLERE",3,0,0,3,"2016","078"
"17685","COLI",64,0,0,64,"2016","016"
"17686","COLICO",96,109,38,243,"2016","023"
"17687","COLLE BRIANZA",12,0,1,13,"2016","024"
"17688","COLLE SANTA LUCIA",0,22,0,22,"2016","014"
"17689","COLLE UMBERTO",29,188,0,217,"2016","020"
"17690","COLLECCHIO",10,2553,0,2563,"2016","009"
"17691","COLLEGNO",187,313,8,508,"2016","090"
"17692","COLLERETTO CASTELNUOVO",3,21,0,24,"2016","091"
"17693","COLLERETTO GIACOSA",28,0,0,28,"2016","092"
"17694","COLLIO",42,74,8,124,"2016","058"
"17695","COLOGNA VENETA",8886,206,0,9092,"2016","027"
"17696","COLOGNE",506,696,3,1205,"2016","059"
"17697","COLOGNO AL SERIO",47,940,8,995,"2016","079"
"17698","COLOGNO MONZESE",3,0,0,3,"2016","081"
"17699","COLORINA",26,367,0,393,"2016","023"
"17700","COLORNO",29,1222,0,1251,"2016","010"
"17701","COLTURANO",22,2,0,24,"2016","082"
"17702","COLVERDE",17,103,21,141,"2016",NA
"17703","COLZATE",13,62,0,75,"2016","080"
"17704","COMACCHIO",588,178,0,766,"2016","006"
"17705","COMAZZO",34,821,4,859,"2016","020"
"17706","COMELICO SUPERIORE",42,162,0,204,"2016","015"
"17707","COMERIO",4,0,0,4,"2016","055"
"17708","COMEZZANO-CIZZAGO",128,1878,0,2006,"2016","060"
"17709","COMMESSAGGIO",0,11,16,27,"2016","020"
"17710","COMO",8,58,17,83,"2016","075"
"17711","COMPIANO",11,27,0,38,"2016","011"
"17712","COMUN NUOVO",38,31,0,69,"2016","081"
"17713","CONA",12810,0,0,12810,"2016","010"
"17714","CONCAMARISE",1,239,0,240,"2016","029"
"17715","CONCESIO",14,11,0,25,"2016","061"
"17716","CONCO",30,236,0,266,"2016","033"
"17717","CONCORDIA SAGITTARIA",1128,0,0,1128,"2016","011"
"17718","CONCORDIA SULLA SECCHIA",6,317,11,334,"2016","010"
"17719","CONCOREZZO",9,29,0,38,"2016",NA
"17720","CONDOVE",123,25,57,205,"2016","093"
"17721","CONEGLIANO",29,60,3,92,"2016","021"
"17722","CONFIENZA",53,17,48,118,"2016","052"
"17723","CONIOLO",183,0,0,183,"2016","060"
"17724","CONSELICE",578,221,0,799,"2016","008"
"17725","CONSELVE",1149,45,0,1194,"2016","034"
"17726","CONZANO",103,0,0,103,"2016","061"
"17727","COPPARO",78,0,0,78,"2016","007"
"17728","CORBETTA",877,66,15,958,"2016","085"
"17729","CORBOLA",24,207,0,231,"2016","017"
"17730","CORDIGNANO",91,213,0,304,"2016","022"
"17731","CORIANO",39,172,0,211,"2016","003"
"17732","CORIO",171,9,6,186,"2016","094"
"17733","CORNA IMAGNA",14,53,0,67,"2016","082"
"17734","CORNALBA",1,10,0,11,"2016","249"
"17735","CORNAREDO",14,202,6,222,"2016","087"
"17736","CORNATE D'ADDA",16,92,0,108,"2016",NA
"17737","CORNEDO VICENTINO",6,128,0,134,"2016","034"
"17738","CORNEGLIANO LAUDENSE",0,182,0,182,"2016","021"
"17739","CORNELIANO D'ALBA",164,0,0,164,"2016","072"
"17740","CORNIGLIO",19,458,0,477,"2016","012"
"17741","CORNO GIOVINE",210,55,0,265,"2016","022"
"17742","CORNOVECCHIO",122,0,0,122,"2016","023"
"17743","CORNUDA",1025,395,0,1420,"2016","023"
"17744","CORREGGIO",5,2026,0,2031,"2016","020"
"17745","CORREZZANA",1,26,0,27,"2016",NA
"17746","CORREZZOLA",4812,9,0,4821,"2016","035"
"17747","CORRIDO",45,8,5,58,"2016","077"
"17748","CORSIONE",10,0,0,10,"2016","044"
"17749","CORTANDONE",1,0,0,1,"2016",NA
"17750","CORTANZE",73,0,0,73,"2016","046"
"17751","CORTAZZONE",7,0,0,7,"2016","047"
"17752","CORTE BRUGNATELLA",77,20,0,97,"2016","017"
"17753","CORTE DE' CORTESI CON CIGNONE",5,0,151,156,"2016","032"
"17754","CORTE DE' FRATI",10,794,206,1010,"2016","033"
"17755","CORTE FRANCA",103,77,0,180,"2016","062"
"17756","CORTE PALASIO",6,1768,14,1788,"2016","024"
"17757","CORTEMAGGIORE",155,1732,0,1887,"2016","018"
"17758","CORTEMILIA",233,0,0,233,"2016","073"
"17759","CORTENO GOLGI",20,105,18,143,"2016","063"
"17760","CORTENOVA",9,34,0,43,"2016","025"
"17761","CORTENUOVA",139,1397,0,1536,"2016","083"
"17762","CORTEOLONA E GENZONE",199,88,0,287,"2016",NA
"17763","CORTIGLIONE",1,0,0,1,"2016","048"
"17764","CORTINA D'AMPEZZO",15,39,0,54,"2016","016"
"17765","CORVINO SAN QUIRICO",2,0,0,2,"2016","057"
"17766","CORZANO",111,259,0,370,"2016","064"
"17767","COSIO VALTELLINO",38,645,1,684,"2016","024"
"17768","COSSANO BELBO",407,0,0,407,"2016","074"
"17769","COSSATO",269,159,1,429,"2016","020"
"17770","COSSOGNO",1,0,0,1,"2016","023"
"17771","COSTA DE' NOBILI",72,17,4,93,"2016","058"
"17772","COSTA DI MEZZATE",21,0,0,21,"2016","084"
"17773","COSTA DI ROVIGO",2,387,0,389,"2016","018"
"17774","COSTA MASNAGA",22,0,0,22,"2016","026"
"17775","COSTA SERINA",13,3,0,16,"2016","247"
"17776","COSTA VALLE IMAGNA",7,0,0,7,"2016","085"
"17777","COSTA VESCOVATO",33,0,0,33,"2016","062"
"17778","COSTA VOLPINO",24,16,4,44,"2016","086"
"17779","COSTABISSARA",19,43,0,62,"2016","035"
"17780","COSTERMANO",14,54,0,68,"2016","030"
"17781","COSTIGLIOLE D'ASTI",485,1,0,486,"2016","050"
"17782","COSTIGLIOLE SALUZZO",492,43,18,553,"2016","075"
"17783","COTIGNOLA",81,0,0,81,"2016","009"
"17784","COVO",637,1231,0,1868,"2016","087"
"17785","CRANDOLA VALSASSINA",2,5,6,13,"2016","027"
"17786","CRAVAGLIANA",0,11,0,11,"2016","048"
"17787","CRAVANZANA",2,0,0,2,"2016","076"
"17788","CRAVEGGIA",24,0,0,24,"2016","024"
"17789","CREAZZO",15,35,0,50,"2016","036"
"17790","CREDARO",7,169,0,176,"2016","088"
"17791","CREDERA RUBBIANO",1,1112,90,1203,"2016","034"
"17792","CREMA",431,2248,285,2964,"2016","035"
"17793","CREMELLA",9,0,0,9,"2016","028"
"17794","CREMENO",2,22,67,91,"2016","029"
"17795","CREMIA",2,1,5,8,"2016","083"
"17796","CREMOLINO",91,0,0,91,"2016","063"
"17797","CREMONA",215,1562,0,1777,"2016","036"
"17798","CREMOSANO",42,546,0,588,"2016","037"
"17799","CRESCENTINO",53,0,31,84,"2016","049"
"17800","CRESPADORO",32,70,1,103,"2016","037"
"17801","CRESPANO DEL GRAPPA",1172,745,0,1917,"2016","024"
"17802","CRESPIATICA",0,456,0,456,"2016","025"
"17803","CRESPINO",2046,0,0,2046,"2016","019"
"17804","CRESSA",61,174,0,235,"2016","055"
"17805","CREVACUORE",4,0,0,4,"2016","021"
"17806","CREVALCORE",334,29,0,363,"2016","024"
"17807","CREVOLADOSSOLA",97,48,0,145,"2016","025"
"17808","CRISSOLO",0,0,26,26,"2016",NA
"17809","CROCETTA DEL MONTELLO",93,47,0,140,"2016","025"
"17810","CRODO",27,104,0,131,"2016","026"
"17811","CROSIO DELLA VALLE",5,0,0,5,"2016","057"
"17812","CROTTA D'ADDA",5,562,0,567,"2016","038"
"17813","CROVA",4,0,0,4,"2016","052"
"17814","CUASSO AL MONTE",19,0,0,19,"2016","058"
"17815","CUCCARO MONFERRATO",19,0,0,19,"2016","064"
"17816","CUCCIAGO",3,0,0,3,"2016","084"
"17817","CUCEGLIO",54,0,0,54,"2016","096"
"17818","CUGGIONO",483,75,0,558,"2016","096"
"17819","CUGLIATE-FABIASCO",1,0,0,1,"2016","059"
"17820","CUMIANA",1414,618,53,2085,"2016","097"
"17821","CUMIGNANO SUL NAVIGLIO",0,1602,0,1602,"2016","039"
"17822","CUNARDO",5,0,0,5,"2016","060"
"17823","CUNEO",8112,903,1067,10082,"2016","078"
"17824","CUNICO",1636,0,0,1636,"2016","051"
"17825","CUORGNE'",172,76,0,248,"2016","098"
"17826","CURA CARPIGNANO",17,173,1,191,"2016","060"
"17827","CUREGGIO",25,43,1,69,"2016","058"
"17828","CURIGLIA CON MONTEVIASCO",0,0,3,3,"2016","061"
"17829","CURINO",5,0,0,5,"2016","023"
"17830","CURNO",51,41,6,98,"2016","089"
"17831","CURTAROLO",88,215,4,307,"2016","036"
"17832","CURTATONE",3821,1438,1199,6458,"2016","021"
"17833","CUSAGO",126,470,0,596,"2016","097"
"17834","CUSINO",6,0,0,6,"2016","085"
"17835","CUSIO",4,0,0,4,"2016","090"
"17836","CUVEGLIO",4,0,0,4,"2016","062"
"17837","CUVIO",3,59,3,65,"2016","063"
"17838","DAIRAGO",2,36,0,38,"2016","099"
"17839","DALMINE",104,122,0,226,"2016","091"
"17840","DARFO BOARIO TERME",9,334,12,355,"2016","065"
"17841","DAVERIO",7,0,0,7,"2016","064"
"17842","DAZIO",0,13,0,13,"2016","025"
"17843","DELEBIO",35,171,0,206,"2016","026"
"17844","DELLO",708,1902,33,2643,"2016","066"
"17845","DEMONTE",692,85,38,815,"2016","079"
"17846","DENICE",2,0,0,2,"2016","065"
"17847","DERNICE",2,6,0,8,"2016","066"
"17848","DEROVERE",26,281,1,308,"2016","040"
"17849","DESANA",49,0,0,49,"2016","054"
"17850","DESENZANO DEL GARDA",155,1513,473,2141,"2016","067"
"17851","DESIO",18,0,0,18,"2016",NA
"17852","DIANO D'ALBA",109,0,0,109,"2016","080"
"17853","DIVIGNANO",67,0,0,67,"2016","060"
"17854","DIZZASCO",0,0,7,7,"2016","087"
"17855","DOGLIANI",1706,0,0,1706,"2016","081"
"17856","DOLO",593,273,1,867,"2016","012"
"17857","DOMASO",2,5,2,9,"2016","089"
"17858","DOMEGGE DI CADORE",0,11,0,11,"2016","018"
"17859","DOMODOSSOLA",38,6,6,50,"2016","028"
"17860","DONATO",169,0,27,196,"2016","024"
"17861","DONGO",3,6,5,14,"2016","090"
"17862","DORIO",3,0,0,3,"2016","032"
"17863","DORMELLETTO",2,0,0,2,"2016","062"
"17864","DORNO",4,15,0,19,"2016","061"
"17865","DORZANO",1,0,0,1,"2016","025"
"17866","DOSOLO",18,338,90,446,"2016","022"
"17867","DOSSENA",22,67,5,94,"2016","092"
"17868","DOSSO DEL LIRO",2,12,9,23,"2016","092"
"17869","DOVADOLA",112,0,0,112,"2016","011"
"17870","DOVERA",22,1290,0,1312,"2016","041"
"17871","DOZZA",6,23,0,29,"2016","025"
"17872","DRESANO",3,0,0,3,"2016","101"
"17873","DRIZZONA",2,458,0,460,"2016","042"
"17874","DRONERO",2230,291,58,2579,"2016","082"
"17875","DRUENTO",760,47,8,815,"2016","099"
"17876","DRUOGNO",13,9,0,22,"2016","029"
"17877","DUBINO",14,692,9,715,"2016","027"
"17878","DUE CARRARE",157,0,0,157,"2016","106"
"17879","DUEVILLE",435,688,0,1123,"2016","038"
"17880","DUMENZA",2,0,7,9,"2016","065"
"17881","DUSINO SAN MICHELE",390,39,0,429,"2016","052"
"17882","EDOLO",18,49,10,77,"2016","068"
"17883","ELLO",5,0,0,5,"2016","033"
"17884","ELVA",20,0,6,26,"2016","083"
"17885","ENDINE GAIANO",43,93,0,136,"2016","093"
"17886","ENEGO",23,225,0,248,"2016","039"
"17887","ENTRACQUE",116,0,0,116,"2016","084"
"17888","ENTRATICO",66,6,0,72,"2016","094"
"17889","ENVIE",836,376,257,1469,"2016","085"
"17890","ERACLEA",3844,292,0,4136,"2016","013"
"17891","ERBA",40,381,0,421,"2016","095"
"17892","ERBE'",240,16,0,256,"2016","032"
"17893","ERBEZZO",34,735,0,769,"2016","033"
"17894","ERBUSCO",203,55,0,258,"2016","069"
"17895","ERVE",1,0,0,1,"2016","034"
"17896","ESINE",2,195,6,203,"2016","070"
"17897","ESINO LARIO",21,0,0,21,"2016","035"
"17898","ESTE",1034,51,0,1085,"2016","037"
"17899","EUPILIO",9,11,56,76,"2016","097"
"17900","EXILLES",2,0,0,2,"2016",NA
"17901","FABBRICA CURONE",12,32,0,44,"2016","067"
"17902","FABBRICO",2,270,0,272,"2016","021"
"17903","FAEDO VALTELLINO",7,20,0,27,"2016","028"
"17904","FAENZA",211,120,0,331,"2016","010"
"17905","FAGGETO LARIO",0,0,7,7,"2016","098"
"17906","FAGNANO OLONA",15,49,1,65,"2016","067"
"17907","FALCADE",15,19,0,34,"2016","019"
"17908","FALOPPIO",6,0,3,9,"2016","099"
"17909","FANANO",86,443,0,529,"2016","011"
"17910","FARA GERA D'ADDA",1,618,76,695,"2016","096"
"17911","FARA NOVARESE",9,0,0,9,"2016","065"
"17912","FARA OLIVANA CON SOLA",206,300,0,506,"2016","097"
"17913","FARA VICENTINO",245,447,146,838,"2016","040"
"17914","FARIGLIANO",492,0,0,492,"2016","086"
"17915","FARINI",102,116,0,218,"2016","019"
"17916","FARRA DI SOLIGO",102,41,0,143,"2016","026"
"17917","FAULE",42,0,107,149,"2016","087"
"17918","FAVRIA",298,606,0,904,"2016","101"
"17919","FEISOGLIO",74,0,0,74,"2016","088"
"17920","FELETTO",21,20,0,41,"2016","102"
"17921","FELINO",33,1071,0,1104,"2016","013"
"17922","FELIZZANO",40,0,0,40,"2016","068"
"17923","FELTRE",169,1306,0,1475,"2016","021"
"17924","FENEGRO'",23,6,41,70,"2016","100"
"17925","FENESTRELLE",25,0,0,25,"2016","103"
"17926","FERNO",1,15,0,16,"2016","068"
"17927","FERRARA",335,214,0,549,"2016","008"
"17928","FERRARA DI MONTE BALDO",4,37,10,51,"2016","034"
"17929","FERRERA DI VARESE",14,0,0,14,"2016","069"
"17930","FERRERA ERBOGNONE",31,0,0,31,"2016","062"
"17931","FERRERE",865,0,0,865,"2016","053"
"17932","FERRIERE",101,6,0,107,"2016","020"
"17933","FIANO",6,0,0,6,"2016","104"
"17934","FICAROLO",24,0,0,24,"2016","021"
"17935","FIDENZA",194,3524,11,3729,"2016","014"
"17936","FIESCO",16,574,0,590,"2016","043"
"17937","FIESSE",673,399,384,1456,"2016","071"
"17938","FIESSO D'ARTICO",6,14,0,20,"2016","014"
"17939","FIESSO UMBERTIANO",79,0,0,79,"2016","022"
"17940","FIGINO SERENZA",28,92,0,120,"2016","101"
"17941","FILAGO",69,0,0,69,"2016","098"
"17942","FILIGHERA",0,140,0,140,"2016","063"
"17943","FINALE EMILIA",34,85,0,119,"2016","012"
"17944","FINO DEL MONTE",3,22,0,25,"2016","099"
"17945","FINO MORNASCO",15,0,0,15,"2016","102"
"17946","FIORANO AL SERIO",9,15,0,24,"2016","100"
"17947","FIORANO CANAVESE",22,0,0,22,"2016","105"
"17948","FIORANO MODENESE",25,53,0,78,"2016","013"
"17949","FIORENZUOLA D'ARDA",132,2174,0,2306,"2016","021"
"17950","FISCAGLIA",2165,76,1,2242,"2016",NA
"17951","FIUMALBO",123,99,0,222,"2016","014"
"17952","FLERO",48,349,0,397,"2016","072"
"17953","FOBELLO",12,0,1,13,"2016","057"
"17954","FOGLIZZO",168,0,0,168,"2016","106"
"17955","FOLLINA",442,87,0,529,"2016","027"
"17956","FOMBIO",259,298,0,557,"2016","026"
"17957","FONTANELICE",175,122,0,297,"2016","026"
"17958","FONTANELLA",2770,2342,0,5112,"2016","101"
"17959","FONTANELLATO",63,2423,0,2486,"2016","015"
"17960","FONTANELLE",70,611,14,695,"2016","028"
"17961","FONTANETO D'AGOGNA",11,58,0,69,"2016","066"
"17962","FONTANILE",6,0,0,6,"2016","054"
"17963","FONTANIVA",253,315,0,568,"2016","038"
"17964","FONTE",1102,702,0,1804,"2016","029"
"17965","FONTENO",10,0,0,10,"2016","102"
"17966","FONTEVIVO",0,1415,0,1415,"2016","016"
"17967","FONZASO",74,66,0,140,"2016","022"
"17968","FOPPOLO",1,14,0,15,"2016","103"
"17969","FORCOLA",6,127,0,133,"2016","029"
"17970","FORESTO SPARSO",13,80,2,95,"2016","104"
"17971","FORLI'",460,110,0,570,"2016","012"
"17972","FORLIMPOPOLI",4,23,0,27,"2016","013"
"17973","FORMAZZA",2,14,11,27,"2016","031"
"17974","FORMIGARA",4,857,220,1081,"2016","044"
"17975","FORMIGINE",4,1816,0,1820,"2016","015"
"17976","FORMIGLIANA",23,0,0,23,"2016","059"
"17977","FORMIGNANA",5,0,0,5,"2016","009"
"17978","FORNO CANAVESE",29,0,0,29,"2016","107"
"17979","FORNOVO DI TARO",12,489,14,515,"2016","017"
"17980","FORNOVO SAN GIOVANNI",13,706,23,742,"2016","105"
"17981","FORTUNAGO",42,0,0,42,"2016","064"
"17982","FOSSALTA DI PIAVE",4,0,0,4,"2016","015"
"17983","FOSSALTA DI PORTOGRUARO",0,1021,0,1021,"2016","016"
"17984","FOSSANO",16775,4377,1106,22258,"2016","089"
"17985","FOSSO'",105,34,0,139,"2016","017"
"17986","FOZA",39,46,5,90,"2016","041"
"17987","FRABOSA SOPRANA",260,15,161,436,"2016","090"
"17988","FRABOSA SOTTANA",502,0,35,537,"2016","091"
"17989","FRACONALTO",31,0,0,31,"2016","069"
"17990","FRASCARO",0,14,0,14,"2016","071"
"17991","FRASCAROLO",255,47,0,302,"2016","065"
"17992","FRASSINELLE POLESINE",285,0,0,285,"2016","023"
"17993","FRASSINELLO MONFERRATO",65,0,0,65,"2016","072"
"17994","FRASSINETO PO",33,0,0,33,"2016","073"
"17995","FRASSINETTO",146,17,0,163,"2016","108"
"17996","FRASSINO",37,0,4,41,"2016","092"
"17997","FRASSINORO",109,174,0,283,"2016","016"
"17998","FRATTA POLESINE",43,134,0,177,"2016","024"
"17999","FREGONA",12,24,0,36,"2016","030"
"18000","FRESONARA",17,0,0,17,"2016","074"
"18001","FRINCO",288,0,0,288,"2016","055"
"18002","FRONT",73,0,0,73,"2016","109"
"18003","FROSSASCO",2109,0,92,2201,"2016","110"
"18004","FRUGAROLO",145,152,0,297,"2016","075"
"18005","FUBINE",623,0,0,623,"2016","076"
"18006","FUIPIANO VALLE IMAGNA",15,52,0,67,"2016","106"
"18007","FUMANE",16,39,6,61,"2016","035"
"18008","FUSIGNANO",2,0,0,2,"2016","011"
"18009","FUSINE",13,34,0,47,"2016","030"
"18010","GABBIONETA-BINANUOVA",13,608,0,621,"2016","045"
"18011","GABIANO",48,0,0,48,"2016","077"
"18012","GADESCO-PIEVE DELMONA",56,434,63,553,"2016","046"
"18013","GAGGIANO",50,433,7,490,"2016","103"
"18014","GAGGIO MONTANO",273,362,0,635,"2016","027"
"18015","GAGLIANICO",1,0,0,1,"2016","026"
"18016","GAIARINE",780,0,2,782,"2016","031"
"18017","GAIBA",17,0,0,17,"2016","025"
"18018","GAIOLA",8,0,1,9,"2016","093"
"18019","GALBIATE",54,14,0,68,"2016","036"
"18020","GALEATA",205,0,17,222,"2016","014"
"18021","GALGAGNANO",0,811,0,811,"2016","027"
"18022","GALLARATE",6,43,0,49,"2016","070"
"18023","GALLIATE",48,32,0,80,"2016","068"
"18024","GALLIATE LOMBARDO",7,0,0,7,"2016","071"
"18025","GALLIERA",0,46,0,46,"2016","028"
"18026","GALLIERA VENETA",3403,133,0,3536,"2016","039"
"18027","GALLIO",1,222,0,223,"2016","042"
"18028","GALZIGNANO TERME",10,0,0,10,"2016","040"
"18029","GAMALERO",30,0,0,30,"2016","078"
"18030","GAMBARA",4023,2067,428,6518,"2016","073"
"18031","GAMBASCA",3,0,0,3,"2016","094"
"18032","GAMBOLO'",132,118,0,250,"2016","068"
"18033","GAMBUGLIANO",0,63,0,63,"2016","044"
"18034","GANDELLINO",15,0,0,15,"2016","107"
"18035","GANDINO",60,188,0,248,"2016","108"
"18036","GANDOSSO",5,13,0,18,"2016","109"
"18037","GARBAGNA",89,0,0,89,"2016","079"
"18038","GARBAGNA NOVARESE",2,0,0,2,"2016","069"
"18039","GARBAGNATE MILANESE",3,0,0,3,"2016",NA
"18040","GARBAGNATE MONASTERO",7,0,0,7,"2016","037"
"18041","GARDA",2,0,0,2,"2016","036"
"18042","GARDONE RIVIERA",7,0,0,7,"2016","074"
"18043","GARDONE VAL TROMPIA",35,0,0,35,"2016","075"
"18044","GARESSIO",177,0,0,177,"2016","095"
"18045","GARGNANO",30,0,9,39,"2016","076"
"18046","GARLASCO",8,22,8,38,"2016","069"
"18047","GARLATE",1,0,0,1,"2016","038"
"18048","GARZENO",13,7,15,35,"2016","106"
"18049","GARZIGLIANA",286,0,0,286,"2016","111"
"18050","GASSINO TORINESE",30,0,0,30,"2016","112"
"18051","GATTATICO",8,2543,0,2551,"2016","022"
"18052","GATTEO",3,0,0,3,"2016","016"
"18053","GATTICO",34,136,153,323,"2016","071"
"18054","GATTINARA",51,0,0,51,"2016","061"
"18055","GAVARDO",98,396,0,494,"2016","077"
"18056","GAVELLO",103,0,0,103,"2016",NA
"18057","GAVERINA TERME",23,42,0,65,"2016","110"
"18058","GAVI",18,0,0,18,"2016","081"
"18059","GAVIRATE",27,0,0,27,"2016","072"
"18060","GAZOLDO DEGLI IPPOLITI",209,94,2,305,"2016","024"
"18061","GAZZADA SCHIANNO",11,11,0,22,"2016","073"
"18062","GAZZANIGA",22,60,0,82,"2016","111"
"18063","GAZZO",66,3082,2,3150,"2016","041"
"18064","GAZZO VERONESE",984,283,0,1267,"2016","037"
"18065","GAZZOLA",131,1365,0,1496,"2016","022"
"18066","GAZZUOLO",787,40,11,838,"2016","025"
"18067","GEMMANO",23,54,0,77,"2016","004"
"18068","GEMONIO",1,0,1,2,"2016","074"
"18069","GENIVOLTA",60,1943,0,2003,"2016","047"
"18070","GENOLA",1941,1851,222,4014,"2016","096"
"18071","GERA LARIO",41,231,5,277,"2016","107"
"18072","GERENZAGO",6,0,0,6,"2016","071"
"18073","GERENZANO",68,101,0,169,"2016","075"
"18074","GERMAGNANO",31,2,0,33,"2016","113"
"18075","GERMAGNO",1,0,0,1,"2016","032"
"18076","GERMIGNAGA",7,68,0,75,"2016","076"
"18077","GERRE DE' CAPRIOLI",0,458,0,458,"2016","048"
"18078","GESSATE",4,405,0,409,"2016","106"
"18079","GHEDI",3242,6468,70,9780,"2016","078"
"18080","GHEMME",16,0,15,31,"2016","073"
"18081","GHIFFA",2,0,0,2,"2016","033"
"18082","GHISALBA",6,739,0,745,"2016","113"
"18083","GHISLARENGO",20,0,0,20,"2016","062"
"18084","GIACCIANO CON BARUCHELLA",0,0,5,5,"2016","027"
"18085","GIAGLIONE",20,0,0,20,"2016","114"
"18086","GIANICO",193,184,144,521,"2016","079"
"18087","GIAVENO",176,413,179,768,"2016","115"
"18088","GIAVERA DEL MONTELLO",698,147,0,845,"2016","032"
"18089","GIGNESE",0,0,1,1,"2016","034"
"18090","GIUSSAGO",21,142,0,163,"2016","072"
"18091","GIUSSANO",4,0,0,4,"2016",NA
"18092","GIVOLETTO",26,0,0,26,"2016","116"
"18093","GODEGA DI SANT'URBANO",30,111,0,141,"2016","033"
"18094","GODIASCO",6,0,0,6,"2016","073"
"18095","GOITO",3972,4720,1533,10225,"2016","026"
"18096","GOLASECCA",20,30,0,50,"2016","077"
"18097","GOLFERENZO",0,0,18,18,"2016","074"
"18098","GOMBITO",2,782,0,784,"2016","049"
"18099","GONZAGA",17824,2677,3918,24419,"2016","027"
"18100","GORDONA",88,114,21,223,"2016","032"
"18101","GORGO AL MONTICANO",41,337,16,394,"2016","034"
"18102","GORGONZOLA",27,303,0,330,"2016","108"
"18103","GORLA MAGGIORE",4,0,149,153,"2016","078"
"18104","GORLA MINORE",88,0,0,88,"2016","079"
"18105","GORLAGO",56,276,0,332,"2016","114"
"18106","GORLE",3,0,0,3,"2016","115"
"18107","GORNATE-OLONA",13,0,0,13,"2016","080"
"18108","GORNO",23,75,0,98,"2016","116"
"18109","GORZEGNO",29,0,0,29,"2016","097"
"18110","GOSSOLENGO",2,585,0,587,"2016","023"
"18111","GOTTASECCA",48,0,0,48,"2016","098"
"18112","GOTTOLENGO",12294,1341,96,13731,"2016","080"
"18113","GOVONE",303,0,0,303,"2016","099"
"18114","GOZZANO",4,0,0,4,"2016","076"
"18115","GRAFFIGNANA",38,222,77,337,"2016","028"
"18116","GRAGLIA",125,8,63,196,"2016","028"
"18117","GRAGNANO TREBBIENSE",2,2569,0,2571,"2016","024"
"18118","GRANA",62,0,0,62,"2016","056"
"18119","GRANAROLO DELL'EMILIA",18,282,92,392,"2016","030"
"18120","GRANCONA",45,131,0,176,"2016","045"
"18121","GRANDOLA ED UNITI",2,20,27,49,"2016","111"
"18122","GRANOZZO CON MONTICELLO",4,40,0,44,"2016","077"
"18123","GRANTOLA",48,0,0,48,"2016","081"
"18124","GRANTORTO",70,949,0,1019,"2016","042"
"18125","GRANZE",878,0,0,878,"2016","043"
"18126","GRASSOBBIO",16,154,0,170,"2016","117"
"18127","GRAVEDONA ED UNITI",12,24,42,78,"2016","249"
"18128","GRAVELLONA LOMELLINA",12,0,0,12,"2016","075"
"18129","GRAVELLONA TOCE",22,0,0,22,"2016","035"
"18130","GRAVERE",11,0,0,11,"2016","117"
"18131","GRAZZANO BADOGLIO",477,0,0,477,"2016","057"
"18132","GREMIASCO",32,0,0,32,"2016","083"
"18133","GREZZAGO",6,0,0,6,"2016","110"
"18134","GREZZANA",149,734,0,883,"2016","038"
"18135","GRIANTE",4,0,5,9,"2016","113"
"18136","GRIGNASCO",39,0,0,39,"2016","079"
"18137","GRINZANE CAVOUR",10,0,0,10,"2016","100"
"18138","GRISIGNANO DI ZOCCO",41,447,14,502,"2016","046"
"18139","GRIZZANA MORANDI",63,0,0,63,"2016","031"
"18140","GROMO",36,96,7,139,"2016","118"
"18141","GRONDONA",7,0,0,7,"2016","085"
"18142","GRONE",29,31,0,60,"2016","119"
"18143","GRONTARDO",0,1985,99,2084,"2016","050"
"18144","GROPELLO CAIROLI",30,0,0,30,"2016","076"
"18145","GROPPARELLO",89,24,0,113,"2016","025"
"18146","GROSCAVALLO",21,13,34,68,"2016","118"
"18147","GROSIO",25,186,6,217,"2016","033"
"18148","GROSOTTO",13,62,0,75,"2016","034"
"18149","GROSSO",49,0,0,49,"2016","119"
"18150","GRUARO",14,211,0,225,"2016","018"
"18151","GRUGLIASCO",94,17,21,132,"2016","120"
"18152","GRUMELLO CREMONESE ED UNITI",107,1407,308,1822,"2016","051"
"18153","GRUMELLO DEL MONTE",110,112,0,222,"2016","120"
"18154","GRUMOLO DELLE ABBADESSE",27,236,0,263,"2016","047"
"18155","GUALTIERI",1355,615,0,1970,"2016","023"
"18156","GUANZATE",26,0,1,27,"2016","114"
"18157","GUARDA VENETA",722,0,0,722,"2016","028"
"18158","GUARDABOSONE",50,12,0,62,"2016","066"
"18159","GUARDAMIGLIO",9,66,300,375,"2016","029"
"18160","GUARENE",283,0,0,283,"2016","101"
"18161","GUASTALLA",61,1080,0,1141,"2016","024"
"18162","GUDO VISCONTI",11,0,0,11,"2016","112"
"18163","GUIDIZZOLO",1088,915,220,2223,"2016","028"
"18164","GUIGLIA",52,519,0,571,"2016","017"
"18165","GUSSAGO",129,861,0,990,"2016","081"
"18166","GUSSOLA",1,53,7,61,"2016","052"
"18167","IDRO",2,0,0,2,"2016","082"
"18168","IESOLO",7,31,3,41,"2016","019"
"18169","IGLIANO",60,0,22,82,"2016","102"
"18170","ILLASI",1,70,0,71,"2016","039"
"18171","IMBERSAGO",5,0,0,5,"2016","039"
"18172","IMOLA",73,38,0,111,"2016","032"
"18173","INARZO",9,0,0,9,"2016","082"
"18174","INCISA SCAPACCINO",36,0,0,36,"2016","058"
"18175","INCUDINE",3,0,0,3,"2016","083"
"18176","INDUNO OLONA",19,73,0,92,"2016","083"
"18177","INTRAGNA",1,0,0,1,"2016","037"
"18178","INTROBIO",56,18,0,74,"2016","040"
"18179","INVERIGO",141,0,0,141,"2016","118"
"18180","INVERNO E MONTELEONE",77,122,21,220,"2016","077"
"18181","INVERSO PINASCA",39,0,0,39,"2016","122"
"18182","INVERUNO",8,135,0,143,"2016","113"
"18183","INVORIO",29,127,0,156,"2016","082"
"18184","INZAGO",154,824,0,978,"2016","114"
"18185","IRMA",7,0,0,7,"2016","084"
"18186","ISASCA",18,0,0,18,"2016","103"
"18187","ISEO",30,29,0,59,"2016","085"
"18188","ISOLA D'ASTI",345,0,0,345,"2016","059"
"18189","ISOLA DELLA SCALA",5694,393,0,6087,"2016","040"
"18190","ISOLA DI FONDRA",5,28,0,33,"2016","121"
"18191","ISOLA DOVARESE",0,706,0,706,"2016","053"
"18192","ISOLA RIZZA",2134,396,0,2530,"2016","041"
"18193","ISOLA SANT'ANTONIO",1,0,0,1,"2016","087"
"18194","ISOLA VICENTINA",1661,776,31,2468,"2016","048"
"18195","ISOLABELLA",42,0,446,488,"2016","123"
"18196","ISORELLA",11558,761,74,12393,"2016","086"
"18197","ISPRA",52,153,0,205,"2016","084"
"18198","ISSIGLIO",87,13,0,100,"2016","124"
"18199","ISSO",9,1143,0,1152,"2016","122"
"18200","ISTRANA",2718,346,92,3156,"2016","035"
"18201","IVREA",155,182,0,337,"2016","125"
"18202","IZANO",16,997,0,1013,"2016","054"
"18203","JERAGO CON ORAGO",2,0,0,2,"2016","085"
"18204","JOLANDA DI SAVOIA",55,0,0,55,"2016","010"
"18205","LA CASSA",1,426,0,427,"2016","126"
"18206","LA LOGGIA",72,0,75,147,"2016","127"
"18207","LA MORRA",54,0,0,54,"2016","105"
"18208","LA VALLE AGORDINA",12,34,0,46,"2016","027"
"18209","LA VALLETTA BRIANZA",21,2,12,35,"2016",NA
"18210","LACCHIARELLA",48,46,0,94,"2016","115"
"18211","LAGNASCO",35,29,0,64,"2016","104"
"18212","LAGOSANTO",24,0,0,24,"2016","011"
"18213","LAINATE",1,0,5,6,"2016","116"
"18214","LAINO",4,1,0,5,"2016","120"
"18215","LALLIO",1,0,0,1,"2016",NA
"18216","LAMA MOCOGNO",103,420,0,523,"2016","018"
"18217","LAMBRUGO",0,107,0,107,"2016","121"
"18218","LAMON",20,28,0,48,"2016","026"
"18219","LAMPORO",20,0,0,20,"2016","067"
"18220","LANDRIANO",9,263,0,272,"2016","078"
"18221","LANGHIRANO",5,992,0,997,"2016","018"
"18222","LANGOSCO",5,0,0,5,"2016","079"
"18223","LANZADA",14,65,0,79,"2016","036"
"18224","LANZO D'INTELVI",16,0,9,25,"2016","122"
"18225","LANZO TORINESE",188,0,23,211,"2016","128"
"18226","LASNIGO",10,25,0,35,"2016","123"
"18227","LAURIANO",10,0,0,10,"2016","129"
"18228","LAVENA PONTE TRESA",6,0,0,6,"2016","086"
"18229","LAVENO-MOMBELLO",8,0,0,8,"2016","087"
"18230","LAVENONE",14,2,0,16,"2016","087"
"18231","LAZISE",57,130,0,187,"2016","043"
"18232","LAZZATE",23,0,0,23,"2016",NA
"18233","LECCO",19,44,6,69,"2016","042"
"18234","LEFFE",17,79,0,96,"2016","124"
"18235","LEGGIUNO",2,0,0,2,"2016","088"
"18236","LEGNAGO",76,27,0,103,"2016","044"
"18237","LEGNANO",0,53,0,53,"2016","118"
"18238","LEGNARO",63,43,72,178,"2016","044"
"18239","LEINI'",576,738,97,1411,"2016","130"
"18240","LEMIE",12,0,76,88,"2016","131"
"18241","LENDINARA",599,115,0,714,"2016","029"
"18242","LENNA",3,6,0,9,"2016","125"
"18243","LENO",6190,7025,1075,14290,"2016","088"
"18244","LENTA",1,17,0,18,"2016","068"
"18245","LENTATE SUL SEVESO",0,191,0,191,"2016",NA
"18246","LENTIAI",91,149,0,240,"2016","028"
"18247","LEQUIO BERRIA",30,0,0,30,"2016","106"
"18248","LEQUIO TANARO",1793,0,0,1793,"2016","107"
"18249","LERMA",16,0,0,16,"2016","088"
"18250","LESA",7,0,0,7,"2016","084"
"18251","LESEGNO",792,0,0,792,"2016","108"
"18252","LESIGNANO DE' BAGNI",33,1295,0,1328,"2016","019"
"18253","LESMO",2,177,0,179,"2016",NA
"18254","LESSOLO",129,4,0,133,"2016","132"
"18255","LESSONA",3,22,0,25,"2016","029"
"18256","LEVATE",11,0,0,11,"2016","126"
"18257","LEVICE",102,0,0,102,"2016","109"
"18258","LEZZENO",0,0,1,1,"2016","126"
"18259","LIERNA",5,4,0,9,"2016","043"
"18260","LIGNANA",1,0,0,1,"2016","070"
"18261","LIMANA",44,149,0,193,"2016","029"
"18262","LIMBIATE",0,0,14,14,"2016",NA
"18263","LIMENA",732,635,89,1456,"2016","045"
"18264","LIMIDO COMASCO",4,37,0,41,"2016","128"
"18265","LIMONE PIEMONTE",107,0,0,107,"2016","110"
"18266","LINAROLO",6,390,0,396,"2016","081"
"18267","LIPOMO",1,0,0,1,"2016",NA
"18268","LIRIO",28,0,0,28,"2016","082"
"18269","LISCATE",12,0,0,12,"2016","122"
"18270","LISIO",58,0,0,58,"2016","111"
"18271","LISSONE",321,0,0,321,"2016",NA
"18272","LIVIGNO",66,286,6,358,"2016","037"
"18273","LIVINALLONGO DEL COL DI LANA",5,59,0,64,"2016","030"
"18274","LIVO",5,6,0,11,"2016","130"
"18275","LIVORNO FERRARIS",2,61,0,63,"2016","071"
"18276","LIVRAGA",39,1244,21,1304,"2016","030"
"18277","LIZZANO IN BELVEDERE",34,66,33,133,"2016","033"
"18278","LOAZZOLO",10,0,1,11,"2016","060"
"18279","LOCANA",154,142,0,296,"2016","134"
"18280","LOCATE DI TRIULZI",0,1041,0,1041,"2016","125"
"18281","LOCATE VARESINO",13,0,0,13,"2016","131"
"18282","LOCATELLO",34,26,0,60,"2016","127"
"18283","LODI",566,1231,46,1843,"2016","031"
"18284","LODI VECCHIO",3,1086,0,1089,"2016","032"
"18285","LODRINO",10,7,0,17,"2016","090"
"18286","LOGRATO",1207,574,10,1791,"2016","091"
"18287","LOIANO",19,300,0,319,"2016","034"
"18288","LOMBARDORE",17,0,0,17,"2016","135"
"18289","LOMBRIASCO",80,133,0,213,"2016","136"
"18290","LOMELLO",1,154,0,155,"2016","083"
"18291","LONATE CEPPINO",1,264,0,265,"2016","089"
"18292","LONATE POZZOLO",17,0,9,26,"2016","090"
"18293","LONATO",2677,4580,376,7633,"2016","092"
"18294","LONGARE",61,264,0,325,"2016","051"
"18295","LONGARONE",3,0,0,3,"2016","031"
"18296","LONGHENA",0,367,0,367,"2016","093"
"18297","LONGIANO",19,0,0,19,"2016","018"
"18298","LONIGO",5594,462,0,6056,"2016","052"
"18299","LORANZE'",17,0,0,17,"2016","137"
"18300","LOREGGIA",276,498,4,778,"2016","046"
"18301","LOREGLIA",11,0,0,11,"2016","038"
"18302","LORENZAGO DI CADORE",2,0,0,2,"2016","032"
"18303","LOREO",1160,88,0,1248,"2016","030"
"18304","LORIA",6439,31,1,6471,"2016","036"
"18305","LOSINE",0,38,1,39,"2016","094"
"18306","LOVERE",6,31,0,37,"2016","128"
"18307","LOVERO",10,7,0,17,"2016","038"
"18308","LOZIO",0,1,0,1,"2016","095"
"18309","LOZZA",0,118,0,118,"2016","091"
"18310","LOZZO ATESTINO",1702,3,2,1707,"2016","047"
"18311","LOZZO DI CADORE",1,0,0,1,"2016","033"
"18312","LU",65,0,0,65,"2016","089"
"18313","LUGAGNANO VAL D'ARDA",46,221,0,267,"2016","026"
"18314","LUGNACCO",6,0,0,6,"2016","138"
"18315","LUGO",490,118,0,608,"2016","012"
"18316","LUGO DI VICENZA",16,141,9,166,"2016","053"
"18317","LUINO",17,27,0,44,"2016","092"
"18318","LUISAGO",6,0,0,6,"2016","135"
"18319","LUMEZZANE",23,0,0,23,"2016","096"
"18320","LURAGO D'ERBA",7,0,0,7,"2016","136"
"18321","LURAGO MARINONE",0,131,0,131,"2016","137"
"18322","LURANO",33,0,0,33,"2016","129"
"18323","LURATE CACCIVIO",27,0,64,91,"2016","138"
"18324","LUSERNA SAN GIOVANNI",404,71,49,524,"2016","139"
"18325","LUSERNETTA",66,0,0,66,"2016","140"
"18326","LUSIA",26,0,0,26,"2016","031"
"18327","LUSIANA",19,112,3,134,"2016","054"
"18328","LUSIGLIE'",61,0,0,61,"2016","141"
"18329","LUZZANA",18,0,0,18,"2016","130"
"18330","LUZZARA",1567,1347,3,2917,"2016","026"
"18331","MACCAGNO CON PINO E VEDDASCA",0,4,11,15,"2016",NA
"18332","MACCASTORNA",584,89,0,673,"2016","033"
"18333","MACELLO",1468,227,461,2156,"2016","142"
"18334","MACHERIO",1,0,0,1,"2016",NA
"18335","MACLODIO",11,428,0,439,"2016","097"
"18336","MACRA",3,0,0,3,"2016",NA
"18337","MACUGNAGA",0,5,0,5,"2016","039"
"18338","MADESIMO",0,27,0,27,"2016","035"
"18339","MADIGNANO",26,639,0,665,"2016","055"
"18340","MADONE",16,0,0,16,"2016","131"
"18341","MADONNA DEL SASSO",16,0,0,16,"2016","040"
"18342","MAGASA",18,14,0,32,"2016","098"
"18343","MAGENTA",31,728,0,759,"2016","130"
"18344","MAGGIORA",92,66,0,158,"2016","088"
"18345","MAGHERNO",9,83,0,92,"2016","085"
"18346","MAGLIANO ALFIERI",444,0,0,444,"2016","113"
"18347","MAGLIANO ALPI",668,93,0,761,"2016","114"
"18348","MAGNACAVALLO",102,273,432,807,"2016","029"
"18349","MAGNAGO",53,0,0,53,"2016","131"
"18350","MAGNANO",24,15,0,39,"2016","030"
"18351","MAIOLO",107,0,0,107,"2016","022"
"18352","MAIRAGO",2,578,0,580,"2016","034"
"18353","MAIRANO",173,569,19,761,"2016","099"
"18354","MALAGNINO",125,538,0,663,"2016","056"
"18355","MALALBERGO",3,0,0,3,"2016","035"
"18356","MALCESINE",25,83,0,108,"2016","045"
"18357","MALEGNO",9,33,7,49,"2016","100"
"18358","MALEO",16,1371,1,1388,"2016","035"
"18359","MALESCO",20,0,3,23,"2016","041"
"18360","MALGESSO",49,0,0,49,"2016","095"
"18361","MALNATE",44,51,0,95,"2016","096"
"18362","MALO",2197,337,0,2534,"2016","055"
"18363","MALONNO",17,221,29,267,"2016","101"
"18364","MALVICINO",6,2,0,8,"2016","090"
"18365","MANDELLO DEL LARIO",20,0,0,20,"2016","046"
"18366","MANERBA DEL GARDA",27,0,10,37,"2016","102"
"18367","MANERBIO",509,1458,0,1967,"2016","103"
"18368","MANGO",34,0,0,34,"2016","115"
"18369","MANSUE'",55,359,27,441,"2016","037"
"18370","MANTA",1,0,0,1,"2016","116"
"18371","MANTELLO",5,114,0,119,"2016","039"
"18372","MANTOVA",762,927,125,1814,"2016","030"
"18373","MAPELLO",8,0,26,34,"2016","132"
"18374","MARANELLO",18,591,0,609,"2016","019"
"18375","MARANO DI VALPOLICELLA",35,69,14,118,"2016","046"
"18376","MARANO SUL PANARO",89,693,0,782,"2016","020"
"18377","MARANO TICINO",5,220,0,225,"2016","091"
"18378","MARANO VICENTINO",194,287,55,536,"2016","056"
"18379","MARCALLO CON CASONE",1,259,0,260,"2016","134"
"18380","MARCARIA",2289,3300,790,6379,"2016","031"
"18381","MARCHENO",16,16,0,32,"2016","104"
"18382","MARCHIROLO",2,0,0,2,"2016","097"
"18383","MARCIGNAGO",25,0,0,25,"2016","086"
"18384","MARCON",414,13,0,427,"2016","020"
"18385","MARENE",2909,2202,188,5299,"2016","117"
"18386","MARENO DI PIAVE",1496,200,0,1696,"2016","038"
"18387","MARENTINO",143,0,0,143,"2016","144"
"18388","MARETTO",121,0,0,121,"2016","062"
"18389","MARGARITA",780,0,0,780,"2016","118"
"18390","MARGNO",6,9,0,15,"2016","047"
"18391","MARIANA MANTOVANA",59,285,39,383,"2016","032"
"18392","MARIANO COMENSE",1117,61,0,1178,"2016","143"
"18393","MARMENTINO",12,11,11,34,"2016","105"
"18394","MARMIROLO",3616,2203,3165,8984,"2016","033"
"18395","MARMORA",45,0,81,126,"2016","119"
"18396","MARONE",37,15,15,67,"2016","106"
"18397","MAROSTICA",196,739,0,935,"2016","057"
"18398","MARSAGLIA",171,0,0,171,"2016","120"
"18399","MARTELLAGO",38,31,0,69,"2016","021"
"18400","MARTIGNANA DI PO",1,0,0,1,"2016","057"
"18401","MARTINENGO",173,2599,0,2772,"2016","133"
"18402","MARTINIANA PO",116,44,49,209,"2016","121"
"18403","MARUDO",1,303,0,304,"2016","036"
"18404","MARZABOTTO",23,74,0,97,"2016","036"
"18405","MARZANO",76,258,12,346,"2016","087"
"18406","MARZIO",1,0,2,3,"2016","099"
"18407","MASATE",0,0,173,173,"2016","136"
"18408","MASCIAGO PRIMO",40,0,0,40,"2016","100"
"18409","MASER",3956,40,0,3996,"2016","039"
"18410","MASERA",16,37,10,63,"2016","042"
"18411","MASERA' DI PADOVA",293,126,92,511,"2016","048"
"18412","MASERADA SUL PIAVE",2536,142,0,2678,"2016","040"
"18413","MASI",88,0,0,88,"2016","049"
"18414","MASI TORELLO",20,34,0,54,"2016","012"
"18415","MASIO",474,0,0,474,"2016","091"
"18416","MASON VICENTINO",94,448,0,542,"2016","058"
"18417","MASSA LOMBARDA",9,0,0,9,"2016","013"
"18418","MASSALENGO",0,166,0,166,"2016","037"
"18419","MASSANZAGO",605,185,0,790,"2016","050"
"18420","MASSAZZA",23,8,0,31,"2016","031"
"18421","MASSELLO",8,0,0,8,"2016","145"
"18422","MASSERANO",63,0,0,63,"2016","032"
"18423","MASSINO VISCONTI",10,1,8,19,"2016","093"
"18424","MASSIOLA",2,0,0,2,"2016","043"
"18425","MATHI",62,0,0,62,"2016","146"
"18426","MATTIE",13,0,0,13,"2016","147"
"18427","MAZZANO",67,755,2,824,"2016","107"
"18428","MAZZE'",975,0,0,975,"2016","148"
"18429","MAZZO DI VALTELLINA",28,20,5,53,"2016","040"
"18430","MEANA DI SUSA",5,0,0,5,"2016","149"
"18431","MEDE",26,71,0,97,"2016","088"
"18432","MEDESANO",95,1402,0,1497,"2016","020"
"18433","MEDICINA",131,102,0,233,"2016","037"
"18434","MEDIGLIA",3,1294,111,1408,"2016","139"
"18435","MEDOLAGO",9,0,0,9,"2016","250"
"18436","MEDOLE",520,418,611,1549,"2016","034"
"18437","MEDOLLA",0,590,0,590,"2016","021"
"18438","MEDUNA DI LIVENZA",13,14,0,27,"2016","041"
"18439","MEGLIADINO SAN FIDENZIO",834,0,0,834,"2016","051"
"18440","MEGLIADINO SAN VITALE",1717,0,0,1717,"2016","052"
"18441","MEL",68,189,0,257,"2016","034"
"18442","MELARA",261,0,0,261,"2016","032"
"18443","MELAZZO",189,0,0,189,"2016","092"
"18444","MELDOLA",142,31,0,173,"2016","019"
"18445","MELEGNANO",1,114,0,115,"2016","140"
"18446","MELETI",49,406,0,455,"2016","038"
"18447","MELLE",256,0,26,282,"2016","122"
"18448","MELLO",18,48,0,66,"2016","041"
"18449","MELZO",168,238,0,406,"2016","142"
"18450","MENAGGIO",1,0,1,2,"2016","145"
"18451","MENCONICO",7,0,0,7,"2016","089"
"18452","MEOLO",47,146,0,193,"2016","022"
"18453","MERANA",25,0,0,25,"2016","093"
"18454","MERATE",71,285,32,388,"2016","048"
"18455","MERCATO SARACENO",218,15,2,235,"2016","020"
"18456","MERCENASCO",281,0,0,281,"2016","150"
"18457","MERGOZZO",30,0,0,30,"2016","044"
"18458","MERLARA",543,8,0,551,"2016","053"
"18459","MERLINO",0,1051,0,1051,"2016","039"
"18460","MERONE",35,62,10,107,"2016","147"
"18461","MESE",16,28,10,54,"2016","043"
"18462","MESENZANA",1,32,0,33,"2016","102"
"18463","MESERO",4,66,0,70,"2016","144"
"18464","MESOLA",1067,239,0,1306,"2016","014"
"18465","MESTRINO",57,78,98,233,"2016","054"
"18466","MEUGLIANO",4,0,0,4,"2016","151"
"18467","MEZZANA BIGLI",136,0,0,136,"2016","090"
"18468","MEZZANE DI SOTTO",1,26,0,27,"2016","047"
"18469","MEZZANI",2,285,5,292,"2016","021"
"18470","MEZZANINO",2,0,0,2,"2016","092"
"18471","MEZZENILE",21,0,24,45,"2016","152"
"18472","MEZZOLDO",2,19,0,21,"2016","134"
"18473","MEZZOMERICO",5,0,0,5,"2016","097"
"18474","MIAGLIANO",2,0,0,2,"2016","034"
"18475","MIANE",12,9,0,21,"2016","042"
"18476","MIASINO",0,0,43,43,"2016","098"
"18477","MIAZZINA",2,0,0,2,"2016","045"
"18478","MILANO",355,85,0,440,"2016","146"
"18479","MILZANO",2,916,0,918,"2016","108"
"18480","MINERBE",1963,233,0,2196,"2016","048"
"18481","MINERBIO",61,0,0,61,"2016","038"
"18482","MIRA",1606,575,17,2198,"2016","023"
"18483","MIRABELLO MONFERRATO",72,0,0,72,"2016","094"
"18484","MIRADOLO TERME",27,12,29,68,"2016","093"
"18485","MIRANDOLA",420,1353,0,1773,"2016","022"
"18486","MIRANO",344,698,0,1042,"2016","024"
"18487","MISANO ADRIATICO",24,0,0,24,"2016","005"
"18488","MISANO DI GERA D'ADDA",13,257,20,290,"2016","135"
"18489","MISSAGLIA",13,266,254,533,"2016","049"
"18490","MODENA",92,2212,0,2304,"2016","023"
"18491","MODIGLIANA",98,0,2,100,"2016","022"
"18492","MOGLIA",3857,773,1273,5903,"2016","035"
"18493","MOGLIANO VENETO",1086,541,122,1749,"2016","043"
"18494","MOIO DE' CALVI",2,12,0,14,"2016","136"
"18495","MOIOLA",35,5,0,40,"2016","123"
"18496","MOLARE",3,0,0,3,"2016","095"
"18497","MOLINELLA",2078,149,0,2227,"2016","039"
"18498","MOLLIA",4,0,0,4,"2016","078"
"18499","MOLTENO",13,45,0,58,"2016","051"
"18500","MOLVENA",11,5,0,16,"2016","059"
"18501","MOMBALDONE",52,0,2,54,"2016","064"
"18502","MOMBARCARO",111,0,0,111,"2016","124"
"18503","MOMBARUZZO",6,0,0,6,"2016","065"
"18504","MOMBASIGLIO",103,0,0,103,"2016","125"
"18505","MOMBELLO DI TORINO",46,0,0,46,"2016","153"
"18506","MOMBELLO MONFERRATO",42,0,0,42,"2016","097"
"18507","MOMBERCELLI",40,0,0,40,"2016","066"
"18508","MOMO",183,480,0,663,"2016","100"
"18509","MOMPERONE",8,0,0,8,"2016","098"
"18510","MONALE",37,0,0,37,"2016","067"
"18511","MONASTERO BORMIDA",416,0,0,416,"2016","068"
"18512","MONASTERO DI LANZO",14,81,1,96,"2016","155"
"18513","MONASTERO DI VASCO",401,0,46,447,"2016","126"
"18514","MONASTEROLO CASOTTO",42,0,0,42,"2016","127"
"18515","MONASTEROLO DEL CASTELLO",5,16,0,21,"2016","137"
"18516","MONASTEROLO DI SAVIGLIANO",421,295,109,825,"2016","128"
"18517","MONASTIER DI TREVISO",2118,376,0,2494,"2016","044"
"18518","MONCALIERI",188,408,0,596,"2016","156"
"18519","MONCALVO",109,0,0,109,"2016","069"
"18520","MONCENISIO",4,0,0,4,"2016","157"
"18521","MONCESTINO",4,0,0,4,"2016","099"
"18522","MONCHIERO",210,0,0,210,"2016","129"
"18523","MONCHIO DELLE CORTI",29,121,0,150,"2016","022"
"18524","MONCRIVELLO",122,234,0,356,"2016","079"
"18525","MONCUCCO TORINESE",22,0,0,22,"2016","070"
"18526","MONDAINO",5,0,0,5,"2016","006"
"18527","MONDOVI'",5567,22,314,5903,"2016","130"
"18528","MONESIGLIO",78,0,0,78,"2016","131"
"18529","MONFORTE D'ALBA",236,0,0,236,"2016","132"
"18530","MONFUMO",43,254,0,297,"2016","045"
"18531","MONGARDINO",25,0,0,25,"2016","071"
"18532","MONGHIDORO",37,57,0,94,"2016","040"
"18533","MONGIARDINO LIGURE",15,0,25,40,"2016","100"
"18534","MONGRANDO",88,100,7,195,"2016","035"
"18535","MONGUZZO",23,0,0,23,"2016","153"
"18536","MONIGA DEL GARDA",0,1,0,1,"2016","109"
"18537","MONNO",6,39,2,47,"2016","110"
"18538","MONSELICE",448,65,0,513,"2016","055"
"18539","MONTA'",151,0,0,151,"2016","133"
"18540","MONTABONE",106,0,0,106,"2016","072"
"18541","MONTACUTO",21,0,0,21,"2016","102"
"18542","MONTAFIA",45,0,0,45,"2016","073"
"18543","MONTAGNA IN VALTELLINA",13,60,1,74,"2016","044"
"18544","MONTAGNANA",1513,49,0,1562,"2016","056"
"18545","MONTALDO DI MONDOVI'",91,5,14,110,"2016","134"
"18546","MONTALDO ROERO",7,0,0,7,"2016","135"
"18547","MONTALDO SCARAMPI",28,0,0,28,"2016","074"
"18548","MONTALDO TORINESE",586,0,0,586,"2016","158"
"18549","MONTALENGHE",5,0,0,5,"2016","159"
"18550","MONTALTO DORA",29,0,0,29,"2016","160"
"18551","MONTALTO PAVESE",76,0,0,76,"2016","094"
"18552","MONTANARO",175,104,14,293,"2016","161"
"18553","MONTANASO LOMBARDO",70,396,0,466,"2016","040"
"18554","MONTANERA",1574,992,112,2678,"2016","136"
"18555","MONTANO LUCINO",14,13,5,32,"2016","154"
"18556","MONTE CREMASCO",299,100,12,411,"2016","058"
"18557","MONTE DI MALO",736,177,0,913,"2016","063"
"18558","MONTE ISOLA",22,0,0,22,"2016","111"
"18559","MONTE MARENZO",11,0,2,13,"2016","052"
"18560","MONTE SAN PIETRO",104,174,0,278,"2016","042"
"18561","MONTEBELLO DELLA BATTAGLIA",0,48,0,48,"2016","095"
"18562","MONTEBELLO VICENTINO",85,0,186,271,"2016","060"
"18563","MONTEBELLUNA",3836,627,41,4504,"2016","046"
"18564","MONTECALVO VERSIGGIA",1,0,0,1,"2016",NA
"18565","MONTECASTELLO",9,0,0,9,"2016","105"
"18566","MONTECCHIA DI CROSARA",761,0,0,761,"2016","049"
"18567","MONTECCHIO EMILIA",1,1368,0,1369,"2016","027"
"18568","MONTECCHIO MAGGIORE",219,64,0,283,"2016","061"
"18569","MONTECCHIO PRECALCINO",201,152,64,417,"2016","062"
"18570","MONTECHIARO D'ACQUI",42,0,0,42,"2016","106"
"18571","MONTECHIARO D'ASTI",244,0,0,244,"2016","075"
"18572","MONTECHIARUGOLO",6,3236,0,3242,"2016","023"
"18573","MONTECRESTESE",28,26,0,54,"2016","046"
"18574","MONTECRETO",12,434,0,446,"2016","024"
"18575","MONTEFIORE CONCA",33,4,0,37,"2016","008"
"18576","MONTEFIORINO",3,440,0,443,"2016","025"
"18577","MONTEFORTE D'ALPONE",815,2,0,817,"2016","050"
"18578","MONTEGALDA",39,392,0,431,"2016","064"
"18579","MONTEGALDELLA",58,324,0,382,"2016","065"
"18580","MONTEGIOCO",34,0,0,34,"2016","107"
"18581","MONTEGRIDOLFO",3,0,0,3,"2016","009"
"18582","MONTEGRINO VALTRAVAGLIA",10,0,0,10,"2016","103"
"18583","MONTEGROSSO D'ASTI",26,0,0,26,"2016","076"
"18584","MONTEGROTTO TERME",18,0,37,55,"2016","057"
"18585","MONTELLO",2,0,0,2,"2016","139"
"18586","MONTELUPO ALBESE",88,0,0,88,"2016","137"
"18587","MONTEMAGNO",114,0,0,114,"2016","077"
"18588","MONTEMALE DI CUNEO",115,0,0,115,"2016","138"
"18589","MONTEMEZZO",1,0,0,1,"2016","155"
"18590","MONTERENZIO",350,191,0,541,"2016","041"
"18591","MONTEROSSO GRANA",7,140,0,147,"2016","139"
"18592","MONTESCANO",1,0,0,1,"2016","097"
"18593","MONTESCUDO-MONTE COLOMBO",205,0,0,205,"2016",NA
"18594","MONTESE",75,1346,0,1421,"2016","026"
"18595","MONTESEGALE",11,0,0,11,"2016","098"
"18596","MONTEU DA PO",122,0,0,122,"2016","162"
"18597","MONTEU ROERO",620,0,0,620,"2016","140"
"18598","MONTEVECCHIA",8,0,2,10,"2016","053"
"18599","MONTEVIALE",56,5,2,63,"2016","066"
"18600","MONTEZEMOLO",97,0,0,97,"2016","141"
"18601","MONTICELLI BRUSATI",12,251,1,264,"2016","112"
"18602","MONTICELLI D'ONGINA",398,574,0,972,"2016","027"
"18603","MONTICELLI PAVESE",1373,330,0,1703,"2016","099"
"18604","MONTICELLO BRIANZA",12,0,287,299,"2016","054"
"18605","MONTICELLO CONTE OTTO",53,826,0,879,"2016","067"
"18606","MONTICELLO D'ALBA",54,0,0,54,"2016","142"
"18607","MONTICHIARI",9253,7560,427,17240,"2016","113"
"18608","MONTIGLIO MONFERRATO",225,0,0,225,"2016","121"
"18609","MONTIRONE",4202,441,0,4643,"2016","114"
"18610","MONTODINE",3,1204,0,1207,"2016","059"
"18611","MONTORFANO",16,0,0,16,"2016","157"
"18612","MONTORSO VICENTINO",567,167,0,734,"2016","068"
"18613","MONTU' BECCARIA",3,0,0,3,"2016","100"
"18614","MONVALLE",14,26,0,40,"2016","104"
"18615","MONZA",45,64,0,109,"2016",NA
"18616","MONZAMBANO",1120,623,693,2436,"2016","036"
"18617","MONZUNO",70,78,0,148,"2016","044"
"18618","MORANO SUL PO",3,0,0,3,"2016","109"
"18619","MORANSENGO",127,0,0,127,"2016","079"
"18620","MORAZZONE",10,83,19,112,"2016","105"
"18621","MORBEGNO",10,110,5,125,"2016","045"
"18622","MORBELLO",1,0,0,1,"2016","110"
"18623","MORDANO",1,0,0,1,"2016","045"
"18624","MORENGO",55,67,0,122,"2016","140"
"18625","MORETTA",1609,555,257,2421,"2016","143"
"18626","MORFASSO",89,9,0,98,"2016","028"
"18627","MORGANO",1784,6,0,1790,"2016","047"
"18628","MORIAGO DELLA BATTAGLIA",2347,72,0,2419,"2016","048"
"18629","MORIMONDO",40,1532,0,1572,"2016","150"
"18630","MORIONDO TORINESE",262,0,0,262,"2016","163"
"18631","MORNAGO",35,0,0,35,"2016","106"
"18632","MORNESE",27,0,0,27,"2016","111"
"18633","MORNICO AL SERIO",429,478,113,1020,"2016","141"
"18634","MORNICO LOSANA",27,0,0,27,"2016","101"
"18635","MOROZZO",2242,579,415,3236,"2016","144"
"18636","MORSASCO",129,0,0,129,"2016","112"
"18637","MORTARA",31,0,0,31,"2016","102"
"18638","MORTERONE",24,16,0,40,"2016","055"
"18639","MOSCAZZANO",3,1087,293,1383,"2016","060"
"18640","MOSSANO",538,31,0,569,"2016","069"
"18641","MOSSO",55,8,13,76,"2016","084"
"18642","MOTTA BALUFFI",2,86,0,88,"2016","061"
"18643","MOTTA DI LIVENZA",28,24,1,53,"2016","049"
"18644","MOTTA VISCONTI",5,0,0,5,"2016","151"
"18645","MOTTALCIATA",72,68,0,140,"2016","037"
"18646","MOTTEGGIANA",684,870,822,2376,"2016","037"
"18647","MOZZANICA",99,742,0,841,"2016","142"
"18648","MOZZATE",14,109,0,123,"2016","159"
"18649","MOZZECANE",3279,912,0,4191,"2016","051"
"18650","MUGGIÒ",4,0,0,4,"2016",NA
"18651","MULAZZANO",10,1177,0,1187,"2016","041"
"18652","MURA",28,5,11,44,"2016","115"
"18653","MURAZZANO",331,0,20,351,"2016","145"
"18654","MURELLO",475,1227,232,1934,"2016","146"
"18655","MURISENGO",308,0,0,308,"2016","113"
"18656","MUSCOLINE",63,470,13,546,"2016","116"
"18657","MUSILE DI PIAVE",21,36,5,62,"2016","025"
"18658","MUSSO",3,5,4,12,"2016","160"
"18659","MUSSOLENTE",145,224,99,468,"2016","070"
"18660","MUZZANO",31,0,0,31,"2016","038"
"18661","NANTO",310,186,0,496,"2016","071"
"18662","NARZOLE",855,167,0,1022,"2016","147"
"18663","NAVE",40,131,0,171,"2016","117"
"18664","NEBBIUNO",63,0,11,74,"2016","103"
"18665","NEGRAR",8,106,0,114,"2016","052"
"18666","NEIVE",21,0,0,21,"2016","148"
"18667","NEMBRO",36,0,0,36,"2016","144"
"18668","NERVESA DELLA BATTAGLIA",572,243,0,815,"2016","050"
"18669","NERVIANO",31,134,0,165,"2016","154"
"18670","NESSO",0,15,0,15,"2016","161"
"18671","NETRO",101,39,0,140,"2016","039"
"18672","NEVIANO DEGLI ARDUINI",38,1880,0,1918,"2016","024"
"18673","NIARDO",1,139,17,157,"2016","118"
"18674","NIBBIANO",203,0,0,203,"2016","029"
"18675","NIBBIOLA",3,0,0,3,"2016",NA
"18676","NIBIONNO",12,0,0,12,"2016","056"
"18677","NICHELINO",59,0,9,68,"2016","164"
"18678","NICORVO",3,0,0,3,"2016","103"
"18679","NIELLA BELBO",140,0,0,140,"2016","150"
"18680","NIELLA TANARO",422,0,0,422,"2016","151"
"18681","NIZZA MONFERRATO",68,4,0,72,"2016","080"
"18682","NOALE",346,66,6,418,"2016","026"
"18683","NOASCA",13,20,38,71,"2016","165"
"18684","NOCETO",55,3134,9,3198,"2016","025"
"18685","NOGARA",2423,403,51,2877,"2016","053"
"18686","NOGAROLE ROCCA",303,321,0,624,"2016","054"
"18687","NOGAROLE VICENTINO",14,22,4,40,"2016","072"
"18688","NOLE",246,83,68,397,"2016","166"
"18689","NONANTOLA",10,204,0,214,"2016","027"
"18690","NONE",836,896,366,2098,"2016","168"
"18691","NONIO",2,0,0,2,"2016",NA
"18692","NOSATE",19,0,0,19,"2016","155"
"18693","NOVA MILANESE",0,55,0,55,"2016",NA
"18694","NOVAFELTRIA",1073,139,0,1212,"2016","023"
"18695","NOVALESA",47,20,0,67,"2016","169"
"18696","NOVARA",38,288,0,326,"2016","106"
"18697","NOVATE MEZZOLA",2,16,8,26,"2016","046"
"18698","NOVATE MILANESE",3,0,0,3,"2016",NA
"18699","NOVE",20,243,0,263,"2016","073"
"18700","NOVEDRATE",562,0,0,562,"2016","163"
"18701","NOVELLARA",3137,2044,0,5181,"2016","028"
"18702","NOVELLO",1032,0,0,1032,"2016","152"
"18703","NOVENTA DI PIAVE",7,18,0,25,"2016","027"
"18704","NOVENTA PADOVANA",8,0,0,8,"2016","058"
"18705","NOVENTA VICENTINA",3988,0,0,3988,"2016","074"
"18706","NOVI DI MODENA",1152,728,0,1880,"2016","028"
"18707","NOVI LIGURE",548,0,0,548,"2016","114"
"18708","NOVIGLIO",11,466,0,477,"2016","158"
"18709","NUVOLENTO",9,929,0,938,"2016","119"
"18710","NUVOLERA",1380,383,0,1763,"2016","120"
"18711","OCCHIEPPO INFERIORE",6,119,10,135,"2016","040"
"18712","OCCHIEPPO SUPERIORE",45,50,34,129,"2016","041"
"18713","OCCHIOBELLO",2,149,0,151,"2016","033"
"18714","OCCIMIANO",37,0,0,37,"2016","115"
"18715","ODALENGO GRANDE",70,0,0,70,"2016","116"
"18716","ODERZO",87,290,0,377,"2016","051"
"18717","ODOLO",2,0,0,2,"2016","121"
"18718","OFFANENGO",267,500,0,767,"2016","062"
"18719","OFFLAGA",85,3611,74,3770,"2016","122"
"18720","OGGEBBIO",3,0,0,3,"2016","049"
"18721","OGGIONA CON SANTO STEFANO",2,35,0,37,"2016","107"
"18722","OGGIONO",53,62,4,119,"2016","057"
"18723","OGLIANICO",68,311,0,379,"2016","170"
"18724","OLDENICO",2,0,0,2,"2016","089"
"18725","OLEGGIO",192,957,0,1149,"2016","108"
"18726","OLEGGIO CASTELLO",2,0,0,2,"2016","109"
"18727","OLGIATE COMASCO",35,38,21,94,"2016","165"
"18728","OLGIATE MOLGORA",19,89,0,108,"2016","058"
"18729","OLGIATE OLONA",3,0,0,3,"2016","108"
"18730","OLGINATE",16,0,0,16,"2016","059"
"18731","OLIVA GESSI",12,0,0,12,"2016",NA
"18732","OLIVETO LARIO",20,0,0,20,"2016","060"
"18733","OLMENETA",14,396,125,535,"2016","063"
"18734","OLMO AL BREMBO",3,7,0,10,"2016","145"
"18735","OLMO GENTILE",30,0,10,40,"2016","081"
"18736","OLTRE IL COLLE",24,65,0,89,"2016","146"
"18737","OLTRESSENDA ALTA",7,32,0,39,"2016","147"
"18738","OLTRONA DI SAN MAMETTE",15,0,0,15,"2016","169"
"18739","OME",19,18,0,37,"2016","123"
"18740","OMEGNA",28,0,0,28,"2016","050"
"18741","ONCINO",0,0,91,91,"2016","154"
"18742","ONETA",3,39,0,42,"2016","148"
"18743","ONO SAN PIETRO",1,10,2,13,"2016","124"
"18744","ONORE",26,22,0,48,"2016","149"
"18745","OPERA",0,182,0,182,"2016","159"
"18746","OPPEANO",4310,890,0,5200,"2016","055"
"18747","ORBASSANO",765,0,167,932,"2016","171"
"18748","ORGIANO",184,23,0,207,"2016","075"
"18749","ORIGGIO",50,0,11,61,"2016","109"
"18750","ORINO",2,0,0,2,"2016","110"
"18751","ORIO CANAVESE",65,0,0,65,"2016","172"
"18752","ORIO LITTA",1,90,0,91,"2016","042"
"18753","ORMEA",133,0,8,141,"2016","155"
"18754","ORMELLE",31,124,0,155,"2016","052"
"18755","ORNAGO",0,60,0,60,"2016",NA
"18756","ORNAVASSO",9,0,4,13,"2016","051"
"18757","ORNICA",4,0,0,4,"2016","151"
"18758","ORSAGO",12,138,0,150,"2016","053"
"18759","ORSARA BORMIDA",9,0,0,9,"2016","119"
"18760","ORSENIGO",5,49,2,56,"2016","170"
"18761","ORZINUOVI",102,4740,9,4851,"2016","125"
"18762","ORZIVECCHI",16,662,0,678,"2016","126"
"18763","OSASCO",358,0,86,444,"2016","173"
"18764","OSASIO",196,166,110,472,"2016","174"
"18765","OSIO SOPRA",12,630,0,642,"2016","152"
"18766","OSIO SOTTO",15,0,0,15,"2016","153"
"18767","OSMATE",12,0,0,12,"2016","111"
"18768","OSNAGO",217,79,0,296,"2016","061"
"18769","OSPEDALETTO EUGANEO",174,23,0,197,"2016","059"
"18770","OSPEDALETTO LODIGIANO",0,935,0,935,"2016","043"
"18771","OSPITALETTO",168,172,0,340,"2016","127"
"18772","OSSAGO LODIGIANO",39,1652,8,1699,"2016","044"
"18773","OSSIMO",1,13,5,19,"2016","128"
"18774","OSSONA",30,0,0,30,"2016","164"
"18775","OSTANA",8,0,37,45,"2016","156"
"18776","OSTELLATO",3431,1,0,3432,"2016","017"
"18777","OSTIANO",442,1468,59,1969,"2016","064"
"18778","OSTIGLIA",28,43,45,116,"2016","038"
"18779","OTTIGLIO",106,0,0,106,"2016","120"
"18780","OTTOBIANO",1,38,0,39,"2016","106"
"18781","OTTONE",100,3,0,103,"2016","030"
"18782","OULX",45,0,0,45,"2016","175"
"18783","OVADA",31,0,0,31,"2016","121"
"18784","OVIGLIO",28,16,0,44,"2016","122"
"18785","OZEGNA",157,5,0,162,"2016","176"
"18786","OZZANO DELL'EMILIA",157,258,0,415,"2016","046"
"18787","OZZANO MONFERRATO",60,0,0,60,"2016","123"
"18788","OZZERO",17,324,0,341,"2016","165"
"18789","PADENGHE SUL GARDA",62,0,30,92,"2016","129"
"18790","PADERNO D'ADDA",0,18,0,18,"2016","062"
"18791","PADERNO DEL GRAPPA",49,150,0,199,"2016","054"
"18792","PADERNO DUGNANO",29,0,0,29,"2016","166"
"18793","PADERNO FRANCIACORTA",2,126,149,277,"2016","130"
"18794","PADERNO PONCHIELLI",160,2064,87,2311,"2016","065"
"18795","PADOVA",596,304,71,971,"2016","060"
"18796","PAESANA",720,12,9,741,"2016","157"
"18797","PAESE",2134,715,89,2938,"2016","055"
"18798","PAGNO",66,0,0,66,"2016","158"
"18799","PAGNONA",19,0,0,19,"2016","063"
"18800","PAISCO LOVENO",0,15,3,18,"2016","131"
"18801","PAITONE",30,12,0,42,"2016","132"
"18802","PALADINA",2,0,0,2,"2016","155"
"18803","PALAGANO",47,631,0,678,"2016","029"
"18804","PALANZANO",6,470,0,476,"2016","026"
"18805","PALAZZAGO",94,100,0,194,"2016","156"
"18806","PALAZZO CANAVESE",1,0,0,1,"2016","177"
"18807","PALAZZO PIGNANO",9,849,0,858,"2016","066"
"18808","PALAZZOLO SULL'OGLIO",1328,1403,91,2822,"2016","133"
"18809","PALAZZOLO VERCELLESE",6,0,0,6,"2016","090"
"18810","PALESTRO",2,0,20,22,"2016","107"
"18811","PALLANZENO",19,0,0,19,"2016","052"
"18812","PALOSCO",438,422,0,860,"2016","157"
"18813","PALU'",160,0,0,160,"2016","056"
"18814","PAMPARATO",43,0,0,43,"2016","159"
"18815","PANCALIERI",88,133,0,221,"2016","178"
"18816","PANDINO",91,3979,80,4150,"2016","067"
"18817","PANTIGLIATE",2,0,0,2,"2016","167"
"18818","PAPOZZE",144,94,0,238,"2016","034"
"18819","PARABIAGO",96,45,0,141,"2016","168"
"18820","PARATICO",11,34,0,45,"2016","134"
"18821","PARETO",50,1,0,51,"2016","125"
"18822","PARMA",201,9663,5,9869,"2016","027"
"18823","PARODI LIGURE",40,0,34,74,"2016","126"
"18824","PAROLDO",31,0,0,31,"2016","160"
"18825","PARONA",8,0,0,8,"2016","109"
"18826","PARRE",38,57,0,95,"2016","158"
"18827","PARUZZARO",27,36,0,63,"2016","114"
"18828","PARZANICA",4,0,4,8,"2016","159"
"18829","PASPARDO",1,1,3,5,"2016","135"
"18830","PASSERANO MARMORITO",89,0,0,89,"2016","082"
"18831","PASSIRANO",79,158,53,290,"2016","136"
"18832","PASTRENGO",0,170,0,170,"2016","057"
"18833","PASTURO",60,146,26,232,"2016","065"
"18834","PAULLO",0,585,0,585,"2016","169"
"18835","PAVAROLO",58,0,0,58,"2016","180"
"18836","PAVIA",178,231,9,418,"2016","110"
"18837","PAVONE CANAVESE",150,0,0,150,"2016","181"
"18838","PAVONE DEL MELLA",1700,466,6,2172,"2016","137"
"18839","PAVULLO NEL FRIGNANO",152,3775,0,3927,"2016","030"
"18840","PECETTO DI VALENZA",30,0,0,30,"2016","128"
"18841","PECETTO TORINESE",94,0,0,94,"2016","183"
"18842","PECORARA",309,115,0,424,"2016","031"
"18843","PEDAVENA",6,135,0,141,"2016","036"
"18844","PEDEMONTE",0,3,13,16,"2016","076"
"18845","PEDEROBBA",74,165,0,239,"2016","056"
"18846","PEDRENGO",11,203,0,214,"2016","160"
"18847","PEGLIO",2,0,14,16,"2016","178"
"18848","PEGOGNAGA",1932,1870,1980,5782,"2016","039"
"18849","PEIA",7,12,1,20,"2016","161"
"18850","PELLEGRINO PARMENSE",12,703,0,715,"2016","028"
"18851","PELLIO INTELVI",12,17,28,57,"2016","179"
"18852","PENANGO",68,0,0,68,"2016","083"
"18853","PENNABILLI",297,16,0,313,"2016","024"
"18854","PERLEDO",3,0,0,3,"2016","067"
"18855","PERLETTO",225,0,0,225,"2016","161"
"18856","PERLO",49,0,0,49,"2016","162"
"18857","PERNUMIA",387,156,0,543,"2016","061"
"18858","PEROSA ARGENTINA",56,7,0,63,"2016","184"
"18859","PEROSA CANAVESE",107,235,0,342,"2016","185"
"18860","PERRERO",36,0,0,36,"2016","186"
"18861","PERSICO DOSIMO",1,1845,0,1846,"2016","068"
"18862","PERTENGO",1,0,0,1,"2016","091"
"18863","PERTICA ALTA",5,1,2,8,"2016","139"
"18864","PERTICA BASSA",29,53,1,83,"2016","140"
"18865","PERTUSIO",64,0,0,64,"2016","187"
"18866","PESCANTINA",34,85,6,125,"2016","058"
"18867","PESCAROLO ED UNITI",71,796,0,867,"2016","069"
"18868","PESCHIERA BORROMEO",24,445,0,469,"2016","171"
"18869","PESSANO CON BORNAGO",72,125,0,197,"2016","172"
"18870","PESSINA CREMONESE",426,2865,0,3291,"2016","070"
"18871","PESSINETTO",2,0,0,2,"2016","188"
"18872","PETTENASCO",10,0,0,10,"2016","116"
"18873","PETTINENGO",5,0,18,23,"2016","042"
"18874","PETTORAZZA GRIMANI",441,255,0,696,"2016","035"
"18875","PEVERAGNO",1068,523,55,1646,"2016","163"
"18876","PEZZAZE",12,22,0,34,"2016","141"
"18877","PEZZOLO VALLE UZZONE",54,0,0,54,"2016","164"
"18878","PIACENZA",545,1238,0,1783,"2016","032"
"18879","PIACENZA D'ADIGE",683,0,0,683,"2016","062"
"18880","PIADENA",0,407,0,407,"2016","071"
"18881","PIAN CAMUNO",0,313,0,313,"2016","142"
"18882","PIANCOGNO",7,42,7,56,"2016","206"
"18883","PIANELLO DEL LARIO",6,0,9,15,"2016","183"
"18884","PIANELLO VAL TIDONE",368,92,0,460,"2016","033"
"18885","PIANENGO",1,131,0,132,"2016","072"
"18886","PIANEZZA",347,480,42,869,"2016","189"
"18887","PIANEZZE",222,33,0,255,"2016","077"
"18888","PIANFEI",755,52,56,863,"2016","165"
"18889","PIANICO",11,75,0,86,"2016","162"
"18890","PIANIGA",44,36,5,85,"2016","028"
"18891","PIANORO",159,230,4,393,"2016","047"
"18892","PIANTEDO",15,323,2,340,"2016","048"
"18893","PIARIO",0,0,19,19,"2016","163"
"18894","PIASCO",294,228,21,543,"2016","166"
"18895","PIATEDA",24,64,0,88,"2016","049"
"18896","PIATTO",31,0,0,31,"2016","043"
"18897","PIAZZA BREMBANA",0,3,0,3,"2016","164"
"18898","PIAZZATORRE",0,3,0,3,"2016","165"
"18899","PIAZZOLA SUL BRENTA",1134,1150,0,2284,"2016","063"
"18900","PIAZZOLO",12,0,3,15,"2016","166"
"18901","PIEA",72,0,0,72,"2016","084"
"18902","PIEDIMULERA",0,27,0,27,"2016","053"
"18903","PIERANICA",40,0,0,40,"2016","073"
"18904","PIETRA DE' GIORGI",18,0,0,18,"2016","111"
"18905","PIEVE D'OLMI",2,1414,437,1853,"2016","074"
"18906","PIEVE DEL CAIRO",20,65,0,85,"2016","113"
"18907","PIEVE DI CADORE",0,18,0,18,"2016","039"
"18908","PIEVE DI CORIANO",0,0,35,35,"2016","040"
"18909","PIEVE DI SOLIGO",44,131,3,178,"2016","057"
"18910","PIEVE EMANUELE",0,358,81,439,"2016","173"
"18911","PIEVE FISSIRAGA",89,1356,34,1479,"2016","045"
"18912","PIEVE PORTO MORONE",117,0,0,117,"2016","114"
"18913","PIEVE SAN GIACOMO",0,1913,0,1913,"2016","075"
"18914","PIEVE VERGONTE",35,10,39,84,"2016","054"
"18915","PIEVEPELAGO",39,84,0,123,"2016","031"
"18916","PINAROLO PO",2135,0,0,2135,"2016","115"
"18917","PINASCA",93,40,0,133,"2016","190"
"18918","PINCARA",407,0,0,407,"2016","036"
"18919","PINEROLO",1717,173,143,2033,"2016","191"
"18920","PINO D'ASTI",3,0,0,3,"2016","085"
"18921","PINO TORINESE",541,0,45,586,"2016","192"
"18922","PIOBESI TORINESE",455,974,210,1639,"2016","193"
"18923","PIODE",0,6,7,13,"2016","097"
"18924","PIOLTELLO",8,0,0,8,"2016","175"
"18925","PIOMBINO DESE",6090,463,0,6553,"2016","064"
"18926","PIOSSASCO",490,485,181,1156,"2016","194"
"18927","PIOVA' MASSAIA",172,0,0,172,"2016","086"
"18928","PIOVE DI SACCO",3192,159,0,3351,"2016","065"
"18929","PIOVENE ROCCHETTE",1864,127,0,1991,"2016","078"
"18930","PIOVERA",186,243,0,429,"2016","130"
"18931","PIOZZANO",148,9,0,157,"2016","034"
"18932","PIOZZO",371,0,0,371,"2016","169"
"18933","PISCINA",1533,0,0,1533,"2016","195"
"18934","PISOGNE",7,227,13,247,"2016","143"
"18935","PIUBEGA",3820,642,56,4518,"2016","041"
"18936","PIURO",12,186,4,202,"2016","050"
"18937","PIVERONE",49,122,0,171,"2016","196"
"18938","PIZZIGHETTONE",87,3362,0,3449,"2016","076"
"18939","PLESIO",5,0,1,6,"2016","185"
"18940","POCAPAGLIA",257,20,0,277,"2016","170"
"18941","PODENZANO",67,830,0,897,"2016","035"
"18942","POGGIO RENATICO",4,424,0,428,"2016","018"
"18943","POGGIO RUSCO",548,439,442,1429,"2016","042"
"18944","POGGIO TORRIANA",512,0,0,512,"2016",NA
"18945","POGGIRIDENTI",4,5,0,9,"2016","051"
"18946","POGLIANO MILANESE",1,0,0,1,"2016","176"
"18947","POGNANO",10,332,47,389,"2016","167"
"18948","POIRINO",3507,618,0,4125,"2016","197"
"18949","POJANA MAGGIORE",1338,28,0,1366,"2016","079"
"18950","POLAVENO",31,3,0,34,"2016","144"
"18951","POLESINE ZIBELLO",3,1320,0,1323,"2016",NA
"18952","POLINAGO",79,725,0,804,"2016","032"
"18953","POLLONE",189,50,0,239,"2016","046"
"18954","POLONGHERA",192,143,42,377,"2016","171"
"18955","POLPENAZZE DEL GARDA",20,114,0,134,"2016","145"
"18956","POLVERARA",22,75,0,97,"2016","066"
"18957","POMARETTO",45,0,18,63,"2016","198"
"18958","POMARO MONFERRATO",8,0,209,217,"2016","131"
"18959","POMBIA",3,69,0,72,"2016","121"
"18960","POMPIANO",17,1373,0,1390,"2016","146"
"18961","POMPONESCO",4,399,15,418,"2016","043"
"18962","PONCARALE",37,758,123,918,"2016","147"
"18963","PONDERANO",55,39,42,136,"2016","047"
"18964","PONNA",1,0,13,14,"2016","187"
"18965","PONSO",36,0,0,36,"2016","067"
"18966","PONT-CANAVESE",39,73,0,112,"2016","199"
"18967","PONTE DELL'OLIO",82,162,0,244,"2016","036"
"18968","PONTE DI LEGNO",2,35,0,37,"2016","148"
"18969","PONTE DI PIAVE",64,61,2,127,"2016","058"
"18970","PONTE IN VALTELLINA",10,15,0,25,"2016","052"
"18971","PONTE LAMBRO",1,19,0,20,"2016","188"
"18972","PONTE NELLE ALPI",27,157,0,184,"2016","040"
"18973","PONTE NIZZA",88,28,0,116,"2016","117"
"18974","PONTE NOSSA",0,32,0,32,"2016","168"
"18975","PONTE SAN NICOLO'",317,37,19,373,"2016","069"
"18976","PONTE SAN PIETRO",4,0,0,4,"2016","170"
"18977","PONTECCHIO POLESINE",1011,0,0,1011,"2016","038"
"18978","PONTECHIANALE",175,0,0,175,"2016","172"
"18979","PONTECURONE",2,0,0,2,"2016","132"
"18980","PONTELONGO",465,0,0,465,"2016","068"
"18981","PONTENURE",67,125,0,192,"2016","037"
"18982","PONTERANICA",2,0,0,2,"2016","169"
"18983","PONTESTURA",8,0,0,8,"2016","133"
"18984","PONTEVICO",104,3360,378,3842,"2016","149"
"18985","PONTI",79,0,15,94,"2016","134"
"18986","PONTI SUL MINCIO",229,418,32,679,"2016","044"
"18987","PONTIDA",20,0,0,20,"2016","171"
"18988","PONTIROLO NUOVO",346,540,0,886,"2016","172"
"18989","PONTOGLIO",703,1085,137,1925,"2016","150"
"18990","PONZANO MONFERRATO",34,0,0,34,"2016","135"
"18991","PONZANO VENETO",408,230,0,638,"2016","059"
"18992","PONZONE",33,7,0,40,"2016","136"
"18993","PORLEZZA",8,29,17,54,"2016","189"
"18994","PORTACOMARO",31,0,0,31,"2016","087"
"18995","PORTE",13,0,0,13,"2016","200"
"18996","PORTICO E SAN BENEDETTO",73,0,0,73,"2016","031"
"18997","PORTO CERESIO",5,0,0,5,"2016","113"
"18998","PORTO MANTOVANO",698,560,2172,3430,"2016","045"
"18999","PORTO TOLLE",17,0,0,17,"2016","039"
"19000","PORTO VALTRAVAGLIA",16,0,6,22,"2016","114"
"19001","PORTO VIRO",3924,0,0,3924,"2016","052"
"19002","PORTOBUFFOLE'",3,0,11,14,"2016","060"
"19003","PORTOGRUARO",1168,81,5,1254,"2016","029"
"19004","PORTOMAGGIORE",462,423,0,885,"2016","019"
"19005","PORTULA",10,0,0,10,"2016","048"
"19006","POSINA",0,12,0,12,"2016","080"
"19007","POSSAGNO",12,11,0,23,"2016","061"
"19008","POSTALESIO",2,0,2,4,"2016","053"
"19009","POSTUA",3,9,0,12,"2016","102"
"19010","POVE DEL GRAPPA",13,34,0,47,"2016","081"
"19011","POVEGLIANO",147,223,8,378,"2016","062"
"19012","POVEGLIANO VERONESE",2401,561,16,2978,"2016","060"
"19013","POVIGLIO",6,1258,0,1264,"2016","029"
"19014","POZZAGLIO ED UNITI",24,2292,247,2563,"2016","077"
"19015","POZZO D'ADDA",199,0,0,199,"2016","177"
"19016","POZZOL GROPPO",39,0,0,39,"2016","137"
"19017","POZZOLENGO",680,457,50,1187,"2016","151"
"19018","POZZOLEONE",151,2239,0,2390,"2016","082"
"19019","POZZOLO FORMIGARO",17,0,191,208,"2016","138"
"19020","POZZONOVO",2367,0,0,2367,"2016","070"
"19021","POZZUOLO MARTESANA",23,821,0,844,"2016","178"
"19022","PRADALUNGA",23,0,0,23,"2016","173"
"19023","PRADLEVES",4,13,0,17,"2016","173"
"19024","PRAGELATO",9,0,3,12,"2016","201"
"19025","PRALBOINO",1632,926,11,2569,"2016","152"
"19026","PRALI",43,0,0,43,"2016","202"
"19027","PRALORMO",1244,313,0,1557,"2016","203"
"19028","PRALUNGO",76,0,38,114,"2016","049"
"19029","PRAMAGGIORE",10,19,0,29,"2016","030"
"19030","PRAMOLLO",4,0,0,4,"2016","204"
"19031","PRAROSTINO",39,7,0,46,"2016","205"
"19032","PRASCO",23,0,0,23,"2016","139"
"19033","PRASCORSANO",2,0,0,2,"2016","206"
"19034","PRATA CAMPORTACCIO",21,113,45,179,"2016","054"
"19035","PRATIGLIONE",2,0,0,2,"2016","207"
"19036","PRATO SESIA",0,13,0,13,"2016","122"
"19037","PRAY",64,0,0,64,"2016","050"
"19038","PRAZZO",205,33,5,243,"2016","174"
"19039","PREDAPPIO",155,34,0,189,"2016","032"
"19040","PREDORE",15,0,0,15,"2016","174"
"19041","PREDOSA",173,93,0,266,"2016","140"
"19042","PREGANZIOL",15,173,0,188,"2016","063"
"19043","PREGNANA MILANESE",1,118,0,119,"2016","179"
"19044","PREMANA",18,4,3,25,"2016","069"
"19045","PREMENO",4,0,0,4,"2016","055"
"19046","PREMIA",26,188,0,214,"2016","056"
"19047","PREMILCUORE",303,0,40,343,"2016","033"
"19048","PREMOLO",11,16,0,27,"2016","175"
"19049","PREMOSELLO-CHIOVENDA",15,0,4,19,"2016","057"
"19050","PRESEGLIE",53,0,0,53,"2016","153"
"19051","PRESEZZO",3,0,0,3,"2016",NA
"19052","PRESSANA",4180,51,0,4231,"2016","061"
"19053","PRESTINE",6,75,11,92,"2016","154"
"19054","PREVALLE",72,547,38,657,"2016","155"
"19055","PRIERO",25,0,0,25,"2016","175"
"19056","PRIGNANO SULLA SECCHIA",134,1201,44,1379,"2016","033"
"19057","PRIMALUNA",21,74,3,98,"2016","070"
"19058","PRIOCCA",608,0,0,608,"2016","176"
"19059","PRIOLA",62,0,0,62,"2016","177"
"19060","PROSERPIO",8,3,0,11,"2016","192"
"19061","PROVAGLIO D'ISEO",91,220,8,319,"2016","156"
"19062","PROVAGLIO VAL SABBIA",25,0,5,30,"2016","157"
"19063","PRUNETTO",60,0,0,60,"2016","178"
"19064","PUEGNAGO SUL GARDA",15,131,0,146,"2016","158"
"19065","PUMENENGO",1673,518,158,2349,"2016","177"
"19066","PUSIANO",0,0,1,1,"2016","193"
"19067","QUAGLIUZZO",11,0,0,11,"2016","208"
"19068","QUAREGNA",1,0,0,1,"2016","051"
"19069","QUARGNENTO",1114,0,0,1114,"2016","141"
"19070","QUARNA SOPRA",1,0,0,1,"2016","058"
"19071","QUARNA SOTTO",7,0,0,7,"2016","059"
"19072","QUARONA",18,9,0,27,"2016","107"
"19073","QUARTO D'ALTINO",12,90,0,102,"2016","031"
"19074","QUASSOLO",23,31,28,82,"2016","209"
"19075","QUATTORDIO",594,0,0,594,"2016","142"
"19076","QUATTRO CASTELLA",21,1462,0,1483,"2016","030"
"19077","QUERO VAS",35,74,6,115,"2016",NA
"19078","QUINCINETTO",29,40,0,69,"2016","210"
"19079","QUINGENTOLE",78,91,96,265,"2016","046"
"19080","QUINTANO",0,290,4,294,"2016","078"
"19081","QUINTO DI TREVISO",149,184,30,363,"2016","064"
"19082","QUINTO VERCELLESE",52,0,0,52,"2016","108"
"19083","QUINTO VICENTINO",50,667,78,795,"2016","083"
"19084","QUINZANO D'OGLIO",250,3290,0,3540,"2016","159"
"19085","QUISTELLO",197,1736,672,2605,"2016","047"
"19086","RACCONIGI",2342,2056,98,4496,"2016","179"
"19087","RAMPONIO VERNA",2,20,0,22,"2016","194"
"19088","RANCIO VALCUVIA",10,0,0,10,"2016","115"
"19089","RANCO",0,0,18,18,"2016","116"
"19090","RANICA",21,18,0,39,"2016","178"
"19091","RANZANICO",12,26,0,38,"2016","179"
"19092","RASURA",2,0,0,2,"2016","055"
"19093","RAVENNA",1205,1355,0,2560,"2016","014"
"19094","RE",20,0,0,20,"2016","060"
"19095","REANO",24,0,0,24,"2016","211"
"19096","RECOARO TERME",72,97,0,169,"2016","084"
"19097","REDAVALLE",31,0,0,31,"2016","120"
"19098","REDONDESCO",211,428,603,1242,"2016","048"
"19099","REFRANCORE",28,0,0,28,"2016","089"
"19100","REFRONTOLO",16,27,1,44,"2016","065"
"19101","REGGIO NELL'EMILIA",53,11424,11,11488,"2016","033"
"19102","REGGIOLO",873,1994,0,2867,"2016","032"
"19103","REMEDELLO",6832,2472,17,9321,"2016","160"
"19104","RENATE",2,0,1,3,"2016",NA
"19105","RESANA",2837,58,15,2910,"2016","066"
"19106","REVELLO",5442,1524,558,7524,"2016","180"
"19107","REVERE",4,212,2,218,"2016","049"
"19108","REVIGLIASCO D'ASTI",288,0,0,288,"2016","090"
"19109","REVINE LAGO",15,25,0,40,"2016","067"
"19110","REZZATO",436,572,0,1008,"2016","161"
"19111","RHO",21,469,0,490,"2016","182"
"19112","RIBORDONE",5,0,0,5,"2016","212"
"19113","RICCIONE",2,0,0,2,"2016","013"
"19114","RICENGO",28,2185,26,2239,"2016","079"
"19115","RIESE PIO X",8744,439,39,9222,"2016","068"
"19116","RIFREDDO",763,18,36,817,"2016","181"
"19117","RIMA SAN GIUSEPPE",7,0,0,7,"2016","111"
"19118","RIMASCO",0,8,0,8,"2016","112"
"19119","RIMELLA",2,11,8,21,"2016","113"
"19120","RIMINI",108,122,0,230,"2016","014"
"19121","RIO SALICETO",789,447,0,1236,"2016","034"
"19122","RIOLO TERME",327,0,0,327,"2016","015"
"19123","RIOLUNATO",57,29,0,86,"2016","035"
"19124","RIPALTA ARPINA",0,309,52,361,"2016","080"
"19125","RIPALTA CREMASCA",3,163,0,166,"2016","081"
"19126","RIPALTA GUERINA",6,506,0,512,"2016","082"
"19127","RIVA DI SOLTO",5,0,0,5,"2016","180"
"19128","RIVA PRESSO CHIERI",3322,131,0,3453,"2016","215"
"19129","RIVA VALDOBBIA",3,22,4,29,"2016","114"
"19130","RIVALBA",73,0,0,73,"2016","213"
"19131","RIVALTA DI TORINO",136,5,0,141,"2016","214"
"19132","RIVAMONTE AGORDINO",1,26,0,27,"2016","043"
"19133","RIVANAZZANO",133,0,0,133,"2016","122"
"19134","RIVARA",102,144,0,246,"2016","216"
"19135","RIVAROLO CANAVESE",1088,554,353,1995,"2016","217"
"19136","RIVAROLO DEL RE ED UNITI",2897,342,0,3239,"2016","083"
"19137","RIVAROLO MANTOVANO",81,1122,233,1436,"2016","050"
"19138","RIVAROSSA",7,164,0,171,"2016","218"
"19139","RIVERGARO",82,864,0,946,"2016","038"
"19140","RIVOLI",1513,0,104,1617,"2016","219"
"19141","RIVOLI VERONESE",94,15,0,109,"2016","062"
"19142","RIVOLTA D'ADDA",2068,2782,135,4985,"2016","084"
"19143","RO",10,54,0,64,"2016","020"
"19144","ROANA",27,466,0,493,"2016","085"
"19145","ROASCIO",11,0,0,11,"2016","184"
"19146","ROASIO",11,0,0,11,"2016","116"
"19147","ROATTO",106,0,0,106,"2016","091"
"19148","ROBASSOMERO",52,77,0,129,"2016","220"
"19149","ROBBIO",2,190,0,192,"2016","123"
"19150","ROBECCHETTO CON INDUNO",260,202,0,462,"2016","183"
"19151","ROBECCO D'OGLIO",12,2936,0,2948,"2016","085"
"19152","ROBECCO SUL NAVIGLIO",75,712,0,787,"2016","184"
"19153","ROBELLA",375,0,0,375,"2016","092"
"19154","ROBILANTE",240,0,0,240,"2016","185"
"19155","ROBURENT",23,0,0,23,"2016","186"
"19156","ROCCA CANAVESE",79,0,0,79,"2016","221"
"19157","ROCCA CIGLIE'",30,0,0,30,"2016","188"
"19158","ROCCA D'ARAZZO",371,0,0,371,"2016","093"
"19159","ROCCA DE' BALDI",2553,1033,703,4289,"2016","189"
"19160","ROCCA GRIMALDA",7,0,0,7,"2016","147"
"19161","ROCCA PIETORE",0,5,0,5,"2016","044"
"19162","ROCCA SAN CASCIANO",124,0,0,124,"2016","036"
"19163","ROCCA SUSELLA",5,0,0,5,"2016",NA
"19164","ROCCABIANCA",6,779,0,785,"2016","030"
"19165","ROCCABRUNA",144,0,47,191,"2016","187"
"19166","ROCCAFORTE LIGURE",32,0,0,32,"2016","146"
"19167","ROCCAFORTE MONDOVI'",1138,0,12,1150,"2016","190"
"19168","ROCCAFRANCA",1520,1354,18,2892,"2016","162"
"19169","ROCCASPARVERA",510,0,0,510,"2016","191"
"19170","ROCCAVERANO",168,0,0,168,"2016","094"
"19171","ROCCAVIONE",34,0,0,34,"2016","192"
"19172","ROCCHETTA LIGURE",31,0,0,31,"2016","148"
"19173","ROCCHETTA PALAFEA",5,0,0,5,"2016","095"
"19174","ROCCHETTA TANARO",324,0,0,324,"2016","096"
"19175","RODANO",36,145,0,181,"2016","185"
"19176","RODDI",77,34,0,111,"2016","194"
"19177","RODDINO",91,0,0,91,"2016","195"
"19178","RODELLO",107,0,0,107,"2016","196"
"19179","RODENGO-SAIANO",8,273,162,443,"2016","163"
"19180","RODERO",3,7,0,10,"2016",NA
"19181","RODIGO",1151,721,1712,3584,"2016","051"
"19182","ROE' VOLCIANO",10,0,0,10,"2016","164"
"19183","ROGENO",89,226,0,315,"2016","072"
"19184","ROGNANO",20,0,0,20,"2016","127"
"19185","ROGNO",18,75,0,93,"2016","182"
"19186","ROGOLO",3,13,0,16,"2016","056"
"19187","ROLETTO",217,85,0,302,"2016","222"
"19188","ROLO",0,243,0,243,"2016","035"
"19189","ROMAGNANO SESIA",31,0,0,31,"2016","130"
"19190","ROMAGNESE",122,0,0,122,"2016","128"
"19191","ROMANENGO",0,1849,249,2098,"2016","086"
"19192","ROMANO CANAVESE",27,0,0,27,"2016","223"
"19193","ROMANO D'EZZELINO",273,370,9,652,"2016","086"
"19194","ROMANO DI LOMBARDIA",181,3427,0,3608,"2016","183"
"19195","ROMENTINO",13,0,0,13,"2016","131"
"19196","RONAGO",7,53,0,60,"2016","199"
"19197","RONCA'",7,7,0,14,"2016","063"
"19198","RONCADE",2356,107,0,2463,"2016","069"
"19199","RONCADELLE",286,698,0,984,"2016","165"
"19200","RONCO ALL'ADIGE",6413,0,0,6413,"2016","064"
"19201","RONCO BIELLESE",6,60,0,66,"2016","053"
"19202","RONCO BRIANTINO",0,138,0,138,"2016",NA
"19203","RONCO CANAVESE",97,0,0,97,"2016","224"
"19204","RONCOFERRARO",2694,458,555,3707,"2016","052"
"19205","RONCOFREDDO",27,60,0,87,"2016","037"
"19206","RONCOLA",30,42,0,72,"2016","185"
"19207","RONDISSONE",8,0,0,8,"2016","225"
"19208","RONSECCO",6,0,0,6,"2016",NA
"19209","ROPPOLO",9,0,0,9,"2016","054"
"19210","RORA'",13,0,0,13,"2016","226"
"19211","ROSA'",106,857,14,977,"2016","087"
"19212","ROSASCO",3,0,0,3,"2016","130"
"19213","ROSATE",3115,507,0,3622,"2016","188"
"19214","ROSIGNANO MONFERRATO",88,0,0,88,"2016","149"
"19215","ROSOLINA",5,0,0,5,"2016","040"
"19216","ROSSA",3,9,0,12,"2016","121"
"19217","ROSSANA",84,138,0,222,"2016","197"
"19218","ROSSANO VENETO",327,215,14,556,"2016","088"
"19219","ROSTA",14,0,96,110,"2016","228"
"19220","ROTA D'IMAGNA",16,38,1,55,"2016","186"
"19221","ROTTOFRENO",412,790,0,1202,"2016","039"
"19222","ROTZO",101,0,0,101,"2016","089"
"19223","ROURE",12,0,0,12,"2016","227"
"19224","ROVASENDA",13,0,0,13,"2016","122"
"19225","ROVATO",1727,2168,144,4039,"2016","166"
"19226","ROVELLASCA",9,66,0,75,"2016","201"
"19227","ROVELLO PORRO",3,0,0,3,"2016",NA
"19228","ROVERBELLA",12521,568,349,13438,"2016","053"
"19229","ROVERCHIARA",4174,6,7,4187,"2016","065"
"19230","ROVERE' VERONESE",357,1264,0,1621,"2016","067"
"19231","ROVEREDO DI GUA'",1624,85,10,1719,"2016","066"
"19232","ROVESCALA",5,0,0,5,"2016","131"
"19233","ROVETTA",34,130,0,164,"2016","187"
"19234","ROVIGO",1399,0,0,1399,"2016","041"
"19235","ROVOLON",247,23,52,322,"2016","071"
"19236","ROZZANO",0,1,0,1,"2016","189"
"19237","RUBANO",25,39,48,112,"2016","072"
"19238","RUBIANA",2,0,0,2,"2016","229"
"19239","RUBIERA",1,473,0,474,"2016","036"
"19240","RUDIANO",507,1254,65,1826,"2016","167"
"19241","RUEGLIO",118,82,0,200,"2016","230"
"19242","RUFFIA",244,272,46,562,"2016","198"
"19243","RUINO",92,0,0,92,"2016","132"
"19244","RUSSI",13,164,0,177,"2016","016"
"19245","SABBIO CHIESE",23,29,6,58,"2016","168"
"19246","SABBIONETA",7,100,29,136,"2016","054"
"19247","SACCOLONGO",69,580,68,717,"2016","073"
"19248","SAGLIANO MICCA",41,0,0,41,"2016","056"
"19249","SALA BAGANZA",7,108,0,115,"2016","031"
"19250","SALA BIELLESE",1,0,0,1,"2016","057"
"19251","SALA BOLOGNESE",356,0,0,356,"2016","050"
"19252","SALA COMACINA",1,0,2,3,"2016","203"
"19253","SALA MONFERRATO",87,0,0,87,"2016","150"
"19254","SALARA",5,0,0,5,"2016","042"
"19255","SALASSA",14,0,0,14,"2016","231"
"19256","SALBERTRAND",35,0,0,35,"2016","232"
"19257","SALCEDO",899,77,0,976,"2016","090"
"19258","SALE",13,0,0,13,"2016","151"
"19259","SALE DELLE LANGHE",54,0,0,54,"2016","199"
"19260","SALE MARASINO",49,34,1,84,"2016","169"
"19261","SALE SAN GIOVANNI",60,0,0,60,"2016","200"
"19262","SALERANO CANAVESE",2,0,0,2,"2016",NA
"19263","SALERANO SUL LAMBRO",2,233,0,235,"2016","046"
"19264","SALETTO",7,57,0,64,"2016","074"
"19265","SALGAREDA",1703,273,0,1976,"2016","070"
"19266","SALICETO",89,0,0,89,"2016","201"
"19267","SALIZZOLE",2506,518,5,3029,"2016","068"
"19268","SALMOUR",240,0,0,240,"2016","202"
"19269","SALO'",2,43,0,45,"2016","170"
"19270","SALSOMAGGIORE TERME",29,1214,16,1259,"2016","032"
"19271","SALTRIO",47,0,0,47,"2016","117"
"19272","SALUDECIO",123,61,0,184,"2016","015"
"19273","SALUGGIA",463,188,0,651,"2016","128"
"19274","SALUSSOLA",406,95,0,501,"2016","058"
"19275","SALUZZO",3130,3402,484,7016,"2016","203"
"19276","SALVIROLA",695,87,0,782,"2016","087"
"19277","SALZANO",217,29,2,248,"2016","032"
"19278","SAMARATE",43,0,0,43,"2016","118"
"19279","SAMBUCO",30,0,0,30,"2016","204"
"19280","SAMOLACO",144,776,34,954,"2016","057"
"19281","SAMONE",20,0,0,20,"2016","235"
"19282","SAMPEYRE",277,61,0,338,"2016","205"
"19283","SAN BARTOLOMEO VAL CAVARGNA",4,0,3,7,"2016","204"
"19284","SAN BASSANO",8,1671,0,1679,"2016","088"
"19285","SAN BELLINO",1504,0,0,1504,"2016","043"
"19286","SAN BENEDETTO BELBO",29,0,64,93,"2016","206"
"19287","SAN BENEDETTO PO",1012,1659,1087,3758,"2016","055"
"19288","SAN BENEDETTO VAL DI SAMBRO",219,138,0,357,"2016","051"
"19289","SAN BENIGNO CANAVESE",228,0,42,270,"2016","236"
"19290","SAN BERNARDINO VERBANO",3,0,0,3,"2016","061"
"19291","SAN BIAGIO DI CALLALTA",219,61,0,280,"2016","071"
"19292","SAN BONIFACIO",2031,0,0,2031,"2016","069"
"19293","SAN CARLO CANAVESE",226,235,37,498,"2016","237"
"19294","SAN CESARIO SUL PANARO",28,776,0,804,"2016","036"
"19295","SAN CIPRIANO PO",13,55,0,68,"2016","133"
"19296","SAN CLEMENTE",23,0,0,23,"2016","016"
"19297","SAN COLOMBANO AL LAMBRO",22,287,0,309,"2016","191"
"19298","SAN COLOMBANO BELMONTE",3,21,0,24,"2016","238"
"19299","SAN CRISTOFORO",16,0,0,16,"2016","152"
"19300","SAN DAMIANO D'ASTI",4202,0,0,4202,"2016","097"
"19301","SAN DAMIANO MACRA",47,0,0,47,"2016","207"
"19302","SAN DANIELE PO",19,1656,0,1675,"2016","089"
"19303","SAN DIDERO",0,8,0,8,"2016","239"
"19304","SAN DONA' DI PIAVE",339,389,17,745,"2016","033"
"19305","SAN DONATO MILANESE",5,0,0,5,"2016","192"
"19306","SAN FEDELE INTELVI",33,34,9,76,"2016","205"
"19307","SAN FELICE DEL BENACO",2,0,0,2,"2016","171"
"19308","SAN FELICE SUL PANARO",20,878,0,898,"2016","037"
"19309","SAN FERMO DELLA BATTAGLIA",9,0,15,24,"2016","206"
"19310","SAN FIOR",25,28,9,62,"2016","072"
"19311","SAN FIORANO",1,166,0,167,"2016","047"
"19312","SAN FRANCESCO AL CAMPO",594,334,0,928,"2016","240"
"19313","SAN GENESIO ED UNITI",14,497,0,511,"2016","135"
"19314","SAN GERMANO CHISONE",65,25,0,90,"2016","242"
"19315","SAN GERMANO DEI BERICI",237,223,0,460,"2016","092"
"19316","SAN GERMANO VERCELLESE",7,0,0,7,"2016","131"
"19317","SAN GERVASIO BRESCIANO",0,237,0,237,"2016","172"
"19318","SAN GIACOMO DELLE SEGNATE",337,163,198,698,"2016","056"
"19319","SAN GIACOMO VERCELLESE",1907,0,0,1907,"2016","035"
"19320","SAN GILLIO",133,56,0,189,"2016","243"
"19321","SAN GIORGIO CANAVESE",293,28,0,321,"2016","244"
"19322","SAN GIORGIO DELLE PERTICHE",290,109,0,399,"2016","075"
"19323","SAN GIORGIO DI LOMELLINA",5,0,0,5,"2016","136"
"19324","SAN GIORGIO DI MANTOVA",210,136,8,354,"2016","057"
"19325","SAN GIORGIO DI PIANO",18,0,0,18,"2016","052"
"19326","SAN GIORGIO IN BOSCO",279,884,0,1163,"2016","076"
"19327","SAN GIORGIO MONFERRATO",13,0,0,13,"2016","153"
"19328","SAN GIORGIO PIACENTINO",234,707,0,941,"2016","040"
"19329","SAN GIORGIO SCARAMPI",63,0,0,63,"2016","098"
"19330","SAN GIORIO DI SUSA",2,24,0,26,"2016","245"
"19331","SAN GIOVANNI BIANCO",52,20,3,75,"2016","188"
"19332","SAN GIOVANNI DEL DOSSO",0,292,68,360,"2016","058"
"19333","SAN GIOVANNI ILARIONE",873,5,0,878,"2016","070"
"19334","SAN GIOVANNI IN CROCE",0,436,2,438,"2016","090"
"19335","SAN GIOVANNI IN MARIGNANO",11,0,0,11,"2016","017"
"19336","SAN GIOVANNI IN PERSICETO",22,795,0,817,"2016","053"
"19337","SAN GIOVANNI LUPATOTO",661,101,0,762,"2016","071"
"19338","SAN GIULIANO MILANESE",15,592,0,607,"2016","195"
"19339","SAN GIUSTO CANAVESE",130,23,0,153,"2016","246"
"19340","SAN GREGORIO NELLE ALPI",17,72,0,89,"2016","045"
"19341","SAN LAZZARO DI SAVENA",3,11,0,14,"2016","054"
"19342","SAN LEO",293,318,25,636,"2016","025"
"19343","SAN MARTINO ALFIERI",10,0,0,10,"2016","099"
"19344","SAN MARTINO BUON ALBERGO",305,1075,0,1380,"2016","073"
"19345","SAN MARTINO CANAVESE",38,0,0,38,"2016","247"
"19346","SAN MARTINO DALL'ARGINE",505,769,54,1328,"2016","059"
"19347","SAN MARTINO DEL LAGO",13,0,0,13,"2016","091"
"19348","SAN MARTINO DI LUPARI",2006,356,0,2362,"2016","077"
"19349","SAN MARTINO IN RIO",1,833,0,834,"2016","037"
"19350","SAN MARTINO IN STRADA",0,1011,0,1011,"2016","048"
"19351","SAN MARTINO SICCOMARIO",0,1,0,1,"2016","137"
"19352","SAN MARZANO OLIVETO",29,0,0,29,"2016","100"
"19353","SAN MAURIZIO CANAVESE",167,504,87,758,"2016","248"
"19354","SAN MAURIZIO D'OPAGLIO",13,0,0,13,"2016","133"
"19355","SAN MAURO DI SALINE",62,377,28,467,"2016","074"
"19356","SAN MAURO TORINESE",13,0,0,13,"2016","249"
"19357","SAN MICHELE AL TAGLIAMENTO",2060,46,0,2106,"2016","034"
"19358","SAN MICHELE MONDOVI'",150,0,0,150,"2016","210"
"19359","SAN NAZARIO",16,0,0,16,"2016","093"
"19360","SAN NAZZARO SESIA",129,0,0,129,"2016","134"
"19361","SAN NAZZARO VAL CAVARGNA",5,0,5,10,"2016","207"
"19362","SAN NICOLO' DI COMELICO",0,17,0,17,"2016","046"
"19363","SAN PAOLO",332,2343,26,2701,"2016","138"
"19364","SAN PAOLO D'ARGON",16,20,2,38,"2016","189"
"19365","SAN PAOLO SOLBRITO",20,0,0,20,"2016","101"
"19366","SAN PELLEGRINO TERME",52,40,0,92,"2016","190"
"19367","SAN PIETRO DI CADORE",4,53,0,57,"2016","047"
"19368","SAN PIETRO DI FELETTO",21,14,2,37,"2016","073"
"19369","SAN PIETRO DI MORUBIO",3,0,0,3,"2016","075"
"19370","SAN PIETRO IN CASALE",26,154,0,180,"2016","055"
"19371","SAN PIETRO IN CERRO",116,696,0,812,"2016","041"
"19372","SAN PIETRO IN GU",810,3278,0,4088,"2016","078"
"19373","SAN PIETRO MOSEZZO",9,0,0,9,"2016","135"
"19374","SAN PIETRO MUSSOLINO",13,0,0,13,"2016","094"
"19375","SAN PIETRO VAL LEMINA",5,0,0,5,"2016","250"
"19376","SAN PIETRO VIMINARIO",243,228,0,471,"2016","079"
"19377","SAN POLO D'ENZA",3,744,0,747,"2016","038"
"19378","SAN POLO DI PIAVE",558,76,0,634,"2016","074"
"19379","SAN PONSO",2,24,0,26,"2016","251"
"19380","SAN POSSIDONIO",379,434,0,813,"2016","038"
"19381","SAN PROSPERO",3,485,0,488,"2016","039"
"19382","SAN RAFFAELE CIMENA",24,0,0,24,"2016","252"
"19383","SAN ROCCO AL PORTO",227,772,0,999,"2016","049"
"19384","SAN SALVATORE MONFERRATO",143,0,0,143,"2016","154"
"19385","SAN SEBASTIANO CURONE",25,0,0,25,"2016","155"
"19386","SAN SEBASTIANO DA PO",326,0,0,326,"2016","253"
"19387","SAN SECONDO DI PINEROLO",526,68,75,669,"2016","254"
"19388","SAN SECONDO PARMENSE",9,1538,0,1547,"2016","033"
"19389","SAN SIRO",0,0,4,4,"2016","248"
"19390","SAN VENDEMIANO",90,137,0,227,"2016","076"
"19391","SAN VITO DI CADORE",5,0,0,5,"2016","051"
"19392","SAN VITO DI LEGUZZANO",422,106,0,528,"2016","096"
"19393","SAN VITTORE OLONA",25,32,0,57,"2016","201"
"19394","SAN ZENO DI MONTAGNA",181,228,57,466,"2016","079"
"19395","SAN ZENO NAVIGLIO",1,440,0,441,"2016","173"
"19396","SAN ZENONE AL LAMBRO",0,726,0,726,"2016","202"
"19397","SAN ZENONE DEGLI EZZELINI",2177,593,0,2770,"2016","077"
"19398","SANDIGLIANO",51,81,0,132,"2016","059"
"19399","SANDRIGO",1460,1914,0,3374,"2016","091"
"19400","SANFRE'",646,0,62,708,"2016","208"
"19401","SANFRONT",2183,164,68,2415,"2016","209"
"19402","SANGANO",101,0,28,129,"2016","241"
"19403","SANGIANO",4,34,0,38,"2016","141"
"19404","SANGUINETTO",2,172,0,174,"2016","072"
"19405","SANNAZZARO DE' BURGONDI",32,59,0,91,"2016","138"
"19406","SANT'AGATA BOLOGNESE",7,469,0,476,"2016","056"
"19407","SANT'AGATA FELTRIA",183,49,0,232,"2016","026"
"19408","SANT'AGATA FOSSILI",70,0,0,70,"2016","156"
"19409","SANT'AGATA SUL SANTERNO",27,0,0,27,"2016","017"
"19410","SANT'AGOSTINO",1,0,0,1,"2016","021"
"19411","SANT'ALBANO STURA",4165,708,71,4944,"2016","211"
"19412","SANT'AMBROGIO DI TORINO",71,19,28,118,"2016","255"
"19413","SANT'AMBROGIO DI VALPOLICELLA",0,35,0,35,"2016","077"
"19414","SANT'ANGELO DI PIOVE DI SACCO",311,64,0,375,"2016","082"
"19415","SANT'ANGELO LODIGIANO",28,319,0,347,"2016","050"
"19416","SANT'ANGELO LOMELLINA",0,338,0,338,"2016","144"
"19417","SANT'ANNA D'ALFAEDO",180,1446,66,1692,"2016","078"
"19418","SANT'ANTONINO DI SUSA",9,56,26,91,"2016","256"
"19419","SANT'ELENA",37,0,0,37,"2016","083"
"19420","SANT'ILARIO D'ENZA",2,767,0,769,"2016","039"
"19421","SANT'OMOBONO TERME",103,27,0,130,"2016","192"
"19422","SANT'URBANO",518,0,0,518,"2016","084"
"19423","SANTA BRIGIDA",5,18,0,23,"2016","191"
"19424","SANTA CRISTINA E BISSONE",9,127,0,136,"2016","139"
"19425","SANTA GIULETTA",21,0,0,21,"2016","140"
"19426","SANTA GIUSTINA",1927,140,0,2067,"2016","048"
"19427","SANTA GIUSTINA IN COLLE",1318,377,13,1708,"2016","080"
"19428","SANTA LUCIA DI PIAVE",44,93,8,145,"2016","075"
"19429","SANTA MARGHERITA D'ADIGE",809,0,32,841,"2016","081"
"19430","SANTA MARGHERITA DI STAFFORA",57,0,8,65,"2016","142"
"19431","SANTA MARIA DELLA VERSA",2,0,0,2,"2016","143"
"19432","SANTA MARIA DI SALA",61,163,12,236,"2016","035"
"19433","SANTA MARIA HOE'",7,0,0,7,"2016","074"
"19434","SANTA MARIA MAGGIORE",28,0,14,42,"2016","062"
"19435","SANTA SOFIA",268,0,6,274,"2016","043"
"19436","SANTA VITTORIA D'ALBA",53,0,0,53,"2016","212"
"19437","SANTARCANGELO DI ROMAGNA",25,0,0,25,"2016","018"
"19438","SANTENA",500,0,0,500,"2016","257"
"19439","SANTHIA'",268,77,0,345,"2016","133"
"19440","SANTO STEFANO BELBO",14,0,0,14,"2016","213"
"19441","SANTO STEFANO DI CADORE",9,12,0,21,"2016","050"
"19442","SANTO STEFANO LODIGIANO",28,351,0,379,"2016","051"
"19443","SANTO STEFANO ROERO",79,0,0,79,"2016","214"
"19444","SANTO STEFANO TICINO",0,0,18,18,"2016","200"
"19445","SANTO STINO DI LIVENZA",2950,103,0,3053,"2016","036"
"19446","SANTORSO",456,231,0,687,"2016","095"
"19447","SAONARA",272,6,1,279,"2016","085"
"19448","SAPPADA",11,53,0,64,"2016","052"
"19449","SARCEDO",1372,339,0,1711,"2016","097"
"19450","SARDIGLIANO",3,0,0,3,"2016","157"
"19451","SAREGO",352,18,0,370,"2016","098"
"19452","SAREZZANO",20,0,0,20,"2016",NA
"19453","SAREZZO",11,19,0,30,"2016","174"
"19454","SARMATO",2,245,0,247,"2016","042"
"19455","SARMEDE",48,63,0,111,"2016","078"
"19456","SARNICO",10,0,0,10,"2016","193"
"19457","SARONNO",0,0,7,7,"2016","119"
"19458","SARSINA",152,0,20,172,"2016","044"
"19459","SASSO MARCONI",83,0,0,83,"2016","057"
"19460","SASSUOLO",45,354,0,399,"2016","040"
"19461","SAUZE D'OULX",86,0,0,86,"2016","259"
"19462","SAUZE DI CESANA",19,0,0,19,"2016","258"
"19463","SAVIGLIANO",8916,5198,120,14234,"2016","215"
"19464","SAVIGNANO SUL PANARO",45,84,0,129,"2016","041"
"19465","SAVIGNANO SUL RUBICONE",39,0,0,39,"2016","045"
"19466","SAVIORE DELL'ADAMELLO",2,36,3,41,"2016","175"
"19467","SCAGNELLO",180,0,0,180,"2016","216"
"19468","SCALDASOLE",2,13,0,15,"2016","147"
"19469","SCALENGHE",1651,2076,386,4113,"2016","260"
"19470","SCANDIANO",47,1256,0,1303,"2016","040"
"19471","SCANDOLARA RAVARA",0,663,0,663,"2016","092"
"19472","SCANDOLARA RIPA D'OGLIO",21,803,77,901,"2016","093"
"19473","SCANZOROSCIATE",41,0,0,41,"2016","194"
"19474","SCARMAGNO",6,0,0,6,"2016","261"
"19475","SCARNAFIGI",1244,1622,35,2901,"2016","217"
"19476","SCHIAVON",2058,1681,4,3743,"2016","099"
"19477","SCHIGNANO",6,3,12,21,"2016","211"
"19478","SCHILPARIO",0,78,0,78,"2016","195"
"19479","SCHIO",356,286,8,650,"2016","100"
"19480","SCHIVENOGLIA",0,8,0,8,"2016","060"
"19481","SCIOLZE",135,0,0,135,"2016","262"
"19482","SCOPA",2,0,0,2,"2016","134"
"19483","SCOPELLO",19,6,0,25,"2016","135"
"19484","SCORZE'",4468,41,0,4509,"2016","037"
"19485","SECUGNAGO",12,1466,0,1478,"2016","052"
"19486","SEDICO",1343,127,0,1470,"2016","053"
"19487","SEDRIANO",6,687,0,693,"2016","204"
"19488","SEDRINA",21,16,0,37,"2016","196"
"19489","SEGRATE",8,0,0,8,"2016","205"
"19490","SEGUSINO",10,67,0,77,"2016","079"
"19491","SELLERO",3,22,7,32,"2016","176"
"19492","SELVA DI CADORE",0,11,0,11,"2016","054"
"19493","SELVA DI PROGNO",62,599,71,732,"2016","080"
"19494","SELVAZZANO DENTRO",8,0,63,71,"2016","086"
"19495","SELVINO",2,0,0,2,"2016","197"
"19496","SEMIANA",5,0,0,5,"2016","148"
"19497","SENIGA",1686,1932,0,3618,"2016","177"
"19498","SENNA COMASCO",23,96,5,124,"2016","212"
"19499","SENNA LODIGIANA",4,876,0,880,"2016","053"
"19500","SEREGNO",6,0,0,6,"2016",NA
"19501","SEREN DEL GRAPPA",83,27,170,280,"2016","055"
"19502","SERGNANO",2,1562,22,1586,"2016","094"
"19503","SERIATE",61,87,0,148,"2016","198"
"19504","SERINA",18,98,0,116,"2016","199"
"19505","SERLE",26,22,24,72,"2016","178"
"19506","SERMIDE",2,182,125,309,"2016","061"
"19507","SERNAGLIA DELLA BATTAGLIA",725,24,6,755,"2016","080"
"19508","SERNIO",3,0,0,3,"2016","059"
"19509","SEROLE",70,0,3,73,"2016","104"
"19510","SERRALUNGA D'ALBA",21,0,0,21,"2016","218"
"19511","SERRALUNGA DI CREA",25,0,0,25,"2016","159"
"19512","SERRAMAZZONI",31,1585,0,1616,"2016","042"
"19513","SERRAVALLE A PO",0,32,119,151,"2016","062"
"19514","SERRAVALLE LANGHE",82,0,0,82,"2016","219"
"19515","SERRAVALLE SCRIVIA",5,0,0,5,"2016","160"
"19516","SESTO CALENDE",36,0,0,36,"2016","120"
"19517","SESTO ED UNITI",3,1311,393,1707,"2016","095"
"19518","SESTOLA",67,399,0,466,"2016","043"
"19519","SETTALA",49,199,39,287,"2016","210"
"19520","SETTIME",169,0,0,169,"2016","106"
"19521","SETTIMO MILANESE",4,307,17,328,"2016","211"
"19522","SETTIMO ROTTARO",34,30,0,64,"2016","264"
"19523","SETTIMO TORINESE",368,260,112,740,"2016","265"
"19524","SETTIMO VITTONE",181,197,0,378,"2016","266"
"19525","SEVESO",1,0,0,1,"2016",NA
"19526","SEZZADIO",51,0,0,51,"2016","161"
"19527","SILEA",4,110,0,114,"2016","081"
"19528","SILLAVENGO",20,104,0,124,"2016","138"
"19529","SILVANO D'ORBA",12,0,0,12,"2016","162"
"19530","SILVANO PIETRA",1,0,0,1,"2016",NA
"19531","SINIO",18,6,0,24,"2016","220"
"19532","SIRONE",9,82,2,93,"2016","075"
"19533","SIRTORI",4,0,0,4,"2016","076"
"19534","SISSA TRECASALI",17,924,0,941,"2016",NA
"19535","SIZIANO",56,64,0,120,"2016","150"
"19536","SIZZANO",269,5,163,437,"2016","139"
"19537","SOAVE",18,0,0,18,"2016","081"
"19538","SOGLIANO AL RUBICONE",222,57,0,279,"2016","046"
"19539","SOIANO DEL LAGO",5,0,0,5,"2016","180"
"19540","SOLAGNA",1,21,0,22,"2016","101"
"19541","SOLARO",0,20,0,20,"2016","213"
"19542","SOLAROLO",3,0,0,3,"2016","018"
"19543","SOLAROLO RAINERIO",0,271,0,271,"2016","096"
"19544","SOLBIATE",4,128,2,134,"2016","215"
"19545","SOLERO",243,0,0,243,"2016","163"
"19546","SOLESINO",4,0,0,4,"2016","087"
"19547","SOLFERINO",644,216,206,1066,"2016","063"
"19548","SOLIERA",20,991,0,1011,"2016","044"
"19549","SOLIGNANO",16,263,0,279,"2016","035"
"19550","SOLONGHELLO",113,0,0,113,"2016","164"
"19551","SOLTO COLLINA",25,0,11,36,"2016","200"
"19552","SOMAGLIA",12,1100,0,1112,"2016","054"
"19553","SOMANO",43,0,0,43,"2016","221"
"19554","SOMMA LOMBARDO",46,11,0,57,"2016","123"
"19555","SOMMACAMPAGNA",1480,421,75,1976,"2016","082"
"19556","SOMMARIVA DEL BOSCO",1370,482,136,1988,"2016","222"
"19557","SOMMARIVA PERNO",18,0,0,18,"2016","223"
"19558","SOMMO",19,0,0,19,"2016","151"
"19559","SONA",2771,622,0,3393,"2016","083"
"19560","SONCINO",625,5051,172,5848,"2016","097"
"19561","SONDALO",41,87,9,137,"2016","060"
"19562","SONDRIO",10,33,0,43,"2016","061"
"19563","SONGAVAZZO",1,0,0,1,"2016","201"
"19564","SONICO",3,66,11,80,"2016","181"
"19565","SORAGNA",12,1733,0,1745,"2016","036"
"19566","SORBOLO",682,1410,0,2092,"2016","037"
"19567","SORDEVOLO",89,36,11,136,"2016","063"
"19568","SORDIO",0,243,0,243,"2016","055"
"19569","SORESINA",47,1138,332,1517,"2016","098"
"19570","SORGA'",1650,43,0,1693,"2016","084"
"19571","SORICO",8,22,65,95,"2016","216"
"19572","SORISO",6,0,0,6,"2016","140"
"19573","SORISOLE",64,52,0,116,"2016","202"
"19574","SORMANO",16,0,0,16,"2016","217"
"19575","SOSPIRO",37,381,0,418,"2016","099"
"19576","SOSPIROLO",4,106,0,110,"2016","056"
"19577","SOSSANO",17,441,0,458,"2016","102"
"19578","SOSTEGNO",1,11,0,12,"2016","064"
"19579","SOTTO IL MONTE GIOVANNI XXIII",50,72,0,122,"2016","203"
"19580","SOVERE",49,48,12,109,"2016","204"
"19581","SOVERZENE",2,0,0,2,"2016","057"
"19582","SOVICO",1,0,0,1,"2016",NA
"19583","SOVIZZO",497,95,0,592,"2016","103"
"19584","SOVRAMONTE",13,99,1,113,"2016","058"
"19585","SOZZAGO",2,0,0,2,"2016","141"
"19586","SPARONE",44,56,0,100,"2016","267"
"19587","SPESSA",6,0,0,6,"2016","152"
"19588","SPIGNO MONFERRATO",125,18,57,200,"2016","165"
"19589","SPILAMBERTO",1912,1299,0,3211,"2016","045"
"19590","SPINEA",34,156,0,190,"2016","038"
"19591","SPINEDA",2,723,0,725,"2016","101"
"19592","SPINETO SCRIVIA",139,0,0,139,"2016","166"
"19593","SPINO D'ADDA",542,2144,0,2686,"2016","102"
"19594","SPINONE AL LAGO",12,0,0,12,"2016","205"
"19595","SPIRANO",19,1000,0,1019,"2016","206"
"19596","SPRESIANO",90,179,2,271,"2016","082"
"19597","STAGNO LOMBARDO",89,6283,149,6521,"2016","103"
"19598","STANGHELLA",382,0,0,382,"2016","088"
"19599","STAZZANO",17,0,3,20,"2016","167"
"19600","STAZZONA",12,7,6,25,"2016","218"
"19601","STEZZANO",182,323,157,662,"2016","207"
"19602","STIENTA",45,0,2,47,"2016","045"
"19603","STRA",0,0,1,1,"2016","039"
"19604","STRADELLA",16,31,0,47,"2016","153"
"19605","STRAMBINO",157,0,0,157,"2016","269"
"19606","STRESA",53,0,0,53,"2016","064"
"19607","STREVI",29,0,0,29,"2016","168"
"19608","STRONA",1,0,0,1,"2016","065"
"19609","STROPPO",16,0,0,16,"2016","224"
"19610","STROZZA",4,0,0,4,"2016","208"
"19611","SUARDI",3,0,0,3,"2016","154"
"19612","SUEGLIO",3,0,0,3,"2016","077"
"19613","SUELLO",5,0,9,14,"2016","078"
"19614","SUISIO",2,65,0,67,"2016","209"
"19615","SULBIATE",21,0,0,21,"2016",NA
"19616","SULZANO",32,216,0,248,"2016","182"
"19617","SUMIRAGO",54,106,0,160,"2016","124"
"19618","SUNO",50,411,0,461,"2016","143"
"19619","SUSA",119,35,0,154,"2016","270"
"19620","SUSEGANA",802,74,0,876,"2016","083"
"19621","SUSTINENTE",477,462,306,1245,"2016","064"
"19622","SUZZARA",1559,1346,1919,4824,"2016","065"
"19623","TACENO",15,0,9,24,"2016","079"
"19624","TAGLIO DI PO",7147,0,0,7147,"2016","046"
"19625","TAGLIOLO MONFERRATO",46,0,0,46,"2016","169"
"19626","TAIBON AGORDINO",4,31,0,35,"2016","059"
"19627","TAINO",32,132,0,164,"2016","125"
"19628","TALAMONA",10,176,3,189,"2016","063"
"19629","TALEGGIO",67,21,0,88,"2016","210"
"19630","TAMBRE",30,117,0,147,"2016","060"
"19631","TARANTASCA",2469,617,0,3086,"2016","225"
"19632","TARTANO",16,9,1,26,"2016","064"
"19633","TARZO",21,19,3,43,"2016","084"
"19634","TAVAGNASCO",104,11,0,115,"2016","271"
"19635","TAVAZZANO CON VILLAVESCO",0,1029,74,1103,"2016","056"
"19636","TAVERNOLA BERGAMASCA",5,13,2,20,"2016","211"
"19637","TAVERNOLE SUL MELLA",19,62,4,85,"2016","183"
"19638","TAVIGLIANO",40,0,0,40,"2016","066"
"19639","TEGLIO",38,206,26,270,"2016","065"
"19640","TELGATE",1784,241,0,2025,"2016","212"
"19641","TEMU'",9,11,0,20,"2016","184"
"19642","TEOLO",36,41,5,82,"2016","089"
"19643","TERDOBBIATE",7,136,0,143,"2016","144"
"19644","TERENZO",107,589,2,698,"2016","038"
"19645","TERNO D'ISOLA",2,46,0,48,"2016","213"
"19646","TERRANOVA DEI PASSERINI",27,320,0,347,"2016","057"
"19647","TERRASSA PADOVANA",1583,0,0,1583,"2016","090"
"19648","TERRAZZO",1,22,0,23,"2016","085"
"19649","TERRUGGIA",10,0,14,24,"2016","171"
"19650","TERZO",18,0,6,24,"2016","172"
"19651","TEZZE SUL BRENTA",84,310,0,394,"2016","104"
"19652","THIENE",490,462,0,952,"2016","105"
"19653","TICENGO",0,419,0,419,"2016","104"
"19654","TIGLIOLE",917,0,0,917,"2016","108"
"19655","TIGNALE",5,0,4,9,"2016","185"
"19656","TIRANO",5,1,13,19,"2016","066"
"19657","TIZZANO VAL PARMA",0,838,0,838,"2016","039"
"19658","TOANO",29,1826,0,1855,"2016","041"
"19659","TOCENO",21,13,6,40,"2016","065"
"19660","TOLLEGNO",2,17,0,19,"2016","068"
"19661","TOMBOLO",936,60,0,996,"2016","091"
"19662","TONCO",660,0,0,660,"2016","109"
"19663","TONENGO",78,0,0,78,"2016","110"
"19664","TONEZZA DEL CIMONE",2,0,0,2,"2016","106"
"19665","TORBOLE CASAGLIA",2,942,25,969,"2016","186"
"19666","TORINO",164,0,10,174,"2016","272"
"19667","TORLINO VIMERCATI",0,460,0,460,"2016","105"
"19668","TORNACO",0,100,0,100,"2016",NA
"19669","TORNATA",2,140,0,142,"2016","106"
"19670","TORNOLO",80,5,0,85,"2016","040"
"19671","TORRAZZA COSTE",11,0,0,11,"2016","155"
"19672","TORRAZZA PIEMONTE",240,9,0,249,"2016","273"
"19673","TORRAZZO",8,0,0,8,"2016","069"
"19674","TORRE BERETTI E CASTELLARO",17,379,0,396,"2016","156"
"19675","TORRE BOLDONE",3,0,0,3,"2016","214"
"19676","TORRE BORMIDA",0,0,6,6,"2016","226"
"19677","TORRE D'ARESE",2,0,0,2,"2016","157"
"19678","TORRE D'ISOLA",2,493,0,495,"2016","159"
"19679","TORRE DE' BUSI",15,0,1,16,"2016","080"
"19680","TORRE DE' NEGRI",21,55,207,283,"2016","158"
"19681","TORRE DE' PICENARDI",1,1247,0,1248,"2016","107"
"19682","TORRE DE' ROVERI",12,0,0,12,"2016","216"
"19683","TORRE DI MOSTO",37,549,0,586,"2016","041"
"19684","TORRE DI SANTA MARIA",25,5,0,30,"2016","067"
"19685","TORRE MONDOVI'",1,0,0,1,"2016","227"
"19686","TORRE PALLAVICINA",539,350,0,889,"2016","217"
"19687","TORRE PELLICE",91,0,0,91,"2016","275"
"19688","TORRE SAN GIORGIO",68,16,24,108,"2016","228"
"19689","TORREBELVICINO",982,13,0,995,"2016","107"
"19690","TORREGLIA",4,0,0,4,"2016","092"
"19691","TORRESINA",2,0,0,2,"2016","229"
"19692","TORREVECCHIA PIA",56,14,10,80,"2016","160"
"19693","TORRI DEL BENACO",4,0,0,4,"2016",NA
"19694","TORRI DI QUARTESOLO",38,231,4,273,"2016","108"
"19695","TORRICELLA VERZATE",1,0,0,1,"2016",NA
"19696","TORRILE",0,2561,0,2561,"2016","041"
"19697","TORTONA",2772,222,0,2994,"2016","174"
"19698","TOSCOLANO-MADERNO",15,0,3,18,"2016","187"
"19699","TOVO DI SANT'AGATA",2,50,2,54,"2016","068"
"19700","TRADATE",43,0,1,44,"2016","127"
"19701","TRANA",45,26,47,118,"2016","276"
"19702","TRAONA",59,101,75,235,"2016","069"
"19703","TRAREGO VIGGIONA",2,0,0,2,"2016","066"
"19704","TRASQUERA",13,0,6,19,"2016","067"
"19705","TRAUSELLA",15,27,0,42,"2016","277"
"19706","TRAVAGLIATO",724,519,0,1243,"2016","188"
"19707","TRAVEDONA-MONATE",12,0,14,26,"2016","128"
"19708","TRAVERSELLA",65,38,3,106,"2016","278"
"19709","TRAVERSETOLO",42,946,0,988,"2016","042"
"19710","TRAVES",8,0,0,8,"2016","279"
"19711","TRAVO",49,33,0,82,"2016","043"
"19712","TREBASELEGHE",8021,146,0,8167,"2016","093"
"19713","TRECATE",1,211,0,212,"2016","149"
"19714","TRECENTA",45,160,0,205,"2016","047"
"19715","TREDOZIO",124,0,0,124,"2016","049"
"19716","TREGNAGO",556,145,0,701,"2016","087"
"19717","TREMENICO",0,0,1,1,"2016","081"
"19718","TREMEZZINA",16,14,52,82,"2016",NA
"19719","TREMOSINE",19,420,15,454,"2016","189"
"19720","TRENZANO",992,1426,89,2507,"2016","190"
"19721","TRESCORE BALNEARIO",21,73,26,120,"2016","218"
"19722","TRESCORE CREMASCO",111,482,0,593,"2016","109"
"19723","TRESIGALLO",4,0,0,4,"2016","024"
"19724","TRESIVIO",5,36,0,41,"2016","070"
"19725","TREVENZUOLO",71,781,26,878,"2016","088"
"19726","TREVIGLIO",1023,1503,0,2526,"2016","219"
"19727","TREVIGNANO",1987,181,5,2173,"2016","085"
"19728","TREVILLE",6,0,0,6,"2016","175"
"19729","TREVIOLO",120,133,0,253,"2016","220"
"19730","TREVISO",647,151,2,800,"2016","086"
"19731","TREVISO BRESCIANO",12,46,0,58,"2016","191"
"19732","TREZZANO SUL NAVIGLIO",0,295,0,295,"2016","220"
"19733","TREZZO SULL'ADDA",2,342,0,344,"2016","221"
"19734","TREZZO TINELLA",27,0,0,27,"2016","231"
"19735","TREZZONE",2,0,2,4,"2016","226"
"19736","TRIBANO",3,0,0,3,"2016","094"
"19737","TRIBIANO",0,42,0,42,"2016","222"
"19738","TRICHIANA",70,502,0,572,"2016","061"
"19739","TRIGOLO",1,1634,2,1637,"2016","110"
"19740","TRINITA'",2609,360,314,3283,"2016","232"
"19741","TRINO",6,156,0,162,"2016","148"
"19742","TRISOBBIO",96,0,0,96,"2016","176"
"19743","TRISSINO",55,306,0,361,"2016","110"
"19744","TRIUGGIO",68,294,2,364,"2016",NA
"19745","TRIVERO",13,26,0,39,"2016","070"
"19746","TROFARELLO",607,72,0,679,"2016","280"
"19747","TROMELLO",15,139,249,403,"2016","164"
"19748","TRONTANO",10,14,14,38,"2016","068"
"19749","TRONZANO LAGO MAGGIORE",3,0,0,3,"2016","129"
"19750","TRONZANO VERCELLESE",145,19,0,164,"2016","150"
"19751","TROVO",11,45,0,56,"2016","165"
"19752","TRUCCAZZANO",99,1759,0,1858,"2016","224"
"19753","TURANO LODIGIANO",62,1880,0,1942,"2016","058"
"19754","TURATE",21,0,0,21,"2016","227"
"19755","TURBIGO",3,53,0,56,"2016","226"
"19756","UBIALE CLANEZZO",6,0,0,6,"2016","221"
"19757","UBOLDO",8,0,0,8,"2016","130"
"19758","UGGIATE-TREVANO",14,66,10,90,"2016","228"
"19759","URAGO D'OGLIO",252,1216,0,1468,"2016","192"
"19760","URBANA",686,0,0,686,"2016","095"
"19761","URGNANO",306,216,0,522,"2016","222"
"19762","USMATE VELATE",7,55,16,78,"2016",NA
"19763","USSEAUX",35,110,0,145,"2016","281"
"19764","USSEGLIO",37,0,0,37,"2016","282"
"19765","VAIANO CREMASCO",11,414,0,425,"2016","111"
"19766","VAIE",19,2,55,76,"2016","283"
"19767","VAILATE",7,537,0,544,"2016","112"
"19768","VAL BREMBILLA",89,42,9,140,"2016",NA
"19769","VAL DELLA TORRE",364,0,0,364,"2016","284"
"19770","VAL DI ZOLDO",19,10,0,29,"2016",NA
"19771","VAL MASINO",4,11,0,15,"2016","074"
"19772","VAL REZZO",5,3,9,17,"2016","233"
"19773","VALBONDIONE",1,8,0,9,"2016","223"
"19774","VALBREMBO",73,2,0,75,"2016","224"
"19775","VALBRONA",6,0,3,9,"2016","229"
"19776","VALDAGNO",54,184,0,238,"2016","111"
"19777","VALDASTICO",756,14,0,770,"2016","112"
"19778","VALDENGO",19,44,0,63,"2016","071"
"19779","VALDIDENTRO",27,148,19,194,"2016","071"
"19780","VALDISOTTO",34,106,8,148,"2016","072"
"19781","VALDOBBIADENE",104,410,5,519,"2016","087"
"19782","VALDUGGIA",5,0,0,5,"2016","152"
"19783","VALEGGIO",57,0,0,57,"2016","167"
"19784","VALEGGIO SUL MINCIO",2067,2232,24,4323,"2016","089"
"19785","VALENZA",52,0,0,52,"2016","177"
"19786","VALERA FRATTA",183,224,0,407,"2016","059"
"19787","VALFENERA",1118,112,171,1401,"2016","112"
"19788","VALFURVA",10,103,15,128,"2016","073"
"19789","VALGANNA",19,0,0,19,"2016","131"
"19790","VALGOGLIO",16,58,0,74,"2016","225"
"19791","VALGRANA",89,0,0,89,"2016","234"
"19792","VALGREGHENTINO",2,0,0,2,"2016","082"
"19793","VALLADA AGORDINA",6,3,0,9,"2016","062"
"19794","VALLE DI CADORE",8,0,0,8,"2016","063"
"19795","VALLE LOMELLINA",19,712,0,731,"2016","168"
"19796","VALLE MOSSO",1,0,0,1,"2016","073"
"19797","VALLE SALIMBENE",0,120,0,120,"2016","169"
"19798","VALLE SAN NICOLAO",5,0,0,5,"2016","074"
"19799","VALLEVE",0,13,0,13,"2016","226"
"19800","VALLI DEL PASUBIO",3,11,0,14,"2016","113"
"19801","VALLIO TERME",8,0,0,8,"2016","193"
"19802","VALLO TORINESE",22,0,0,22,"2016","286"
"19803","VALMADRERA",33,0,0,33,"2016","083"
"19804","VALMOREA",6,29,0,35,"2016","232"
"19805","VALMOZZOLA",47,4,0,51,"2016","044"
"19806","VALPERGA",195,209,0,404,"2016","287"
"19807","VALPRATO SOANA",66,0,0,66,"2016","288"
"19808","VALSAMOGGIA",281,884,0,1165,"2016",NA
"19809","VALSOLDA",3,5,4,12,"2016","234"
"19810","VALSTAGNA",3,0,0,3,"2016","114"
"19811","VALSTRONA",25,0,0,25,"2016","069"
"19812","VALTORTA",7,34,0,41,"2016","229"
"19813","VALVERDE",7,0,0,7,"2016","170"
"19814","VALVESTINO",3,6,0,9,"2016","194"
"19815","VANZAGO",46,0,0,46,"2016","229"
"19816","VAPRIO D'ADDA",19,374,0,393,"2016","230"
"19817","VARALLO",51,55,0,106,"2016","156"
"19818","VARALLO POMBIA",1,0,0,1,"2016","154"
"19819","VARANO DE' MELEGARI",19,372,0,391,"2016","045"
"19820","VAREDO",1,0,0,1,"2016",NA
"19821","VARESE",111,104,0,215,"2016","133"
"19822","VARISELLA",13,0,0,13,"2016","289"
"19823","VARSI",2,439,0,441,"2016","046"
"19824","VARZI",64,12,0,76,"2016","171"
"19825","VARZO",11,9,10,30,"2016","071"
"19826","VAUDA CANAVESE",43,0,0,43,"2016","290"
"19827","VAZZOLA",1247,238,5,1490,"2016","088"
"19828","VEDANO OLONA",119,124,0,243,"2016","134"
"19829","VEDELAGO",20323,449,98,20870,"2016","089"
"19830","VEDESETA",5,51,79,135,"2016","230"
"19831","VEGGIANO",77,93,62,232,"2016","096"
"19832","VEGLIO",26,0,0,26,"2016","075"
"19833","VELESO",0,0,6,6,"2016","236"
"19834","VELEZZO LOMELLINA",1,0,0,1,"2016","172"
"19835","VELLEZZO BELLINI",14,376,0,390,"2016","173"
"19836","VELO D'ASTICO",729,34,0,763,"2016","115"
"19837","VELO VERONESE",518,1959,0,2477,"2016","090"
"19838","VENARIA REALE",70,15,257,342,"2016","292"
"19839","VENASCA",47,0,0,47,"2016","237"
"19840","VENAUS",21,33,5,59,"2016","291"
"19841","VENDROGNO",3,16,2,21,"2016","085"
"19842","VENEGONO INFERIORE",0,108,2,110,"2016","136"
"19843","VENEGONO SUPERIORE",14,0,1,15,"2016","137"
"19844","VENEZIA",1545,201,0,1746,"2016","042"
"19845","VENIANO",31,114,0,145,"2016","238"
"19846","VENTASSO",66,415,0,481,"2016",NA
"19847","VERANO BRIANZA",2,0,0,2,"2016",NA
"19848","VERBANIA",67,0,1,68,"2016","072"
"19849","VERCANA",7,8,1,16,"2016","239"
"19850","VERCEIA",11,0,5,16,"2016","075"
"19851","VERCELLI",92,211,0,303,"2016","158"
"19852","VERDELLINO",0,66,0,66,"2016","232"
"19853","VERDELLO",214,68,0,282,"2016","233"
"19854","VERDERIO",1,0,36,37,"2016",NA
"19855","VERDUNO",107,0,0,107,"2016","238"
"19856","VERGATO",63,3,12,78,"2016","059"
"19857","VERGHERETO",528,0,51,579,"2016","050"
"19858","VERGIATE",40,0,0,40,"2016","138"
"19859","VERMEZZO",0,471,0,471,"2016","235"
"19860","VERNANTE",213,47,0,260,"2016","239"
"19861","VERNASCA",59,69,0,128,"2016","044"
"19862","VERNATE",2,78,0,80,"2016","236"
"19863","VEROLANUOVA",1458,2075,114,3647,"2016","195"
"19864","VEROLAVECCHIA",42,3155,574,3771,"2016","196"
"19865","VEROLENGO",229,125,0,354,"2016","293"
"19866","VERONA",2705,885,0,3590,"2016","091"
"19867","VERONELLA",5135,309,0,5444,"2016","092"
"19868","VERRONE",57,0,0,57,"2016","076"
"19869","VERRUA SAVOIA",559,0,0,559,"2016","294"
"19870","VERTEMATE CON MINOPRIO",4,20,0,24,"2016","242"
"19871","VERTOVA",27,44,0,71,"2016","234"
"19872","VERUCCHIO",147,20,0,167,"2016","020"
"19873","VERUNO",8,0,0,8,"2016","157"
"19874","VERVIO",3,1,0,4,"2016","076"
"19875","VERZUOLO",9,0,0,9,"2016","240"
"19876","VESCOVANA",5,0,0,5,"2016","097"
"19877","VESCOVATO",1989,714,530,3233,"2016","113"
"19878","VESIME",574,1,0,575,"2016","113"
"19879","VESPOLATE",39,110,0,149,"2016","158"
"19880","VESTENANOVA",262,153,19,434,"2016","093"
"19881","VESTIGNE'",12,71,0,83,"2016","295"
"19882","VESTONE",11,0,0,11,"2016","197"
"19883","VESTRENO",1,0,0,1,"2016","089"
"19884","VETTO",18,423,0,441,"2016","042"
"19885","VEZZA D'ALBA",2,0,0,2,"2016","241"
"19886","VEZZA D'OGLIO",0,137,45,182,"2016","198"
"19887","VEZZANO SUL CROSTOLO",24,138,0,162,"2016","043"
"19888","VIADANA",284,1345,85,1714,"2016","066"
"19889","VIADANICA",16,37,0,53,"2016","235"
"19890","VIALE",280,0,0,280,"2016","114"
"19891","VIALFRE'",17,0,0,17,"2016","296"
"19892","VIANO",21,807,0,828,"2016","044"
"19893","VIARIGI",47,0,0,47,"2016","115"
"19894","VICENZA",186,1035,4,1225,"2016","116"
"19895","VICO CANAVESE",145,117,0,262,"2016","297"
"19896","VICOFORTE",473,0,0,473,"2016","242"
"19897","VIDIGULFO",30,403,0,433,"2016","176"
"19898","VIDOR",14,374,0,388,"2016","090"
"19899","VIDRACCO",1,0,0,1,"2016","298"
"19900","VIGANO SAN MARTINO",14,0,0,14,"2016","236"
"19901","VIGASIO",959,580,0,1539,"2016","094"
"19902","VIGEVANO",105,64,64,233,"2016","177"
"19903","VIGGIU'",20,72,0,92,"2016","139"
"19904","VIGHIZZOLO D'ESTE",85,24,0,109,"2016","098"
"19905","VIGLIANO BIELLESE",2,21,0,23,"2016","077"
"19906","VIGLIANO D'ASTI",25,0,0,25,"2016","116"
"19907","VIGNALE MONFERRATO",179,0,0,179,"2016","179"
"19908","VIGNATE",31,398,0,429,"2016","237"
"19909","VIGNOLA",10,102,0,112,"2016","046"
"19910","VIGNOLE BORBERA",14,0,0,14,"2016","180"
"19911","VIGNOLO",1252,0,0,1252,"2016","243"
"19912","VIGNONE",4,0,0,4,"2016","074"
"19913","VIGO DI CADORE",0,8,5,13,"2016","065"
"19914","VIGODARZERE",279,96,0,375,"2016","099"
"19915","VIGOLO",19,143,0,162,"2016","237"
"19916","VIGOLZONE",70,502,0,572,"2016","045"
"19917","VIGONE",2830,1150,166,4146,"2016","299"
"19918","VIGONOVO",8,0,0,8,"2016","043"
"19919","VIGONZA",721,264,0,985,"2016","100"
"19920","VILLA BARTOLOMEA",71,0,0,71,"2016","095"
"19921","VILLA CARCINA",4,0,0,4,"2016","199"
"19922","VILLA CORTESE",151,0,0,151,"2016","248"
"19923","VILLA D'ADDA",10,0,0,10,"2016","238"
"19924","VILLA D'ALME'",67,21,0,88,"2016","239"
"19925","VILLA D'OGNA",1,47,0,48,"2016","241"
"19926","VILLA DEL BOSCO",1,0,0,1,"2016","078"
"19927","VILLA DEL CONTE",778,706,2,1486,"2016","101"
"19928","VILLA DI CHIAVENNA",4,0,0,4,"2016","077"
"19929","VILLA DI SERIO",9,0,0,9,"2016","240"
"19930","VILLA DI TIRANO",11,135,72,218,"2016","078"
"19931","VILLA ESTENSE",204,0,0,204,"2016","102"
"19932","VILLA GUARDIA",129,0,0,129,"2016","245"
"19933","VILLA MINOZZO",36,772,0,808,"2016","045"
"19934","VILLA POMA",0,633,90,723,"2016","067"
"19935","VILLA SAN SECONDO",7,0,0,7,"2016","119"
"19936","VILLACHIARA",438,1815,988,3241,"2016","200"
"19937","VILLADEATI",17,0,0,17,"2016","182"
"19938","VILLADOSE",159,0,106,265,"2016","048"
"19939","VILLADOSSOLA",17,0,0,17,"2016","075"
"19940","VILLAFALLETTO",1831,835,291,2957,"2016","244"
"19941","VILLAFRANCA D'ASTI",300,0,0,300,"2016","117"
"19942","VILLAFRANCA DI VERONA",8463,3275,70,11808,"2016","096"
"19943","VILLAFRANCA PADOVANA",710,1838,21,2569,"2016","103"
"19944","VILLAFRANCA PIEMONTE",2435,2068,441,4944,"2016","300"
"19945","VILLAGA",111,122,171,404,"2016","117"
"19946","VILLALVERNIA",1,0,0,1,"2016",NA
"19947","VILLAMARZANA",728,95,0,823,"2016","049"
"19948","VILLAMIROGLIO",15,0,0,15,"2016","184"
"19949","VILLANOVA BIELLESE",281,0,0,281,"2016","079"
"19950","VILLANOVA CANAVESE",48,26,0,74,"2016","301"
"19951","VILLANOVA D'ARDENGHI",12,0,0,12,"2016","179"
"19952","VILLANOVA D'ASTI",4056,104,0,4160,"2016","118"
"19953","VILLANOVA DEL GHEBBO",37,0,0,37,"2016","050"
"19954","VILLANOVA DEL SILLARO",0,1043,7,1050,"2016","060"
"19955","VILLANOVA DI CAMPOSAMPIERO",27,37,3,67,"2016","104"
"19956","VILLANOVA MARCHESANA",4,73,0,77,"2016","051"
"19957","VILLANOVA MONDOVI'",1729,487,142,2358,"2016","245"
"19958","VILLANOVA MONFERRATO",0,84,0,84,"2016","185"
"19959","VILLANOVA SOLARO",253,672,7,932,"2016","246"
"19960","VILLANOVA SULL'ARDA",173,1423,0,1596,"2016","046"
"19961","VILLANTERIO",4,0,268,272,"2016","180"
"19962","VILLANUOVA SUL CLISI",7,0,0,7,"2016","201"
"19963","VILLAR DORA",55,0,38,93,"2016","303"
"19964","VILLAR FOCCHIARDO",17,24,73,114,"2016","305"
"19965","VILLAR PELLICE",184,38,9,231,"2016","306"
"19966","VILLAR PEROSA",6,0,7,13,"2016","307"
"19967","VILLAR SAN COSTANZO",408,199,7,614,"2016","247"
"19968","VILLARBASSE",220,22,0,242,"2016","302"
"19969","VILLARBOIT",1,0,0,1,"2016","163"
"19970","VILLAREGGIA",47,25,0,72,"2016","304"
"19971","VILLAROMAGNANO",79,0,0,79,"2016","186"
"19972","VILLASTELLONE",973,640,0,1613,"2016","308"
"19973","VILLATA",11,41,0,52,"2016","164"
"19974","VILLAVERLA",115,1340,0,1455,"2016","118"
"19975","VILLETTE",56,0,0,56,"2016","076"
"19976","VILLIMPENTA",581,87,35,703,"2016","068"
"19977","VILLONGO",19,0,0,19,"2016","242"
"19978","VILLORBA",125,6,0,131,"2016","091"
"19979","VILMINORE DI SCALVE",13,169,0,182,"2016","243"
"19980","VIMERCATE",3,50,0,53,"2016",NA
"19981","VINADIO",200,0,0,200,"2016","248"
"19982","VINCHIO",16,0,0,16,"2016","120"
"19983","VINOVO",357,117,20,494,"2016","309"
"19984","VINZAGLIO",14,34,0,48,"2016","164"
"19985","VIOLA",89,0,0,89,"2016","249"
"19986","VIONE",2,59,1,62,"2016","202"
"19987","VIRLE PIEMONTE",317,232,158,707,"2016","310"
"19988","VISANO",2073,579,39,2691,"2016","203"
"19989","VISCHE",9,0,0,9,"2016","311"
"19990","VISONE",42,0,0,42,"2016","187"
"19991","VISTARINO",37,0,9,46,"2016","181"
"19992","VISTRORIO",14,0,0,14,"2016","312"
"19993","VITTORIO VENETO",188,130,24,342,"2016","092"
"19994","VITTUONE",1,171,0,172,"2016","243"
"19995","VIU'",51,0,76,127,"2016","313"
"19996","VIVERONE",34,0,0,34,"2016","080"
"19997","VIZZOLO PREDABISSI",25,0,36,61,"2016","244"
"19998","VO'",67,75,0,142,"2016","105"
"19999","VOBARNO",48,91,1,140,"2016","204"
"20000","VOCCA",0,21,0,21,"2016","166"
"20001","VODO CADORE",0,0,25,25,"2016","066"
"20002","VOGHERA",17,0,0,17,"2016","182"
"20003","VOGHIERA",3,0,0,3,"2016","023"
"20004","VOGOGNA",9,8,0,17,"2016","077"
"20005","VOLONGO",36,0,0,36,"2016","114"
"20006","VOLPAGO DEL MONTELLO",1222,595,19,1836,"2016","093"
"20007","VOLPIANO",288,69,141,498,"2016","314"
"20008","VOLTA MANTOVANA",3329,1164,997,5490,"2016","070"
"20009","VOLTAGGIO",12,0,68,80,"2016","190"
"20010","VOLTAGO AGORDINO",1,0,0,1,"2016",NA
"20011","VOLTIDO",0,381,0,381,"2016","115"
"20012","VOLVERA",1514,168,0,1682,"2016","315"
"20013","VOTTIGNASCO",1918,96,68,2082,"2016","250"
"20014","ZANDOBBIO",13,0,0,13,"2016","244"
"20015","ZANE'",316,172,0,488,"2016","119"
"20016","ZANICA",216,1227,0,1443,"2016","245"
"20017","ZAVATTARELLO",95,0,0,95,"2016","184"
"20018","ZECCONE",3,231,0,234,"2016","185"
"20019","ZELBIO",0,0,15,15,"2016","246"
"20020","ZELO BUON PERSICO",0,1081,0,1081,"2016","061"
"20021","ZELO SURRIGONE",13,225,0,238,"2016","246"
"20022","ZEME",65,29,0,94,"2016","186"
"20023","ZENEVREDO",4,0,0,4,"2016","187"
"20024","ZENSON DI PIAVE",9,0,0,9,"2016","094"
"20025","ZERBOLO'",0,174,0,174,"2016","189"
"20026","ZERMEGHEDO",0,55,0,55,"2016","120"
"20027","ZERO BRANCO",241,194,6,441,"2016","095"
"20028","ZEVIO",4066,758,65,4889,"2016","097"
"20029","ZIANO PIACENTINO",82,0,0,82,"2016","048"
"20030","ZIBIDO SAN GIACOMO",58,494,0,552,"2016","247"
"20031","ZIMELLA",7938,539,66,8543,"2016","098"
"20032","ZIMONE",3,0,0,3,"2016",NA
"20033","ZINASCO",22,0,0,22,"2016","190"
"20034","ZOCCA",91,754,0,845,"2016","047"
"20035","ZOGNO",112,55,0,167,"2016","246"
"20036","ZOLA PREDOSA",18,197,0,215,"2016","060"
"20037","ZONE",5,32,0,37,"2016","205"
"20038","ZOPPE' DI CADORE",0,6,0,6,"2016",NA
"20039","ZOVENCEDO",7,0,0,7,"2016","121"
"20040","ZUBIENA",25,4,18,47,"2016","082"
"20041","ZUGLIANO",211,169,20,400,"2016","122"
"20042","ZUMAGLIA",38,0,0,38,"2016","083"
"20043","ABANO TERME",14,111,44,169,"2017","001"
"20044","ABBADIA CERRETO",0,1176,0,1176,"2017","001"
"20045","ABBADIA LARIANA",12,25,1,38,"2017","001"
"20046","ABBIATEGRASSO",73,1478,16,1567,"2017","002"
"20047","ACCEGLIO",97,0,0,97,"2017","001"
"20048","ACQUAFREDDA",1527,149,0,1676,"2017","001"
"20049","ACQUANEGRA CREMONESE",1,190,490,681,"2017","001"
"20050","ACQUANEGRA SUL CHIESE",1322,792,133,2247,"2017","001"
"20051","ACQUI TERME",248,0,0,248,"2017","001"
"20052","ADRARA SAN MARTINO",37,34,2,73,"2017","001"
"20053","ADRARA SAN ROCCO",3,1,4,8,"2017","002"
"20054","ADRIA",2731,285,0,3016,"2017","001"
"20055","ADRO",548,21,0,569,"2017","002"
"20056","AGAZZANO",95,382,0,477,"2017","001"
"20057","AGLIANO TERME",56,0,0,56,"2017","001"
"20058","AGLIE'",230,10,12,252,"2017","001"
"20059","AGNA",418,0,0,418,"2017","002"
"20060","AGNADELLO",22,1210,541,1773,"2017","002"
"20061","AGNOSINE",15,29,0,44,"2017","003"
"20062","AGORDO",5,22,0,27,"2017","001"
"20063","AGRATE CONTURBIA",46,0,0,46,"2017","001"
"20064","AGUGLIARO",391,27,0,418,"2017","001"
"20065","AICURZIO",2,67,0,69,"2017",NA
"20066","AILOCHE",0,8,0,8,"2017","001"
"20067","AIRASCA",962,424,132,1518,"2017","002"
"20068","AIRUNO",4,0,0,4,"2017","002"
"20069","AISONE",35,0,0,35,"2017","002"
"20070","ALA DI STURA",26,34,0,60,"2017","003"
"20071","ALAGNA VALSESIA",25,16,0,41,"2017","002"
"20072","ALANO DI PIAVE",43,58,0,101,"2017","002"
"20073","ALBA",791,0,0,791,"2017","003"
"20074","ALBAIRATE",33,686,0,719,"2017","005"
"20075","ALBANO SANT'ALESSANDRO",5,0,2,7,"2017","003"
"20076","ALBAREDO D'ADIGE",10949,201,0,11150,"2017","002"
"20077","ALBAREDO PER SAN MARCO",4,29,0,33,"2017","001"
"20078","ALBARETO",146,83,0,229,"2017","001"
"20079","ALBARETTO DELLA TORRE",30,0,0,30,"2017","004"
"20080","ALBAVILLA",3,0,0,3,"2017","003"
"20081","ALBERA LIGURE",26,0,0,26,"2017","002"
"20082","ALBESE CON CASSANO",0,0,4,4,"2017","004"
"20083","ALBETTONE",2245,617,39,2901,"2017","002"
"20084","ALBIANO D'IVREA",124,39,0,163,"2017","004"
"20085","ALBIATE",387,0,0,387,"2017",NA
"20086","ALBIGNASEGO",154,198,7,359,"2017","003"
"20087","ALBINEA",15,1358,0,1373,"2017","001"
"20088","ALBINO",73,26,4,103,"2017","004"
"20089","ALBIOLO",22,0,0,22,"2017","005"
"20090","ALBIZZATE",4,0,0,4,"2017","002"
"20091","ALBOSAGGIA",46,44,26,116,"2017","002"
"20092","ALBUGNANO",43,0,0,43,"2017","002"
"20093","ALBUZZANO",19,0,0,19,"2017","004"
"20094","ALESSANDRIA",9566,2309,0,11875,"2017","003"
"20095","ALFIANELLO",9,507,5,521,"2017","004"
"20096","ALFIANO NATTA",32,0,0,32,"2017","004"
"20097","ALFONSINE",48,0,0,48,"2017","001"
"20098","ALGUA",5,8,0,13,"2017","248"
"20099","ALICE BEL COLLE",1,0,0,1,"2017","005"
"20100","ALICE CASTELLO",702,21,0,723,"2017","004"
"20101","ALICE SUPERIORE",37,0,0,37,"2017","005"
"20102","ALLEGHE",4,0,0,4,"2017","003"
"20103","ALLUVIONI CAMBIO'",9,0,0,9,"2017","006"
"20104","ALME'",0,0,4,4,"2017","005"
"20105","ALMENNO SAN BARTOLOMEO",38,5,0,43,"2017","006"
"20106","ALMENNO SAN SALVATORE",7,0,0,7,"2017","007"
"20107","ALMESE",52,22,0,74,"2017","006"
"20108","ALONTE",723,12,0,735,"2017","003"
"20109","ALPAGO",27,269,0,296,"2017",NA
"20110","ALPETTE",0,0,17,17,"2017","007"
"20111","ALPIGNANO",332,169,31,532,"2017","008"
"20112","ALSENO",571,863,0,1434,"2017","002"
"20113","ALSERIO",1,0,0,1,"2017","006"
"20114","ALTA VALLE INTELVI",44,32,13,89,"2017",NA
"20115","ALTAVILLA MONFERRATO",105,0,0,105,"2017","007"
"20116","ALTAVILLA VICENTINA",135,0,0,135,"2017","004"
"20117","ALTISSIMO",43,53,0,96,"2017","005"
"20118","ALTIVOLE",11086,73,48,11207,"2017","001"
"20119","ALTO RENO TERME",59,0,0,59,"2017",NA
"20120","ALZANO LOMBARDO",17,41,0,58,"2017","008"
"20121","ALZANO SCRIVIA",2,0,0,2,"2017","008"
"20122","ALZATE BRIANZA",4,119,0,123,"2017","007"
"20123","AMBIVERE",2,0,0,2,"2017","009"
"20124","AMENO",8,4,24,36,"2017","002"
"20125","ANDALO VALTELLINO",13,0,0,13,"2017",NA
"20126","ANDEZENO",401,0,0,401,"2017","009"
"20127","ANDORNO MICCA",15,0,46,61,"2017","002"
"20128","ANDRATE",33,0,0,33,"2017","010"
"20129","ANFO",7,22,0,29,"2017","005"
"20130","ANGERA",68,157,17,242,"2017","003"
"20131","ANGOLO TERME",6,46,2,54,"2017","006"
"20132","ANGROGNA",98,0,19,117,"2017","011"
"20133","ANGUILLARA VENETA",7,0,0,7,"2017","004"
"20134","ANNICCO",16,801,253,1070,"2017","003"
"20135","ANNONE DI BRIANZA",40,15,0,55,"2017","003"
"20136","ANNONE VENETO",23,59,0,82,"2017","001"
"20137","ANTEGNATE",815,1466,0,2281,"2017","010"
"20138","ANTIGNANO",101,0,0,101,"2017","003"
"20139","ANTRONA SCHIERANCO",4,0,0,4,"2017","001"
"20140","ANZANO DEL PARCO",2,138,0,140,"2017","009"
"20141","ANZOLA D'OSSOLA",2,118,0,120,"2017","002"
"20142","ANZOLA DELL'EMILIA",62,386,0,448,"2017","001"
"20143","APPIANO GENTILE",57,281,19,357,"2017","010"
"20144","APRICA",2,2,0,4,"2017","004"
"20145","ARAMENGO",209,0,0,209,"2017","004"
"20146","ARCADE",1191,77,0,1268,"2017","002"
"20147","ARCENE",4,353,0,357,"2017","011"
"20148","ARCISATE",62,569,307,938,"2017","004"
"20149","ARCOLE",1383,129,0,1512,"2017","004"
"20150","ARCONATE",58,104,0,162,"2017","007"
"20151","ARCORE",65,6,0,71,"2017",NA
"20152","ARCUGNANO",93,5,0,98,"2017","006"
"20153","ARDENNO",34,33,0,67,"2017","005"
"20154","ARDESIO",45,63,0,108,"2017","012"
"20155","ARENA PO",45,449,110,604,"2017","005"
"20156","ARESE",0,120,0,120,"2017","009"
"20157","ARGEGNO",3,0,0,3,"2017","011"
"20158","ARGELATO",93,53,0,146,"2017","002"
"20159","ARGENTA",1675,3,0,1678,"2017","001"
"20160","ARGUELLO",62,0,0,62,"2017","007"
"20161","ARIANO NEL POLESINE",985,163,0,1148,"2017","002"
"20162","ARIGNANO",595,0,0,595,"2017","012"
"20163","ARLUNO",74,218,16,308,"2017","010"
"20164","ARMENO",69,77,0,146,"2017","006"
"20165","AROLA",5,0,15,20,"2017","004"
"20166","ARONA",2,0,0,2,"2017","008"
"20167","AROSIO",2,3,0,5,"2017","012"
"20168","ARQUA' PETRARCA",167,0,0,167,"2017","005"
"20169","ARQUA' POLESINE",915,4,0,919,"2017","003"
"20170","ARQUATA SCRIVIA",6,0,0,6,"2017","009"
"20171","ARRE",1,24,0,25,"2017","006"
"20172","ARSAGO SEPRIO",14,0,0,14,"2017","005"
"20173","ARSIE'",19,4,465,488,"2017","004"
"20174","ARSIERO",5,21,0,26,"2017","007"
"20175","ARTOGNE",5,351,62,418,"2017","007"
"20176","ARZAGO D'ADDA",486,846,0,1332,"2017","013"
"20177","ARZERGRANDE",200,152,0,352,"2017","007"
"20178","ARZIGNANO",203,244,0,447,"2017","008"
"20179","ASIAGO",48,1243,6,1297,"2017","009"
"20180","ASIGLIANO VENETO",61,0,0,61,"2017","010"
"20181","ASIGLIANO VERCELLESE",23,0,0,23,"2017","007"
"20182","ASOLA",8629,1688,1496,11813,"2017","002"
"20183","ASOLO",10569,576,0,11145,"2017","003"
"20184","ASSAGO",2,0,0,2,"2017","011"
"20185","ASSO",21,0,5,26,"2017","013"
"20186","ASTI",2388,7,0,2395,"2017","005"
"20187","AURANO",11,0,0,11,"2017","005"
"20188","AURONZO DI CADORE",5,13,0,18,"2017","005"
"20189","AVERARA",0,6,0,6,"2017","014"
"20190","AVIATICO",0,21,0,21,"2017","015"
"20191","AVIGLIANA",172,56,10,238,"2017","013"
"20192","AVOLASCA",129,0,0,129,"2017","010"
"20193","AZEGLIO",71,17,68,156,"2017","014"
"20194","AZZANELLO",1,178,0,179,"2017","004"
"20195","AZZANO D'ASTI",2,0,0,2,"2017",NA
"20196","AZZANO MELLA",295,898,0,1193,"2017","008"
"20197","AZZANO SAN PAOLO",22,135,0,157,"2017","016"
"20198","AZZATE",17,0,16,33,"2017","006"
"20199","AZZIO",11,111,0,122,"2017","007"
"20200","AZZONE",0,1,0,1,"2017","017"
"20201","BACENO",6,16,9,31,"2017","006"
"20202","BADIA CALAVENA",1086,195,41,1322,"2017","005"
"20203","BADIA PAVESE",16,0,0,16,"2017","006"
"20204","BADIA POLESINE",176,0,0,176,"2017","004"
"20205","BAGNACAVALLO",45,0,0,45,"2017","002"
"20206","BAGNARA DI ROMAGNA",7,0,0,7,"2017","003"
"20207","BAGNARIA",10,0,0,10,"2017","007"
"20208","BAGNASCO",132,0,0,132,"2017","008"
"20209","BAGNATICA",4,171,0,175,"2017","018"
"20210","BAGNO DI ROMAGNA",865,23,0,888,"2017","001"
"20211","BAGNOLI DI SOPRA",1040,8,0,1048,"2017","008"
"20212","BAGNOLO CREMASCO",3,1754,0,1757,"2017","005"
"20213","BAGNOLO IN PIANO",2,549,0,551,"2017","002"
"20214","BAGNOLO MELLA",250,2912,377,3539,"2017","009"
"20215","BAGNOLO PIEMONTE",922,0,134,1056,"2017","009"
"20216","BAGNOLO SAN VITO",4,2352,1218,3574,"2017","003"
"20217","BAGOLINO",1,311,8,320,"2017","010"
"20218","BAIRO",74,80,0,154,"2017","015"
"20219","BAISO",24,902,0,926,"2017","003"
"20220","BALANGERO",175,10,100,285,"2017","016"
"20221","BALDICHIERI D'ASTI",40,0,0,40,"2017","007"
"20222","BALDISSERO CANAVESE",0,73,0,73,"2017","017"
"20223","BALDISSERO D'ALBA",707,0,0,707,"2017","010"
"20224","BALDISSERO TORINESE",184,0,0,184,"2017","018"
"20225","BALLABIO",24,77,0,101,"2017","004"
"20226","BALME",10,0,0,10,"2017","019"
"20227","BALOCCO",72,0,37,109,"2017","009"
"20228","BANCHETTE",6,0,0,6,"2017","020"
"20229","BANNIO ANZINO",54,0,1,55,"2017","007"
"20230","BAONE",11,0,0,11,"2017","009"
"20231","BARBANIA",22,172,78,272,"2017","021"
"20232","BARBARANO VICENTINO",290,340,0,630,"2017","011"
"20233","BARBARESCO",25,0,0,25,"2017","011"
"20234","BARBARIGA",980,1342,12,2334,"2017","011"
"20235","BARBATA",1,785,0,786,"2017","019"
"20236","BARBIANELLO",95,0,0,95,"2017","008"
"20237","BARBONA",313,1,0,314,"2017","010"
"20238","BARDELLO",17,0,0,17,"2017","009"
"20239","BARDI",54,663,0,717,"2017","002"
"20240","BARDOLINO",25,112,0,137,"2017","006"
"20241","BARDONECCHIA",9,46,0,55,"2017","022"
"20242","BAREGGIO",37,157,29,223,"2017","012"
"20243","BARENGO",1,124,0,125,"2017","012"
"20244","BARGE",4052,1494,734,6280,"2017","012"
"20245","BARGHE",6,14,0,20,"2017","012"
"20246","BARIANO",24,337,0,361,"2017","020"
"20247","BARLASSINA",4,0,0,4,"2017",NA
"20248","BARNI",6,3,4,13,"2017","015"
"20249","BAROLO",30,0,0,30,"2017","013"
"20250","BARONE CANAVESE",159,47,0,206,"2017","023"
"20251","BARZAGO",253,15,0,268,"2017","005"
"20252","BARZANO'",14,0,0,14,"2017","006"
"20253","BARZIO",7,45,3,55,"2017","007"
"20254","BASALUZZO",109,0,0,109,"2017","012"
"20255","BASCAPE'",1,809,0,810,"2017","009"
"20256","BASIGLIO",0,76,0,76,"2017","015"
"20257","BASSANO BRESCIANO",0,104,0,104,"2017","013"
"20258","BASSANO DEL GRAPPA",265,184,1,450,"2017","012"
"20259","BASSIGNANA",5,0,0,5,"2017","013"
"20260","BASTIA MONDOVI'",589,0,0,589,"2017","014"
"20261","BASTIDA PANCARANA",2,0,0,2,"2017","011"
"20262","BASTIGLIA",138,0,0,138,"2017","001"
"20263","BATTAGLIA TERME",5,0,0,5,"2017","011"
"20264","BEDERO VALCUVIA",14,0,0,14,"2017","010"
"20265","BEDIZZOLE",4038,1367,36,5441,"2017","014"
"20266","BEDONIA",218,109,28,355,"2017","003"
"20267","BEDULITA",11,0,0,11,"2017","022"
"20268","BEE",5,0,0,5,"2017","009"
"20269","BEINASCO",25,0,0,25,"2017","024"
"20270","BEINETTE",718,353,0,1071,"2017","016"
"20271","BELFIORE",2389,0,0,2389,"2017","007"
"20272","BELGIOIOSO",1,169,0,170,"2017","013"
"20273","BELLAGIO",5,59,36,100,"2017","019"
"20274","BELLANO",8,0,0,8,"2017","008"
"20275","BELLARIA-IGEA MARINA",12,0,0,12,"2017","001"
"20276","BELLINO",132,0,0,132,"2017","017"
"20277","BELLINZAGO LOMBARDO",45,1352,0,1397,"2017","016"
"20278","BELLINZAGO NOVARESE",520,525,0,1045,"2017","016"
"20279","BELLUNO",581,348,104,1033,"2017","006"
"20280","BELVEDERE LANGHE",138,0,95,233,"2017","018"
"20281","BEMA",0,6,0,6,"2017","006"
"20282","BENE LARIO",1,0,74,75,"2017","021"
"20283","BENE VAGIENNA",1690,440,0,2130,"2017","019"
"20284","BENEVELLO",153,0,0,153,"2017","020"
"20285","BENNA",9,17,20,46,"2017","003"
"20286","BENTIVOGLIO",4,361,0,365,"2017","005"
"20287","BERBENNO",13,42,0,55,"2017","023"
"20288","BERBENNO DI VALTELLINA",32,139,2,173,"2017","007"
"20289","BERCETO",35,58,0,93,"2017","004"
"20290","BEREGAZZO CON FIGLIARO",6,0,0,6,"2017","022"
"20291","BEREGUARDO",19,618,72,709,"2017","014"
"20292","BERGAMASCO",67,0,0,67,"2017","015"
"20293","BERGAMO",137,119,2,258,"2017","024"
"20294","BERLINGO",3452,308,44,3804,"2017","015"
"20295","BERNAREGGIO",1,17,0,18,"2017",NA
"20296","BERNATE TICINO",84,148,0,232,"2017","019"
"20297","BERNEZZO",297,75,10,382,"2017","022"
"20298","BERRA",2043,79,0,2122,"2017","002"
"20299","BERTINORO",210,9,0,219,"2017","003"
"20300","BERTONICO",24,2653,0,2677,"2017","002"
"20301","BERZANO DI SAN PIETRO",3,0,0,3,"2017","009"
"20302","BERZO DEMO",5,54,6,65,"2017","016"
"20303","BERZO INFERIORE",4,127,0,131,"2017","017"
"20304","BERZO SAN FERMO",519,77,27,623,"2017","025"
"20305","BESANA IN BRIANZA",206,50,18,274,"2017",NA
"20306","BESANO",28,0,7,35,"2017","011"
"20307","BESATE",119,0,0,119,"2017","022"
"20308","BESENZONE",106,1561,0,1667,"2017","003"
"20309","BESNATE",9,172,0,181,"2017","012"
"20310","BESOZZO",15,78,0,93,"2017","013"
"20311","BETTOLA",319,130,0,449,"2017","004"
"20312","BEURA-CARDEZZA",14,9,0,23,"2017","011"
"20313","BEVILACQUA",80,45,0,125,"2017","008"
"20314","BIANDRONNO",14,0,9,23,"2017","014"
"20315","BIANZANO",4,16,0,20,"2017","026"
"20316","BIANZE'",83,392,0,475,"2017","011"
"20317","BIANZONE",3,21,0,24,"2017","008"
"20318","BIASSONO",3,0,0,3,"2017",NA
"20319","BIBBIANO",32,2318,0,2350,"2017","004"
"20320","BIBIANA",575,0,0,575,"2017","025"
"20321","BIELLA",162,31,136,329,"2017","004"
"20322","BIENNO",2,138,2,142,"2017","018"
"20323","BIGARELLO",1568,195,721,2484,"2017","004"
"20324","BINAGO",42,86,64,192,"2017","023"
"20325","BIOGLIO",5,0,0,5,"2017","005"
"20326","BIONE",12,6,0,18,"2017","019"
"20327","BISTAGNO",10,0,0,10,"2017","017"
"20328","BISUSCHIO",5,0,0,5,"2017","015"
"20329","BIZZARONE",12,14,0,26,"2017","024"
"20330","BLELLO",0,54,0,54,"2017","027"
"20331","BLESSAGNO",0,0,8,8,"2017","025"
"20332","BOARA PISANI",1,0,0,1,"2017","012"
"20333","BOBBIO",133,159,0,292,"2017","005"
"20334","BOBBIO PELLICE",51,14,135,200,"2017","026"
"20335","BOCA",2,0,0,2,"2017","019"
"20336","BOCCIOLETO",9,0,0,9,"2017","014"
"20337","BOFFALORA D'ADDA",33,321,5,359,"2017","003"
"20338","BOFFALORA SOPRA TICINO",67,113,23,203,"2017","026"
"20339","BOLGARE",46,298,0,344,"2017","028"
"20340","BOLLATE",2,251,0,253,"2017","027"
"20341","BOLLENGO",98,60,0,158,"2017","027"
"20342","BOLOGNA",12,32,4,48,"2017","006"
"20343","BOLTIERE",14,69,0,83,"2017","029"
"20344","BOLZANO NOVARESE",0,22,0,22,"2017","022"
"20345","BOLZANO VICENTINO",208,1188,85,1481,"2017","013"
"20346","BOMPORTO",1226,121,0,1347,"2017","002"
"20347","BONATE SOPRA",275,0,0,275,"2017","030"
"20348","BONATE SOTTO",53,0,0,53,"2017","031"
"20349","BONAVIGO",3575,26,44,3645,"2017","009"
"20350","BONDENO",615,379,0,994,"2017","003"
"20351","BONEMERSE",18,176,0,194,"2017","006"
"20352","BORDOLANO",16,368,0,384,"2017","007"
"20353","BORE",64,5,0,69,"2017","005"
"20354","BORETTO",0,185,0,185,"2017","005"
"20355","BORGARELLO",0,0,1,1,"2017","015"
"20356","BORGARO TORINESE",60,77,0,137,"2017","028"
"20357","BORGHETTO DI BORBERA",143,0,6,149,"2017","018"
"20358","BORGHETTO LODIGIANO",12,1825,30,1867,"2017","004"
"20359","BORGHI",1627,0,0,1627,"2017","004"
"20360","BORGIALLO",3,33,0,36,"2017","029"
"20361","BORGO D'ALE",231,0,0,231,"2017","015"
"20362","BORGO DI TERZO",3,0,0,3,"2017","032"
"20363","BORGO PRIOLO",8,0,0,8,"2017","016"
"20364","BORGO SAN DALMAZZO",523,0,79,602,"2017","025"
"20365","BORGO SAN GIACOMO",974,4080,16,5070,"2017","020"
"20366","BORGO SAN GIOVANNI",5,890,0,895,"2017","005"
"20367","BORGO SAN SIRO",2,704,0,706,"2017","018"
"20368","BORGO TICINO",31,0,0,31,"2017","025"
"20369","BORGO TOSSIGNANO",7,0,0,7,"2017","007"
"20370","BORGO VAL DI TARO",86,198,0,284,"2017","006"
"20371","BORGO VIRGILIO",161,3671,2262,6094,"2017",NA
"20372","BORGOFRANCO D'IVREA",191,2,7,200,"2017","030"
"20373","BORGOFRANCO SUL PO",0,15,53,68,"2017","006"
"20374","BORGOLAVEZZARO",6,0,0,6,"2017","023"
"20375","BORGOMALE",55,0,0,55,"2017","024"
"20376","BORGOMANERO",98,25,0,123,"2017","024"
"20377","BORGOMASINO",155,0,3,158,"2017","031"
"20378","BORGOMEZZAVALLE",1,0,0,1,"2017",NA
"20379","BORGONE SUSA",27,28,0,55,"2017","032"
"20380","BORGONOVO VAL TIDONE",783,1954,0,2737,"2017","006"
"20381","BORGORATTO ALESSANDRINO",26,0,0,26,"2017","019"
"20382","BORGORATTO MORMOROLO",24,0,0,24,"2017","017"
"20383","BORGORICCO",70,29,0,99,"2017","013"
"20384","BORGOSATOLLO",3,588,50,641,"2017","021"
"20385","BORGOSESIA",65,40,0,105,"2017","016"
"20386","BORMIO",21,380,12,413,"2017","009"
"20387","BORNASCO",155,547,0,702,"2017","019"
"20388","BORNO",0,102,69,171,"2017","022"
"20389","BORRIANA",119,29,0,148,"2017","006"
"20390","BORSO DEL GRAPPA",123,173,7,303,"2017","004"
"20391","BOSARO",1,0,0,1,"2017","007"
"20392","BOSCHI SANT'ANNA",4,0,28,32,"2017","010"
"20393","BOSCO CHIESANUOVA",11,1481,0,1492,"2017","011"
"20394","BOSCO MARENGO",31,24,0,55,"2017","021"
"20395","BOSCONERO",78,31,0,109,"2017","033"
"20396","BOSIA",404,0,0,404,"2017","026"
"20397","BOSIO",24,0,8,32,"2017","022"
"20398","BOSISIO PARINI",2,114,0,116,"2017","009"
"20399","BOSSICO",32,78,0,110,"2017","033"
"20400","BOSSOLASCO",49,78,0,127,"2017","027"
"20401","BOTTANUCO",10,224,405,639,"2017","034"
"20402","BOTTICINO",37,0,0,37,"2017","023"
"20403","BOVEGNO",52,96,64,212,"2017","024"
"20404","BOVES",801,704,155,1660,"2017","028"
"20405","BOVEZZO",2,0,0,2,"2017","025"
"20406","BOVOLENTA",3619,333,0,3952,"2017","014"
"20407","BOVOLONE",3342,359,0,3701,"2017","012"
"20408","BOZZOLO",55,1271,12,1338,"2017","007"
"20409","BRA",3710,1313,147,5170,"2017","029"
"20410","BRACCA",5,0,0,5,"2017","035"
"20411","BRALLO DI PREGOLA",10,13,0,23,"2017","021"
"20412","BRANDICO",0,590,0,590,"2017","026"
"20413","BRANDIZZO",0,0,99,99,"2017","034"
"20414","BRANZI",3,39,3,45,"2017","036"
"20415","BRAONE",0,54,6,60,"2017","027"
"20416","BREBBIA",28,0,0,28,"2017","017"
"20417","BREDA DI PIAVE",51,397,3,451,"2017","005"
"20418","BREGANO",7,0,0,7,"2017","018"
"20419","BREGANZE",540,768,113,1421,"2017","014"
"20420","BREGNANO",6,106,0,112,"2017","028"
"20421","BREIA",4,0,0,4,"2017","019"
"20422","BREMBATE",33,0,282,315,"2017","037"
"20423","BREMBATE DI SOPRA",0,226,0,226,"2017","038"
"20424","BREMBIO",231,1706,121,2058,"2017","006"
"20425","BREME",13,0,0,13,"2017","022"
"20426","BRENDOLA",299,98,1,398,"2017","015"
"20427","BRENNA",3,0,0,3,"2017","029"
"20428","BRENO",7,256,8,271,"2017","028"
"20429","BRENTA",5,0,0,5,"2017","019"
"20430","BRENTINO BELLUNO",1,0,0,1,"2017","013"
"20431","BRENZONE",3,0,0,3,"2017","014"
"20432","BRESCELLO",1,28,0,29,"2017","006"
"20433","BRESCIA",45,547,0,592,"2017","029"
"20434","BRESSANA BOTTARONE",232,0,0,232,"2017","023"
"20435","BRESSANVIDO",46,1442,11,1499,"2017","016"
"20436","BRESSO",11,0,0,11,"2017",NA
"20437","BREZZO DI BEDERO",2,0,0,2,"2017","020"
"20438","BRIAGLIA",73,0,0,73,"2017","030"
"20439","BRICHERASIO",1095,76,29,1200,"2017","035"
"20440","BRIGA NOVARESE",5,79,0,84,"2017","026"
"20441","BRIGNANO GERA D'ADDA",229,1586,0,1815,"2017","040"
"20442","BRIGNANO-FRASCATA",5,0,0,5,"2017","024"
"20443","BRINZIO",7,0,0,7,"2017","021"
"20444","BRIONA",10,1644,0,1654,"2017","027"
"20445","BRIONE",17,0,0,17,"2017","030"
"20446","BRIOSCO",9,0,0,9,"2017",NA
"20447","BRISIGHELLA",370,73,0,443,"2017","004"
"20448","BRISSAGO-VALTRAVAGLIA",2,0,0,2,"2017","022"
"20449","BRIVIO",44,77,0,121,"2017","010"
"20450","BROGLIANO",37,23,0,60,"2017","017"
"20451","BRONDELLO",6,0,0,6,"2017","032"
"20452","BRONI",63,0,0,63,"2017","024"
"20453","BROSSASCO",62,0,0,62,"2017","033"
"20454","BROSSO",27,16,14,57,"2017","036"
"20455","BROVELLO-CARPUGNINO",15,0,11,26,"2017","013"
"20456","BROZOLO",46,0,0,46,"2017","037"
"20457","BRUGHERIO",2,292,0,294,"2017",NA
"20458","BRUGINE",4398,85,48,4531,"2017","015"
"20459","BRUINO",99,0,0,99,"2017","038"
"20460","BRUMANO",22,20,0,42,"2017","041"
"20461","BRUNELLO",17,0,0,17,"2017","023"
"20462","BRUNO",13,0,0,13,"2017","010"
"20463","BRUSAPORTO",36,0,34,70,"2017","042"
"20464","BRUSASCO",129,0,0,129,"2017","039"
"20465","BRUSNENGO",11,0,0,11,"2017","007"
"20466","BRUZOLO",43,29,2,74,"2017","040"
"20467","BUBBIANO",0,31,0,31,"2017","035"
"20468","BUBBIO",55,0,0,55,"2017","011"
"20469","BUCCINASCO",5,516,0,521,"2017","036"
"20470","BUDRIO",251,258,0,509,"2017","008"
"20471","BUGLIO IN MONTE",27,198,38,263,"2017","010"
"20472","BULCIAGO",10,0,120,130,"2017","011"
"20473","BULGAROGRASSO",43,317,0,360,"2017","034"
"20474","BURAGO DI MOLGORA",2,0,0,2,"2017",NA
"20475","BURIASCO",1152,836,137,2125,"2017","041"
"20476","BUROLO",8,0,0,8,"2017","042"
"20477","BURONZO",1,16,0,17,"2017","021"
"20478","BUSANO",24,46,0,70,"2017","043"
"20479","BUSCA",4171,1362,414,5947,"2017","034"
"20480","BUSCATE",83,0,0,83,"2017","038"
"20481","BUSNAGO",16,4,0,20,"2017",NA
"20482","BUSSERO",0,513,0,513,"2017","040"
"20483","BUSSETO",4,3695,33,3732,"2017","007"
"20484","BUSSOLENGO",549,125,123,797,"2017","015"
"20485","BUSSOLENO",35,244,0,279,"2017","044"
"20486","BUSTO ARSIZIO",8,145,52,205,"2017","026"
"20487","BUSTO GAROLFO",72,186,8,266,"2017","041"
"20488","BUTTAPIETRA",0,149,0,149,"2017","016"
"20489","BUTTIGLIERA ALTA",89,50,0,139,"2017","045"
"20490","BUTTIGLIERA D'ASTI",1789,101,94,1984,"2017","012"
"20491","CA' D'ANDREA",3,1405,0,1408,"2017","008"
"20492","CABELLA LIGURE",108,0,0,108,"2017","025"
"20493","CADEGLIANO-VICONAGO",4,0,0,4,"2017","027"
"20494","CADELBOSCO DI SOPRA",1,1647,0,1648,"2017","008"
"20495","CADEO",57,2926,0,2983,"2017","007"
"20496","CADONEGHE",13,0,10,23,"2017","016"
"20497","CADORAGO",10,0,54,64,"2017","036"
"20498","CADREZZATE",5,0,0,5,"2017","028"
"20499","CAERANO DI SAN MARCO",242,74,19,335,"2017","006"
"20500","CAFASSE",74,11,15,100,"2017","046"
"20501","CAGLIO",42,0,0,42,"2017","037"
"20502","CAGNO",1,31,0,32,"2017","038"
"20503","CAINO",7,0,0,7,"2017","031"
"20504","CAIOLO",4,99,0,103,"2017","011"
"20505","CAIRATE",3,0,0,3,"2017","029"
"20506","CALAMANDRANA",68,0,0,68,"2017","013"
"20507","CALASCA-CASTIGLIONE",16,0,0,16,"2017","014"
"20508","CALCINATE",241,240,2,483,"2017","043"
"20509","CALCINATO",7590,1843,1290,10723,"2017","032"
"20510","CALCIO",142,1383,0,1525,"2017","044"
"20511","CALCO",17,203,0,220,"2017","012"
"20512","CALDERARA DI RENO",45,48,0,93,"2017","009"
"20513","CALDOGNO",248,341,6,595,"2017","018"
"20514","CALENDASCO",185,380,0,565,"2017","008"
"20515","CALESTANO",4,396,0,400,"2017","008"
"20516","CALLABIANA",22,0,0,22,"2017","008"
"20517","CALLIANO",204,0,0,204,"2017","014"
"20518","CALOLZIOCORTE",10,0,17,27,"2017","013"
"20519","CALOSSO",3,0,0,3,"2017","015"
"20520","CALTIGNAGA",1175,310,0,1485,"2017","030"
"20521","CALTO",26,0,0,26,"2017","008"
"20522","CALTRANO",1416,2,0,1418,"2017","019"
"20523","CALUSCO D'ADDA",15,0,0,15,"2017","046"
"20524","CALUSO",863,169,0,1032,"2017","047"
"20525","CALVAGESE DELLA RIVIERA",141,194,12,347,"2017","033"
"20526","CALVATONE",18,123,0,141,"2017","009"
"20527","CALVENE",10,40,0,50,"2017","020"
"20528","CALVENZANO",29,604,0,633,"2017","047"
"20529","CALVIGNASCO",1,28,0,29,"2017","042"
"20530","CALVISANO",15545,4406,125,20076,"2017","034"
"20531","CAMAGNA MONFERRATO",21,0,0,21,"2017","026"
"20532","CAMAIRAGO",0,1501,0,1501,"2017","007"
"20533","CAMANDONA",6,0,0,6,"2017","009"
"20534","CAMBIAGO",24,87,0,111,"2017","044"
"20535","CAMBIANO",356,0,0,356,"2017","048"
"20536","CAMBIASCA",7,0,0,7,"2017","015"
"20537","CAMBURZANO",94,0,10,104,"2017","010"
"20538","CAMERANA",289,0,5,294,"2017","035"
"20539","CAMERANO CASASCO",25,0,0,25,"2017","016"
"20540","CAMERATA CORNELLO",5,74,0,79,"2017","048"
"20541","CAMERI",81,618,0,699,"2017","032"
"20542","CAMINATA",27,0,0,27,"2017","009"
"20543","CAMISANO",298,2338,480,3116,"2017","010"
"20544","CAMISANO VICENTINO",296,1255,297,1848,"2017","021"
"20545","CAMPAGNA LUPIA",89,100,0,189,"2017","002"
"20546","CAMPAGNOLA CREMASCA",64,474,78,616,"2017","011"
"20547","CAMPAGNOLA EMILIA",7,753,0,760,"2017","009"
"20548","CAMPEGINE",1,1171,0,1172,"2017","010"
"20549","CAMPERTOGNO",122,43,0,165,"2017","025"
"20550","CAMPIGLIA CERVO",3,0,0,3,"2017","011"
"20551","CAMPIGLIA DEI BERICI",516,97,2,615,"2017","022"
"20552","CAMPIGLIONE-FENILE",772,1,0,773,"2017","049"
"20553","CAMPO SAN MARTINO",469,71,10,550,"2017","020"
"20554","CAMPODARSEGO",960,53,2,1015,"2017","017"
"20555","CAMPODORO",73,228,0,301,"2017","018"
"20556","CAMPOGALLIANO",0,367,0,367,"2017","003"
"20557","CAMPOLONGO MAGGIORE",32,89,0,121,"2017","003"
"20558","CAMPOLONGO SUL BRENTA",3,0,0,3,"2017","023"
"20559","CAMPONOGARA",152,46,0,198,"2017","004"
"20560","CAMPOSAMPIERO",146,92,0,238,"2017","019"
"20561","CAMUGNANO",226,112,0,338,"2017","010"
"20562","CANALE",749,0,0,749,"2017","037"
"20563","CANARO",411,11,0,422,"2017","009"
"20564","CANDA",8,0,0,8,"2017","010"
"20565","CANDELO",55,42,78,175,"2017","012"
"20566","CANDIA CANAVESE",21,0,0,21,"2017","050"
"20567","CANDIANA",10496,206,0,10702,"2017","021"
"20568","CANDIOLO",79,457,149,685,"2017","051"
"20569","CANELLI",5,0,0,5,"2017","017"
"20570","CANEVINO",40,0,0,40,"2017","028"
"20571","CANISCHIO",4,30,0,34,"2017","052"
"20572","CANNETO SULL'OGLIO",1719,1534,1283,4536,"2017","008"
"20573","CANNOBIO",6,0,0,6,"2017","017"
"20574","CANONICA D'ADDA",25,426,0,451,"2017","049"
"20575","CANOSIO",11,0,93,104,"2017","038"
"20576","CANOSSA",31,267,0,298,"2017","018"
"20577","CANTALUPA",38,0,0,38,"2017","053"
"20578","CANTALUPO LIGURE",4,0,0,4,"2017","028"
"20579","CANTARANA",91,0,0,91,"2017","018"
"20580","CANTELLO",157,174,0,331,"2017","030"
"20581","CANTOIRA",78,17,22,117,"2017","054"
"20582","CANTU'",225,215,18,458,"2017","041"
"20583","CANZO",10,0,15,25,"2017","042"
"20584","CAORLE",808,70,0,878,"2017","005"
"20585","CAORSO",3,423,0,426,"2017","010"
"20586","CAPERGNANICA",428,1112,33,1573,"2017","012"
"20587","CAPIAGO INTIMIANO",1,24,0,25,"2017","043"
"20588","CAPIZZONE",42,20,0,62,"2017","050"
"20589","CAPO DI PONTE",19,176,7,202,"2017","035"
"20590","CAPONAGO",86,0,0,86,"2017",NA
"20591","CAPOVALLE",16,0,11,27,"2017","036"
"20592","CAPPELLA CANTONE",0,345,0,345,"2017","013"
"20593","CAPPELLA DE' PICENARDI",1,421,0,422,"2017","014"
"20594","CAPPELLA MAGGIORE",19,17,0,36,"2017","007"
"20595","CAPRALBA",86,1438,42,1566,"2017","015"
"20596","CAPRAUNA",3,0,0,3,"2017","039"
"20597","CAPRIANO DEL COLLE",16,340,1,357,"2017","037"
"20598","CAPRIATA D'ORBA",19,0,0,19,"2017","029"
"20599","CAPRIATE SAN GERVASIO",1,0,0,1,"2017",NA
"20600","CAPRIE",26,0,0,26,"2017","055"
"20601","CAPRIGLIO",1,0,0,1,"2017","019"
"20602","CAPRILE",33,3,0,36,"2017","013"
"20603","CAPRINO BERGAMASCO",21,35,0,56,"2017","052"
"20604","CAPRINO VERONESE",91,694,69,854,"2017","018"
"20605","CAPRIOLO",356,32,38,426,"2017","038"
"20606","CARAGLIO",3159,801,409,4369,"2017","040"
"20607","CARAMAGNA PIEMONTE",1756,628,31,2415,"2017","041"
"20608","CARATE BRIANZA",20,0,0,20,"2017",NA
"20609","CARAVAGGIO",491,2913,53,3457,"2017","053"
"20610","CARAVATE",2,102,0,104,"2017","031"
"20611","CARBONARA AL TICINO",0,291,0,291,"2017","030"
"20612","CARBONARA DI PO",0,277,286,563,"2017","009"
"20613","CARBONARA SCRIVIA",50,0,0,50,"2017","030"
"20614","CARBONATE",139,56,18,213,"2017","045"
"20615","CARBONERA",63,260,50,373,"2017","008"
"20616","CARCERI",1134,0,0,1134,"2017","022"
"20617","CARCOFORO",0,0,11,11,"2017","029"
"20618","CARDANO AL CAMPO",10,0,0,10,"2017","032"
"20619","CARDE'",2653,1818,16,4487,"2017","042"
"20620","CAREMA",78,11,1,90,"2017","057"
"20621","CARENNO",22,0,6,28,"2017","014"
"20622","CARENTINO",85,603,0,688,"2017","031"
"20623","CARESANA",9,0,0,9,"2017","030"
"20624","CAREZZANO",4,0,0,4,"2017","032"
"20625","CARIGNANO",2997,1564,299,4860,"2017","058"
"20626","CARISIO",26,0,0,26,"2017","032"
"20627","CARLAZZO",14,56,39,109,"2017","047"
"20628","CARMAGNOLA",7000,2928,0,9928,"2017","059"
"20629","CARMIGNANO DI BRENTA",360,1358,0,1718,"2017","023"
"20630","CARNAGO",26,59,0,85,"2017","033"
"20631","CAROBBIO DEGLI ANGELI",98,33,0,131,"2017","055"
"20632","CARONNO PERTUSELLA",3,0,0,3,"2017","034"
"20633","CARONNO VARESINO",35,0,0,35,"2017","035"
"20634","CARPANETO PIACENTINO",88,4296,0,4384,"2017","011"
"20635","CARPENEDOLO",1641,4323,137,6101,"2017","039"
"20636","CARPENETO",129,0,0,129,"2017","033"
"20637","CARPI",17,1963,0,1980,"2017","005"
"20638","CARPIANO",128,1411,239,1778,"2017","050"
"20639","CARPIGNANO SESIA",131,2,0,133,"2017","036"
"20640","CARPINETI",98,1463,0,1561,"2017","011"
"20641","CARRE'",409,130,0,539,"2017","024"
"20642","CARREGA LIGURE",40,0,0,40,"2017","034"
"20643","CARRU'",687,40,97,824,"2017","043"
"20644","CARTIGLIANO",15,19,0,34,"2017","025"
"20645","CARTIGNANO",137,68,0,205,"2017","044"
"20646","CARTOSIO",52,0,0,52,"2017","036"
"20647","CARTURA",438,28,0,466,"2017","026"
"20648","CARUGATE",6,99,0,105,"2017","051"
"20649","CARUGO",3,0,0,3,"2017","048"
"20650","CARVICO",5,0,0,5,"2017","057"
"20651","CASAL CERMELLI",2,0,0,2,"2017","037"
"20652","CASALBELTRAME",1,0,171,172,"2017","037"
"20653","CASALBORGONE",48,0,0,48,"2017","060"
"20654","CASALBUTTANO ED UNITI",2,1410,0,1412,"2017","016"
"20655","CASALE CORTE CERRO",12,0,0,12,"2017","019"
"20656","CASALE CREMASCO-VIDOLASCO",0,1819,0,1819,"2017","017"
"20657","CASALE DI SCODOSIA",582,0,0,582,"2017","027"
"20658","CASALE LITTA",26,139,17,182,"2017","036"
"20659","CASALE MONFERRATO",124,165,0,289,"2017","039"
"20660","CASALE SUL SILE",505,88,21,614,"2017","009"
"20661","CASALEONE",133,0,0,133,"2017","019"
"20662","CASALETTO CEREDANO",8,11,0,19,"2017","018"
"20663","CASALETTO DI SOPRA",17,353,0,370,"2017","019"
"20664","CASALETTO LODIGIANO",12,418,33,463,"2017","008"
"20665","CASALETTO VAPRIO",146,536,0,682,"2017","020"
"20666","CASALFIUMANESE",321,143,0,464,"2017","012"
"20667","CASALGRANDE",26,1097,0,1123,"2017","012"
"20668","CASALGRASSO",292,361,0,653,"2017","045"
"20669","CASALINO",2,269,0,271,"2017","040"
"20670","CASALMAGGIORE",23,686,0,709,"2017","021"
"20671","CASALMAIOCCO",18,593,0,611,"2017","009"
"20672","CASALMORANO",110,2280,0,2390,"2017","022"
"20673","CASALMORO",677,0,612,1289,"2017","010"
"20674","CASALNOCETO",36,0,0,36,"2017","040"
"20675","CASALOLDO",983,1109,1159,3251,"2017","011"
"20676","CASALPUSTERLENGO",26,1215,0,1241,"2017","010"
"20677","CASALROMANO",263,288,206,757,"2017","012"
"20678","CASALSERUGO",119,8,21,148,"2017","028"
"20679","CASALVOLONE",19,42,0,61,"2017","041"
"20680","CASALZUIGNO",0,96,0,96,"2017","037"
"20681","CASARGO",7,16,0,23,"2017","015"
"20682","CASARILE",38,0,0,38,"2017","055"
"20683","CASATENOVO",367,30,0,397,"2017","016"
"20684","CASAZZA",10,20,2,32,"2017","058"
"20685","CASCIAGO",16,0,38,54,"2017","038"
"20686","CASEI GEROLA",621,0,0,621,"2017","033"
"20687","CASELETTE",76,320,38,434,"2017","062"
"20688","CASELLE LANDI",265,472,0,737,"2017","011"
"20689","CASELLE LURANI",51,291,0,342,"2017","012"
"20690","CASELLE TORINESE",431,1294,28,1753,"2017","063"
"20691","CASIER",15,109,0,124,"2017","010"
"20692","CASINA",78,962,0,1040,"2017","013"
"20693","CASIRATE D'ADDA",144,363,0,507,"2017","059"
"20694","CASLINO D'ERBA",4,0,9,13,"2017","052"
"20695","CASNATE CON BERNATE",39,0,0,39,"2017","053"
"20696","CASNIGO",37,134,0,171,"2017","060"
"20697","CASOLA VALSENIO",143,39,36,218,"2017","005"
"20698","CASORATE PRIMO",9,143,0,152,"2017","034"
"20699","CASOREZZO",0,307,0,307,"2017","058"
"20700","CASORZO",2,0,0,2,"2017","020"
"20701","CASPOGGIO",2,43,0,45,"2017","013"
"20702","CASSAGO BRIANZA",3,43,2,48,"2017","017"
"20703","CASSANO D'ADDA",91,230,0,321,"2017","059"
"20704","CASSANO MAGNAGO",8,115,28,151,"2017","040"
"20705","CASSANO SPINOLA",425,0,0,425,"2017","042"
"20706","CASSANO VALCUVIA",2,0,0,2,"2017","041"
"20707","CASSINA DE' PECCHI",0,344,0,344,"2017","060"
"20708","CASSINA RIZZARDI",2,0,0,2,"2017","055"
"20709","CASSINA VALSASSINA",4,44,0,48,"2017","018"
"20710","CASSINASCO",19,20,0,39,"2017","021"
"20711","CASSINE",269,0,0,269,"2017","043"
"20712","CASSINETTA DI LUGAGNANO",1,230,0,231,"2017","061"
"20713","CASSOLA",529,32,0,561,"2017","026"
"20714","CASSOLNOVO",0,44,0,44,"2017","035"
"20715","CASTAGNARO",152,0,0,152,"2017","020"
"20716","CASTAGNETO PO",68,0,0,68,"2017","064"
"20717","CASTAGNITO",147,0,0,147,"2017","046"
"20718","CASTAGNOLE DELLE LANZE",280,0,0,280,"2017","022"
"20719","CASTAGNOLE MONFERRATO",52,0,0,52,"2017","023"
"20720","CASTAGNOLE PIEMONTE",1475,769,76,2320,"2017","065"
"20721","CASTANA",2,0,0,2,"2017","036"
"20722","CASTANO PRIMO",80,0,0,80,"2017","062"
"20723","CASTEGGIO",16,0,0,16,"2017","037"
"20724","CASTEGNATO",21,1120,43,1184,"2017","040"
"20725","CASTEGNERO",96,54,0,150,"2017","027"
"20726","CASTEL BOGLIONE",17,0,0,17,"2017","024"
"20727","CASTEL BOLOGNESE",23,0,0,23,"2017","006"
"20728","CASTEL D'AIANO",29,640,32,701,"2017","013"
"20729","CASTEL D'ARIO",130,19,1235,1384,"2017","014"
"20730","CASTEL D'AZZANO",1923,129,0,2052,"2017","021"
"20731","CASTEL DEL RIO",13,18,0,31,"2017","014"
"20732","CASTEL DI CASIO",55,29,0,84,"2017","015"
"20733","CASTEL GABBIANO",0,1790,0,1790,"2017","024"
"20734","CASTEL GOFFREDO",1694,604,697,2995,"2017","015"
"20735","CASTEL GUELFO DI BOLOGNA",106,291,0,397,"2017","016"
"20736","CASTEL MELLA",3,389,0,392,"2017","042"
"20737","CASTEL ROCCHERO",10,0,0,10,"2017","032"
"20738","CASTEL ROZZONE",3,31,0,34,"2017","063"
"20739","CASTEL SAN GIOVANNI",129,793,0,922,"2017","013"
"20740","CASTEL SAN PIETRO TERME",504,285,0,789,"2017","020"
"20741","CASTELBELFORTE",1653,70,0,1723,"2017","013"
"20742","CASTELCOVATI",6,333,0,339,"2017","041"
"20743","CASTELCUCCO",50,196,0,246,"2017","011"
"20744","CASTELDELCI",216,0,0,216,"2017","021"
"20745","CASTELDELFINO",59,0,0,59,"2017","047"
"20746","CASTELDIDONE",57,0,0,57,"2017","023"
"20747","CASTELFRANCO EMILIA",1154,2601,0,3755,"2017","006"
"20748","CASTELFRANCO VENETO",4846,186,5,5037,"2017","012"
"20749","CASTELGOMBERTO",414,444,0,858,"2017","028"
"20750","CASTELGUGLIELMO",536,0,0,536,"2017","011"
"20751","CASTELL'ALFERO",412,0,0,412,"2017","025"
"20752","CASTELL'ARQUATO",82,771,0,853,"2017","012"
"20753","CASTELLAMONTE",308,274,39,621,"2017","066"
"20754","CASTELLAR",6,0,0,6,"2017","048"
"20755","CASTELLARANO",23,301,0,324,"2017","014"
"20756","CASTELLAZZO BORMIDA",138,24,0,162,"2017","047"
"20757","CASTELLAZZO NOVARESE",2,0,0,2,"2017","042"
"20758","CASTELLEONE",766,3741,5,4512,"2017","025"
"20759","CASTELLERO",3,0,0,3,"2017","026"
"20760","CASTELLETTO CERVO",13,34,0,47,"2017","015"
"20761","CASTELLETTO D'ERRO",2,0,0,2,"2017",NA
"20762","CASTELLETTO D'ORBA",7,0,0,7,"2017","049"
"20763","CASTELLETTO DI BRANDUZZO",11,0,0,11,"2017","038"
"20764","CASTELLETTO MERLI",43,0,0,43,"2017","050"
"20765","CASTELLETTO MONFERRATO",142,0,0,142,"2017","051"
"20766","CASTELLETTO SOPRA TICINO",108,45,0,153,"2017","043"
"20767","CASTELLETTO STURA",1266,43,104,1413,"2017","049"
"20768","CASTELLETTO UZZONE",7,0,0,7,"2017","050"
"20769","CASTELLI CALEPIO",39,260,0,299,"2017","062"
"20770","CASTELLINALDO D'ALBA",970,0,0,970,"2017",NA
"20771","CASTELLINO TANARO",152,0,0,152,"2017","052"
"20772","CASTELLO CABIAGLIO",11,0,0,11,"2017","043"
"20773","CASTELLO D'ARGILE",50,37,0,87,"2017","017"
"20774","CASTELLO DELL'ACQUA",24,10,0,34,"2017","014"
"20775","CASTELLO DI ANNONE",143,0,0,143,"2017","028"
"20776","CASTELLO DI BRIANZA",13,0,0,13,"2017","019"
"20777","CASTELLO DI GODEGO",6125,143,1,6269,"2017","013"
"20778","CASTELLUCCHIO",910,1543,1874,4327,"2017","016"
"20779","CASTELMAGNO",76,13,7,96,"2017","053"
"20780","CASTELMARTE",10,0,1,11,"2017","058"
"20781","CASTELMASSA",0,115,0,115,"2017","012"
"20782","CASTELNOVO BARIANO",1198,55,0,1253,"2017","013"
"20783","CASTELNOVO DI SOTTO",1,1222,0,1223,"2017","015"
"20784","CASTELNOVO NE' MONTI",71,1572,0,1643,"2017","016"
"20785","CASTELNUOVO BOCCA D'ADDA",2421,336,1,2758,"2017","013"
"20786","CASTELNUOVO BORMIDA",11,0,0,11,"2017","052"
"20787","CASTELNUOVO BOZZENTE",2,10,0,12,"2017","059"
"20788","CASTELNUOVO CALCEA",45,0,0,45,"2017","030"
"20789","CASTELNUOVO DEL GARDA",3582,237,13,3832,"2017","022"
"20790","CASTELNUOVO DON BOSCO",167,0,0,167,"2017","031"
"20791","CASTELNUOVO NIGRA",48,0,0,48,"2017","067"
"20792","CASTELNUOVO RANGONE",7,853,0,860,"2017","007"
"20793","CASTELNUOVO SCRIVIA",122,0,13,135,"2017","053"
"20794","CASTELSEPRIO",3,0,2,5,"2017","044"
"20795","CASTELSPINA",12,0,0,12,"2017","054"
"20796","CASTELVECCANA",5,0,0,5,"2017","045"
"20797","CASTELVERDE",202,3526,95,3823,"2017","026"
"20798","CASTELVETRO DI MODENA",20,1140,0,1160,"2017","008"
"20799","CASTELVETRO PIACENTINO",1020,1065,0,2085,"2017","014"
"20800","CASTELVISCONTI",14,1830,61,1905,"2017","027"
"20801","CASTENASO",133,124,0,257,"2017","021"
"20802","CASTENEDOLO",979,1572,0,2551,"2017","043"
"20803","CASTIGLIONE D'ADDA",6,475,0,481,"2017","014"
"20804","CASTIGLIONE D'INTELVI",4,7,3,14,"2017","060"
"20805","CASTIGLIONE DEI PEPOLI",106,89,0,195,"2017","022"
"20806","CASTIGLIONE DELLE STIVIERE",4566,1828,1298,7692,"2017","017"
"20807","CASTIGLIONE FALLETTO",25,0,0,25,"2017","055"
"20808","CASTIGLIONE OLONA",3,0,9,12,"2017","046"
"20809","CASTIGLIONE TINELLA",32,0,0,32,"2017","056"
"20810","CASTIGLIONE TORINESE",16,0,0,16,"2017","068"
"20811","CASTINO",153,0,0,153,"2017","057"
"20812","CASTIONE ANDEVENNO",15,40,0,55,"2017","015"
"20813","CASTIONE DELLA PRESOLANA",35,9,0,44,"2017","064"
"20814","CASTIRAGA VIDARDO",5,300,0,305,"2017","015"
"20815","CASTO",22,34,2,58,"2017","044"
"20816","CASTREZZATO",396,1109,52,1557,"2017","045"
"20817","CASTRO",1,0,0,1,"2017","065"
"20818","CASTROCARO TERME E TERRA DEL SOLE",6,1,0,7,"2017","005"
"20819","CASTRONNO",3,0,0,3,"2017","047"
"20820","CAVA MANARA",2,0,0,2,"2017","041"
"20821","CAVACURTA",78,548,0,626,"2017","016"
"20822","CAVAGLIA'",1280,180,0,1460,"2017","016"
"20823","CAVAGLIETTO",0,194,0,194,"2017","044"
"20824","CAVAGNOLO",26,0,0,26,"2017","069"
"20825","CAVAION VERONESE",4,0,0,4,"2017","023"
"20826","CAVALLERLEONE",410,1173,66,1649,"2017","058"
"20827","CAVALLERMAGGIORE",2230,2275,41,4546,"2017","059"
"20828","CAVALLINO-TREPORTI",20,0,0,20,"2017","044"
"20829","CAVALLIRIO",4,0,0,4,"2017","047"
"20830","CAVARGNA",0,0,18,18,"2017","062"
"20831","CAVARIA CON PREMEZZO",8,0,2,10,"2017","048"
"20832","CAVARZERE",6036,0,1,6037,"2017","006"
"20833","CAVASO DEL TOMBA",76,70,0,146,"2017","014"
"20834","CAVATORE",1,0,0,1,"2017","055"
"20835","CAVENAGO D'ADDA",7,851,142,1000,"2017","017"
"20836","CAVEZZO",0,360,0,360,"2017","009"
"20837","CAVOUR",3424,288,954,4666,"2017","070"
"20838","CAVRIAGO",33,639,0,672,"2017","017"
"20839","CAVRIANA",2048,1486,503,4037,"2017","018"
"20840","CAZZAGO SAN MARTINO",4356,232,307,4895,"2017","046"
"20841","CAZZANO DI TRAMIGNA",20,0,0,20,"2017","024"
"20842","CAZZANO SANT'ANDREA",305,0,0,305,"2017","067"
"20843","CECIMA",16,0,0,16,"2017","042"
"20844","CEDEGOLO",0,14,2,16,"2017","047"
"20845","CEDRASCO",0,43,0,43,"2017","016"
"20846","CEGGIA",15,1,0,16,"2017","007"
"20847","CELLA DATI",1073,88,42,1203,"2017","028"
"20848","CELLA MONTE",121,0,0,121,"2017","056"
"20849","CELLARENGO",339,81,161,581,"2017","033"
"20850","CELLATICA",1,48,1,50,"2017","048"
"20851","CELLE DI MACRA",110,0,13,123,"2017","060"
"20852","CELLE ENOMONDO",202,0,0,202,"2017","034"
"20853","CELLIO",11,0,0,11,"2017","038"
"20854","CENATE SOPRA",14,9,0,23,"2017","068"
"20855","CENATE SOTTO",14,0,0,14,"2017","069"
"20856","CENCENIGHE AGORDINO",0,4,0,4,"2017","010"
"20857","CENE",21,43,0,64,"2017","070"
"20858","CENESELLI",0,223,30,253,"2017","014"
"20859","CENTALLO",5757,669,415,6841,"2017","061"
"20860","CENTO",1,0,0,1,"2017","004"
"20861","CEPPO MORELLI",25,0,0,25,"2017","021"
"20862","CERANO",67,0,0,67,"2017","049"
"20863","CERANO D'INTELVI",11,0,32,43,"2017","063"
"20864","CERANOVA",0,587,0,587,"2017","043"
"20865","CERCENASCO",159,265,0,424,"2017","071"
"20866","CERCINO",17,49,0,66,"2017","017"
"20867","CEREA",1097,206,0,1303,"2017","025"
"20868","CERES",5,0,0,5,"2017","072"
"20869","CERESARA",1643,424,137,2204,"2017","019"
"20870","CERESETO",100,0,0,100,"2017","057"
"20871","CERESOLE ALBA",3441,687,0,4128,"2017","062"
"20872","CERESOLE REALE",0,27,0,27,"2017","073"
"20873","CERETE",20,153,0,173,"2017","071"
"20874","CERETTO LOMELLINA",1,0,0,1,"2017","044"
"20875","CERIANO LAGHETTO",0,46,0,46,"2017",NA
"20876","CERIGNALE",33,0,0,33,"2017","015"
"20877","CERMENATE",1,152,4,157,"2017","064"
"20878","CERNOBBIO",2,0,0,2,"2017",NA
"20879","CERNUSCO LOMBARDONE",15,0,0,15,"2017","020"
"20880","CERNUSCO SUL NAVIGLIO",11,171,0,182,"2017","070"
"20881","CERRETO CASTELLO",116,0,0,116,"2017","017"
"20882","CERRETO D'ASTI",1,0,0,1,"2017","035"
"20883","CERRETO GRUE",14,0,0,14,"2017","058"
"20884","CERRETTO LANGHE",12,0,0,12,"2017","063"
"20885","CERRINA MONFERRATO",57,0,27,84,"2017","059"
"20886","CERRIONE",85,317,0,402,"2017","018"
"20887","CERRO AL LAMBRO",1,775,0,776,"2017","071"
"20888","CERRO MAGGIORE",8,82,0,90,"2017","072"
"20889","CERRO TANARO",171,0,0,171,"2017","036"
"20890","CERRO VERONESE",18,187,0,205,"2017","026"
"20891","CERTOSA DI PAVIA",11,0,0,11,"2017","046"
"20892","CERVARESE SANTA CROCE",25,239,39,303,"2017","030"
"20893","CERVASCA",1251,277,33,1561,"2017","064"
"20894","CERVATTO",0,16,0,16,"2017",NA
"20895","CERVENO",1,15,4,20,"2017","049"
"20896","CERVERE",1536,197,217,1950,"2017","065"
"20897","CERVIA",1,0,0,1,"2017","007"
"20898","CERVIGNANO D'ADDA",0,870,0,870,"2017","018"
"20899","CESANA BRIANZA",10,19,0,29,"2017","021"
"20900","CESANA TORINESE",42,0,26,68,"2017","074"
"20901","CESANO BOSCONE",0,73,0,73,"2017","074"
"20902","CESANO MADERNO",1,0,0,1,"2017",NA
"20903","CESARA",2,0,0,2,"2017","022"
"20904","CESENA",102,19,0,121,"2017","007"
"20905","CESIOMAGGIORE",195,132,0,327,"2017","011"
"20906","CESSALTO",28,116,0,144,"2017","015"
"20907","CESSOLE",185,0,0,185,"2017","037"
"20908","CETO",4,24,41,69,"2017","050"
"20909","CEVA",1068,0,0,1068,"2017","066"
"20910","CEVO",32,8,0,40,"2017","051"
"20911","CHERASCO",4667,974,109,5750,"2017","067"
"20912","CHIALAMBERTO",7,0,32,39,"2017","075"
"20913","CHIAMPO",25,83,0,108,"2017","029"
"20914","CHIANOCCO",128,0,0,128,"2017","076"
"20915","CHIARANO",14,515,0,529,"2017","016"
"20916","CHIARI",1538,5806,167,7511,"2017","052"
"20917","CHIAVENNA",4,0,10,14,"2017","018"
"20918","CHIAVERANO",25,0,0,25,"2017","077"
"20919","CHIERI",2711,484,76,3271,"2017","078"
"20920","CHIES D'ALPAGO",16,4,0,20,"2017","012"
"20921","CHIESA IN VALMALENCO",20,41,0,61,"2017","019"
"20922","CHIESANUOVA",44,61,0,105,"2017","079"
"20923","CHIEVE",74,890,0,964,"2017","029"
"20924","CHIGNOLO D'ISOLA",63,376,0,439,"2017","072"
"20925","CHIGNOLO PO",26,78,0,104,"2017","048"
"20926","CHIOGGIA",2484,0,0,2484,"2017","008"
"20927","CHIOMONTE",1,28,0,29,"2017","080"
"20928","CHIUDUNO",35,2,0,37,"2017","073"
"20929","CHIUPPANO",8,28,0,36,"2017","030"
"20930","CHIURO",1,87,0,88,"2017","020"
"20931","CHIUSA DI PESIO",1500,385,106,1991,"2017","068"
"20932","CHIUSA DI SAN MICHELE",0,0,58,58,"2017","081"
"20933","CHIUSANO D'ASTI",36,0,0,36,"2017","038"
"20934","CHIVASSO",1412,253,0,1665,"2017","082"
"20935","CICOGNOLO",0,976,0,976,"2017","030"
"20936","CICONIO",68,87,0,155,"2017","083"
"20937","CIGLIANO",267,69,44,380,"2017","042"
"20938","CIGLIE'",455,0,0,455,"2017","069"
"20939","CIGOGNOLA",3,0,0,3,"2017","049"
"20940","CIGOLE",1972,1503,0,3475,"2017","053"
"20941","CILAVEGNA",10,31,0,41,"2017","050"
"20942","CIMADOLMO",354,47,0,401,"2017","017"
"20943","CIMBERGO",2,1,0,3,"2017","054"
"20944","CINAGLIO",702,0,0,702,"2017","039"
"20945","CINGIA DE' BOTTI",2,1064,0,1066,"2017","031"
"20946","CINO",12,12,0,24,"2017","021"
"20947","CINTANO",34,0,0,34,"2017","084"
"20948","CINTO CAOMAGGIORE",459,4,26,489,"2017","009"
"20949","CINTO EUGANEO",72,34,0,106,"2017","031"
"20950","CINZANO",13,0,0,13,"2017","085"
"20951","CIRIE'",403,219,46,668,"2017","086"
"20952","CIRIMIDO",7,24,0,31,"2017","068"
"20953","CISANO BERGAMASCO",23,0,0,23,"2017","074"
"20954","CISERANO",22,36,0,58,"2017","075"
"20955","CISLAGO",5,0,0,5,"2017","050"
"20956","CISLIANO",164,504,0,668,"2017","078"
"20957","CISMON DEL GRAPPA",1,29,2,32,"2017","031"
"20958","CISON DI VALMARINO",83,10,0,93,"2017","018"
"20959","CISSONE",8,0,0,8,"2017","070"
"20960","CISTERNA D'ASTI",88,0,0,88,"2017","040"
"20961","CITTADELLA",2203,1073,100,3376,"2017","032"
"20962","CITTIGLIO",6,10,0,16,"2017","051"
"20963","CIVATE",8,0,0,8,"2017","022"
"20964","CIVIASCO",0,5,0,5,"2017","043"
"20965","CIVIDATE AL PIANO",967,580,0,1547,"2017","076"
"20966","CIVIDATE CAMUNO",1,0,0,1,"2017","055"
"20967","CIVITELLA DI ROMAGNA",481,28,33,542,"2017","009"
"20968","CIVO",7,12,0,19,"2017","022"
"20969","CLAINO CON OSTENO",1,0,2,3,"2017","071"
"20970","CLAVESANA",427,0,0,427,"2017","071"
"20971","CLIVIO",11,60,0,71,"2017","052"
"20972","CLUSONE",97,163,5,265,"2017","077"
"20973","COASSOLO TORINESE",32,47,0,79,"2017","088"
"20974","COAZZE",17,0,14,31,"2017","089"
"20975","COAZZOLO",32,0,0,32,"2017","041"
"20976","COCCAGLIO",198,869,5,1072,"2017","056"
"20977","COCCONATO",73,0,0,73,"2017","042"
"20978","COCQUIO-TREVISAGO",29,0,0,29,"2017","053"
"20979","CODEVIGO",473,112,3,588,"2017","033"
"20980","CODIGORO",3538,209,0,3747,"2017","005"
"20981","CODOGNE'",38,228,10,276,"2017","019"
"20982","CODOGNO",16,825,0,841,"2017","019"
"20983","COGGIOLA",3,0,0,3,"2017","019"
"20984","COGLIATE",81,0,0,81,"2017",NA
"20985","COGOLLO DEL CENGIO",361,108,28,497,"2017","032"
"20986","COLERE",3,0,0,3,"2017","078"
"20987","COLI",64,0,0,64,"2017","016"
"20988","COLICO",75,92,52,219,"2017","023"
"20989","COLLE BRIANZA",6,0,1,7,"2017","024"
"20990","COLLE SANTA LUCIA",0,16,0,16,"2017","014"
"20991","COLLE UMBERTO",26,125,23,174,"2017","020"
"20992","COLLECCHIO",6,2609,0,2615,"2017","009"
"20993","COLLEGNO",209,279,4,492,"2017","090"
"20994","COLLERETTO CASTELNUOVO",4,22,0,26,"2017","091"
"20995","COLLERETTO GIACOSA",10,0,0,10,"2017","092"
"20996","COLLIO",29,79,10,118,"2017","058"
"20997","COLOGNA VENETA",9629,208,0,9837,"2017","027"
"20998","COLOGNE",474,674,6,1154,"2017","059"
"20999","COLOGNO AL SERIO",43,916,12,971,"2017","079"
"21000","COLONNO",0,0,1,1,"2017",NA
"21001","COLORINA",40,369,0,409,"2017","023"
"21002","COLORNO",8,1127,0,1135,"2017","010"
"21003","COLTURANO",2,9,0,11,"2017","082"
"21004","COLVERDE",21,103,14,138,"2017",NA
"21005","COLZATE",14,31,0,45,"2017","080"
"21006","COMACCHIO",497,173,0,670,"2017","006"
"21007","COMAZZO",56,864,8,928,"2017","020"
"21008","COMELICO SUPERIORE",28,172,0,200,"2017","015"
"21009","COMERIO",3,0,0,3,"2017","055"
"21010","COMEZZANO-CIZZAGO",182,1922,0,2104,"2017","060"
"21011","COMMESSAGGIO",0,10,16,26,"2017","020"
"21012","COMO",4,64,13,81,"2017","075"
"21013","COMPIANO",13,36,0,49,"2017","011"
"21014","COMUN NUOVO",39,31,0,70,"2017","081"
"21015","CONA",14678,0,0,14678,"2017","010"
"21016","CONCAMARISE",2,229,0,231,"2017","029"
"21017","CONCESIO",20,9,0,29,"2017","061"
"21018","CONCO",33,204,0,237,"2017","033"
"21019","CONCORDIA SAGITTARIA",1234,0,0,1234,"2017","011"
"21020","CONCORDIA SULLA SECCHIA",7,312,19,338,"2017","010"
"21021","CONCOREZZO",6,31,0,37,"2017",NA
"21022","CONDOVE",120,26,47,193,"2017","093"
"21023","CONEGLIANO",26,65,9,100,"2017","021"
"21024","CONFIENZA",38,19,74,131,"2017","052"
"21025","CONIOLO",168,0,0,168,"2017","060"
"21026","CONSELICE",552,246,0,798,"2017","008"
"21027","CONSELVE",1174,38,0,1212,"2017","034"
"21028","CONZANO",100,0,0,100,"2017","061"
"21029","COPPARO",191,0,0,191,"2017","007"
"21030","CORBETTA",919,72,10,1001,"2017","085"
"21031","CORBOLA",51,138,0,189,"2017","017"
"21032","CORDIGNANO",90,169,0,259,"2017","022"
"21033","CORIANO",44,141,0,185,"2017","003"
"21034","CORIO",184,0,0,184,"2017","094"
"21035","CORNA IMAGNA",17,40,0,57,"2017","082"
"21036","CORNALBA",2,11,0,13,"2017","249"
"21037","CORNAREDO",10,197,10,217,"2017","087"
"21038","CORNATE D'ADDA",26,108,0,134,"2017",NA
"21039","CORNEDO VICENTINO",3,137,0,140,"2017","034"
"21040","CORNEGLIANO LAUDENSE",0,193,0,193,"2017","021"
"21041","CORNELIANO D'ALBA",133,0,0,133,"2017","072"
"21042","CORNIGLIO",43,478,0,521,"2017","012"
"21043","CORNO GIOVINE",221,62,0,283,"2017","022"
"21044","CORNOVECCHIO",121,0,0,121,"2017","023"
"21045","CORNUDA",894,436,0,1330,"2017","023"
"21046","CORREGGIO",6,2034,0,2040,"2017","020"
"21047","CORREZZANA",1,31,2,34,"2017",NA
"21048","CORREZZOLA",5406,16,0,5422,"2017","035"
"21049","CORRIDO",59,8,11,78,"2017","077"
"21050","CORSIONE",13,0,0,13,"2017","044"
"21051","CORTANDONE",3,0,0,3,"2017",NA
"21052","CORTANZE",90,0,0,90,"2017","046"
"21053","CORTAZZONE",1,0,0,1,"2017","047"
"21054","CORTE BRUGNATELLA",99,18,0,117,"2017","017"
"21055","CORTE DE' CORTESI CON CIGNONE",0,1,207,208,"2017","032"
"21056","CORTE DE' FRATI",4,828,264,1096,"2017","033"
"21057","CORTE FRANCA",110,62,0,172,"2017","062"
"21058","CORTE PALASIO",7,1740,11,1758,"2017","024"
"21059","CORTEMAGGIORE",151,1785,0,1936,"2017","018"
"21060","CORTEMILIA",220,0,0,220,"2017","073"
"21061","CORTENO GOLGI",17,83,22,122,"2017","063"
"21062","CORTENOVA",2,30,4,36,"2017","025"
"21063","CORTENUOVA",182,1419,0,1601,"2017","083"
"21064","CORTEOLONA E GENZONE",195,81,0,276,"2017",NA
"21065","CORTIGLIONE",1,0,0,1,"2017","048"
"21066","CORTINA D'AMPEZZO",10,45,0,55,"2017","016"
"21067","CORVINO SAN QUIRICO",2,0,0,2,"2017","057"
"21068","CORZANO",113,232,0,345,"2017","064"
"21069","COSIO VALTELLINO",29,660,2,691,"2017","024"
"21070","COSSANO BELBO",424,0,0,424,"2017","074"
"21071","COSSATO",262,153,1,416,"2017","020"
"21072","COSSOGNO",1,0,0,1,"2017","023"
"21073","COSTA DE' NOBILI",54,13,7,74,"2017","058"
"21074","COSTA DI MEZZATE",25,0,0,25,"2017","084"
"21075","COSTA DI ROVIGO",0,323,0,323,"2017","018"
"21076","COSTA MASNAGA",21,0,0,21,"2017","026"
"21077","COSTA SERINA",10,3,0,13,"2017","247"
"21078","COSTA VALLE IMAGNA",9,0,0,9,"2017","085"
"21079","COSTA VESCOVATO",30,0,0,30,"2017","062"
"21080","COSTA VOLPINO",17,21,5,43,"2017","086"
"21081","COSTABISSARA",31,45,0,76,"2017","035"
"21082","COSTERMANO",10,46,0,56,"2017","030"
"21083","COSTIGLIOLE D'ASTI",401,1,0,402,"2017","050"
"21084","COSTIGLIOLE SALUZZO",481,39,21,541,"2017","075"
"21085","COTIGNOLA",82,0,0,82,"2017","009"
"21086","COVO",603,1265,0,1868,"2017","087"
"21087","CRANDOLA VALSASSINA",3,5,5,13,"2017","027"
"21088","CRAVAGLIANA",0,20,0,20,"2017","048"
"21089","CRAVANZANA",2,0,0,2,"2017","076"
"21090","CRAVEGGIA",16,0,0,16,"2017","024"
"21091","CREAZZO",16,24,0,40,"2017","036"
"21092","CREDARO",6,120,0,126,"2017","088"
"21093","CREDERA RUBBIANO",0,1077,235,1312,"2017","034"
"21094","CREMA",362,1987,424,2773,"2017","035"
"21095","CREMELLA",6,0,0,6,"2017","028"
"21096","CREMENO",1,24,30,55,"2017","029"
"21097","CREMIA",5,0,8,13,"2017","083"
"21098","CREMOLINO",96,0,0,96,"2017","063"
"21099","CREMONA",114,1175,2,1291,"2017","036"
"21100","CREMOSANO",36,512,0,548,"2017","037"
"21101","CRESCENTINO",65,0,40,105,"2017","049"
"21102","CRESPADORO",29,62,0,91,"2017","037"
"21103","CRESPANO DEL GRAPPA",1127,739,0,1866,"2017","024"
"21104","CRESPIATICA",0,423,0,423,"2017","025"
"21105","CRESPINO",2175,0,0,2175,"2017","019"
"21106","CRESSA",61,227,0,288,"2017","055"
"21107","CREVACUORE",1,0,0,1,"2017","021"
"21108","CREVALCORE",320,31,0,351,"2017","024"
"21109","CREVOLADOSSOLA",82,50,0,132,"2017","025"
"21110","CRISSOLO",0,0,17,17,"2017",NA
"21111","CROCETTA DEL MONTELLO",100,44,4,148,"2017","025"
"21112","CRODO",12,66,22,100,"2017","026"
"21113","CROSIO DELLA VALLE",6,0,0,6,"2017","057"
"21114","CROTTA D'ADDA",4,612,0,616,"2017","038"
"21115","CROVA",2,0,0,2,"2017","052"
"21116","CUASSO AL MONTE",15,0,0,15,"2017","058"
"21117","CUCCARO MONFERRATO",3,0,0,3,"2017","064"
"21118","CUCCIAGO",8,0,0,8,"2017","084"
"21119","CUCEGLIO",44,0,0,44,"2017","096"
"21120","CUGGIONO",473,89,0,562,"2017","096"
"21121","CUGLIATE-FABIASCO",1,0,0,1,"2017","059"
"21122","CUMIANA",1475,539,26,2040,"2017","097"
"21123","CUMIGNANO SUL NAVIGLIO",0,1401,33,1434,"2017","039"
"21124","CUNARDO",4,0,0,4,"2017","060"
"21125","CUNEO",7951,927,1071,9949,"2017","078"
"21126","CUNICO",1668,0,0,1668,"2017","051"
"21127","CUORGNE'",148,66,0,214,"2017","098"
"21128","CURA CARPIGNANO",26,149,1,176,"2017","060"
"21129","CUREGGIO",24,36,3,63,"2017","058"
"21130","CURIGLIA CON MONTEVIASCO",2,0,2,4,"2017","061"
"21131","CURINO",3,0,0,3,"2017","023"
"21132","CURNO",56,44,6,106,"2017","089"
"21133","CURTAROLO",73,243,2,318,"2017","036"
"21134","CURTATONE",3918,1344,1154,6416,"2017","021"
"21135","CUSAGO",100,463,0,563,"2017","097"
"21136","CUSINO",7,0,16,23,"2017","085"
"21137","CUSIO",2,0,0,2,"2017","090"
"21138","CUVEGLIO",4,4,0,8,"2017","062"
"21139","CUVIO",6,60,5,71,"2017","063"
"21140","DAIRAGO",33,33,0,66,"2017","099"
"21141","DALMINE",93,112,0,205,"2017","091"
"21142","DARFO BOARIO TERME",8,301,15,324,"2017","065"
"21143","DAVERIO",21,0,0,21,"2017","064"
"21144","DAZIO",0,13,0,13,"2017","025"
"21145","DELEBIO",34,123,2,159,"2017","026"
"21146","DELLO",713,2029,21,2763,"2017","066"
"21147","DEMONTE",817,87,0,904,"2017","079"
"21148","DENICE",2,0,0,2,"2017","065"
"21149","DERNICE",10,0,0,10,"2017","066"
"21150","DEROVERE",22,253,1,276,"2017","040"
"21151","DERVIO",1,0,0,1,"2017","030"
"21152","DESANA",56,0,0,56,"2017","054"
"21153","DESENZANO DEL GARDA",110,1411,625,2146,"2017","067"
"21154","DESIO",18,0,0,18,"2017",NA
"21155","DIANO D'ALBA",103,0,0,103,"2017","080"
"21156","DIVIGNANO",61,0,0,61,"2017","060"
"21157","DIZZASCO",0,0,8,8,"2017","087"
"21158","DOGLIANI",1857,0,0,1857,"2017","081"
"21159","DOLO",583,258,0,841,"2017","012"
"21160","DOMASO",0,3,2,5,"2017","089"
"21161","DOMODOSSOLA",23,9,8,40,"2017","028"
"21162","DONATO",162,0,27,189,"2017","024"
"21163","DONGO",7,5,3,15,"2017","090"
"21164","DORIO",2,0,0,2,"2017","032"
"21165","DORMELLETTO",4,0,0,4,"2017","062"
"21166","DORNO",1,10,0,11,"2017","061"
"21167","DORZANO",6,0,0,6,"2017","025"
"21168","DOSOLO",23,330,78,431,"2017","022"
"21169","DOSSENA",17,64,4,85,"2017","092"
"21170","DOSSO DEL LIRO",0,3,11,14,"2017","092"
"21171","DOVADOLA",125,0,0,125,"2017","011"
"21172","DOVERA",21,1285,34,1340,"2017","041"
"21173","DOZZA",4,23,0,27,"2017","025"
"21174","DRESANO",7,0,0,7,"2017","101"
"21175","DRIZZONA",0,429,0,429,"2017","042"
"21176","DRONERO",2359,269,35,2663,"2017","082"
"21177","DRUENTO",771,40,0,811,"2017","099"
"21178","DRUOGNO",10,4,0,14,"2017","029"
"21179","DUBINO",11,666,20,697,"2017","027"
"21180","DUE CARRARE",141,0,0,141,"2017","106"
"21181","DUEVILLE",459,629,1,1089,"2017","038"
"21182","DUMENZA",1,0,11,12,"2017","065"
"21183","DUSINO SAN MICHELE",365,40,0,405,"2017","052"
"21184","EDOLO",19,56,10,85,"2017","068"
"21185","ELLO",4,0,0,4,"2017","033"
"21186","ELVA",13,0,5,18,"2017","083"
"21187","ENDINE GAIANO",45,98,4,147,"2017","093"
"21188","ENEGO",22,190,0,212,"2017","039"
"21189","ENTRACQUE",83,0,0,83,"2017","084"
"21190","ENTRATICO",27,14,30,71,"2017","094"
"21191","ENVIE",1443,390,249,2082,"2017","085"
"21192","ERACLEA",4031,312,0,4343,"2017","013"
"21193","ERBA",34,415,0,449,"2017","095"
"21194","ERBE'",267,23,0,290,"2017","032"
"21195","ERBEZZO",47,693,0,740,"2017","033"
"21196","ERBUSCO",193,49,0,242,"2017","069"
"21197","ERVE",1,0,0,1,"2017","034"
"21198","ESINE",4,160,6,170,"2017","070"
"21199","ESINO LARIO",17,0,0,17,"2017","035"
"21200","ESTE",868,45,0,913,"2017","037"
"21201","EUPILIO",9,10,54,73,"2017","097"
"21202","EXILLES",3,0,0,3,"2017",NA
"21203","FABBRICA CURONE",9,31,0,40,"2017","067"
"21204","FABBRICO",1,269,0,270,"2017","021"
"21205","FAEDO VALTELLINO",8,20,0,28,"2017","028"
"21206","FAENZA",207,95,0,302,"2017","010"
"21207","FAGGETO LARIO",6,0,8,14,"2017","098"
"21208","FAGNANO OLONA",7,35,1,43,"2017","067"
"21209","FALCADE",10,26,0,36,"2017","019"
"21210","FALOPPIO",1,0,2,3,"2017","099"
"21211","FANANO",96,427,0,523,"2017","011"
"21212","FARA GERA D'ADDA",19,558,91,668,"2017","096"
"21213","FARA NOVARESE",4,0,0,4,"2017","065"
"21214","FARA OLIVANA CON SOLA",83,294,0,377,"2017","097"
"21215","FARA VICENTINO",630,413,158,1201,"2017","040"
"21216","FARIGLIANO",500,0,0,500,"2017","086"
"21217","FARINI",105,82,0,187,"2017","019"
"21218","FARRA DI SOLIGO",93,36,0,129,"2017","026"
"21219","FAULE",12,0,115,127,"2017","087"
"21220","FAVRIA",310,655,8,973,"2017","101"
"21221","FEISOGLIO",81,0,0,81,"2017","088"
"21222","FELETTO",9,13,0,22,"2017","102"
"21223","FELINO",8,1080,0,1088,"2017","013"
"21224","FELIZZANO",15,0,0,15,"2017","068"
"21225","FELTRE",185,1216,0,1401,"2017","021"
"21226","FENEGRO'",24,0,31,55,"2017","100"
"21227","FENESTRELLE",27,0,0,27,"2017","103"
"21228","FERNO",1,10,0,11,"2017","068"
"21229","FERRARA",258,210,0,468,"2017","008"
"21230","FERRARA DI MONTE BALDO",10,39,14,63,"2017","034"
"21231","FERRERA DI VARESE",15,0,0,15,"2017","069"
"21232","FERRERA ERBOGNONE",32,0,0,32,"2017","062"
"21233","FERRERE",910,0,0,910,"2017","053"
"21234","FERRIERE",114,4,0,118,"2017","020"
"21235","FIANO",8,0,0,8,"2017","104"
"21236","FICAROLO",21,0,0,21,"2017","021"
"21237","FIDENZA",100,3384,14,3498,"2017","014"
"21238","FIESCO",14,559,111,684,"2017","043"
"21239","FIESSE",597,381,394,1372,"2017","071"
"21240","FIESSO D'ARTICO",9,36,0,45,"2017","014"
"21241","FIESSO UMBERTIANO",118,0,0,118,"2017","022"
"21242","FIGINO SERENZA",50,90,0,140,"2017","101"
"21243","FILAGO",99,0,0,99,"2017","098"
"21244","FILIGHERA",0,1,0,1,"2017","063"
"21245","FINALE EMILIA",72,72,0,144,"2017","012"
"21246","FINO DEL MONTE",3,27,0,30,"2017","099"
"21247","FINO MORNASCO",12,0,0,12,"2017","102"
"21248","FIORANO AL SERIO",8,18,0,26,"2017","100"
"21249","FIORANO CANAVESE",5,0,0,5,"2017","105"
"21250","FIORANO MODENESE",3,48,0,51,"2017","013"
"21251","FIORENZUOLA D'ARDA",24,2105,0,2129,"2017","021"
"21252","FISCAGLIA",1806,84,1,1891,"2017",NA
"21253","FIUMALBO",117,83,0,200,"2017","014"
"21254","FLERO",228,226,115,569,"2017","072"
"21255","FOBELLO",16,0,4,20,"2017","057"
"21256","FOGLIZZO",162,0,0,162,"2017","106"
"21257","FOLLINA",391,98,0,489,"2017","027"
"21258","FOMBIO",284,185,0,469,"2017","026"
"21259","FONTANELICE",146,118,0,264,"2017","026"
"21260","FONTANELLA",3148,2377,0,5525,"2017","101"
"21261","FONTANELLATO",52,2322,0,2374,"2017","015"
"21262","FONTANELLE",42,574,17,633,"2017","028"
"21263","FONTANETO D'AGOGNA",12,78,0,90,"2017","066"
"21264","FONTANETTO PO",2,0,0,2,"2017","058"
"21265","FONTANILE",5,0,0,5,"2017","054"
"21266","FONTANIVA",315,320,0,635,"2017","038"
"21267","FONTE",977,594,3,1574,"2017","029"
"21268","FONTENO",11,0,0,11,"2017","102"
"21269","FONTEVIVO",0,1635,0,1635,"2017","016"
"21270","FONZASO",57,66,0,123,"2017","022"
"21271","FOPPOLO",1,14,0,15,"2017","103"
"21272","FORCOLA",7,122,0,129,"2017","029"
"21273","FORESTO SPARSO",16,99,1,116,"2017","104"
"21274","FORLI'",494,134,0,628,"2017","012"
"21275","FORLIMPOPOLI",9,9,0,18,"2017","013"
"21276","FORMAZZA",2,19,8,29,"2017","031"
"21277","FORMIGARA",3,866,227,1096,"2017","044"
"21278","FORMIGINE",1,1852,0,1853,"2017","015"
"21279","FORMIGLIANA",14,0,0,14,"2017","059"
"21280","FORMIGNANA",5,0,0,5,"2017","009"
"21281","FORNO CANAVESE",32,0,0,32,"2017","107"
"21282","FORNOVO DI TARO",27,611,0,638,"2017","017"
"21283","FORNOVO SAN GIOVANNI",16,703,23,742,"2017","105"
"21284","FORTUNAGO",54,0,0,54,"2017","064"
"21285","FOSSALTA DI PIAVE",3,0,0,3,"2017","015"
"21286","FOSSALTA DI PORTOGRUARO",0,949,0,949,"2017","016"
"21287","FOSSANO",18532,4373,1240,24145,"2017","089"
"21288","FOSSO'",97,30,0,127,"2017","017"
"21289","FOZA",44,44,13,101,"2017","041"
"21290","FRABOSA SOPRANA",261,3,156,420,"2017","090"
"21291","FRABOSA SOTTANA",48,30,37,115,"2017","091"
"21292","FRACONALTO",29,0,0,29,"2017","069"
"21293","FRASCARO",0,6,0,6,"2017","071"
"21294","FRASCAROLO",216,31,0,247,"2017","065"
"21295","FRASSINELLE POLESINE",213,0,0,213,"2017","023"
"21296","FRASSINELLO MONFERRATO",55,0,0,55,"2017","072"
"21297","FRASSINETO PO",51,0,0,51,"2017","073"
"21298","FRASSINETTO",146,8,0,154,"2017","108"
"21299","FRASSINO",34,0,0,34,"2017","092"
"21300","FRASSINORO",92,146,0,238,"2017","016"
"21301","FRATTA POLESINE",285,146,0,431,"2017","024"
"21302","FREGONA",11,21,0,32,"2017","030"
"21303","FRESONARA",22,0,0,22,"2017","074"
"21304","FRINCO",291,0,0,291,"2017","055"
"21305","FRONT",54,0,11,65,"2017","109"
"21306","FROSSASCO",2096,0,104,2200,"2017","110"
"21307","FRUGAROLO",138,157,0,295,"2017","075"
"21308","FUBINE",157,0,0,157,"2017","076"
"21309","FUIPIANO VALLE IMAGNA",16,48,0,64,"2017","106"
"21310","FUMANE",19,41,6,66,"2017","035"
"21311","FUSIGNANO",2,0,0,2,"2017","011"
"21312","FUSINE",0,33,0,33,"2017","030"
"21313","GABBIONETA-BINANUOVA",49,660,0,709,"2017","045"
"21314","GABIANO",54,0,0,54,"2017","077"
"21315","GADESCO-PIEVE DELMONA",27,448,77,552,"2017","046"
"21316","GAGGIANO",85,409,9,503,"2017","103"
"21317","GAGGIO MONTANO",249,367,1,617,"2017","027"
"21318","GAGLIANICO",3,0,0,3,"2017","026"
"21319","GAIARINE",779,0,0,779,"2017","031"
"21320","GAIBA",40,0,0,40,"2017","025"
"21321","GAIOLA",28,0,1,29,"2017","093"
"21322","GALBIATE",40,13,0,53,"2017","036"
"21323","GALEATA",217,0,12,229,"2017","014"
"21324","GALGAGNANO",0,906,0,906,"2017","027"
"21325","GALLARATE",6,28,6,40,"2017","070"
"21326","GALLIATE",27,38,0,65,"2017","068"
"21327","GALLIATE LOMBARDO",12,0,0,12,"2017","071"
"21328","GALLIERA",0,42,0,42,"2017","028"
"21329","GALLIERA VENETA",3624,119,0,3743,"2017","039"
"21330","GALLIO",1,221,0,222,"2017","042"
"21331","GALZIGNANO TERME",11,0,0,11,"2017","040"
"21332","GAMALERO",22,0,0,22,"2017","078"
"21333","GAMBARA",4202,2055,469,6726,"2017","073"
"21334","GAMBASCA",3,0,0,3,"2017","094"
"21335","GAMBOLO'",139,152,0,291,"2017","068"
"21336","GAMBUGLIANO",2,48,0,50,"2017","044"
"21337","GANDELLINO",10,0,0,10,"2017","107"
"21338","GANDINO",48,152,0,200,"2017","108"
"21339","GANDOSSO",4,17,0,21,"2017","109"
"21340","GARBAGNA",90,0,0,90,"2017","079"
"21341","GARBAGNATE MILANESE",4,0,0,4,"2017",NA
"21342","GARBAGNATE MONASTERO",6,0,0,6,"2017","037"
"21343","GARDONE RIVIERA",11,0,0,11,"2017","074"
"21344","GARDONE VAL TROMPIA",25,0,0,25,"2017","075"
"21345","GARESSIO",177,0,24,201,"2017","095"
"21346","GARGNANO",30,0,23,53,"2017","076"
"21347","GARLASCO",10,30,7,47,"2017","069"
"21348","GARZENO",12,4,21,37,"2017","106"
"21349","GARZIGLIANA",270,0,0,270,"2017","111"
"21350","GASSINO TORINESE",28,0,0,28,"2017","112"
"21351","GATTATICO",8,2551,0,2559,"2017","022"
"21352","GATTEO",5,0,0,5,"2017","016"
"21353","GATTICO",35,121,178,334,"2017","071"
"21354","GATTINARA",40,0,0,40,"2017","061"
"21355","GAVARDO",94,488,8,590,"2017","077"
"21356","GAVELLO",99,0,0,99,"2017",NA
"21357","GAVERINA TERME",21,40,0,61,"2017","110"
"21358","GAVI",27,0,0,27,"2017","081"
"21359","GAVIRATE",49,0,0,49,"2017","072"
"21360","GAZOLDO DEGLI IPPOLITI",480,87,4,571,"2017","024"
"21361","GAZZADA SCHIANNO",8,9,0,17,"2017","073"
"21362","GAZZANIGA",24,46,0,70,"2017","111"
"21363","GAZZO",73,2719,1,2793,"2017","041"
"21364","GAZZO VERONESE",1183,292,0,1475,"2017","037"
"21365","GAZZOLA",91,1437,0,1528,"2017","022"
"21366","GAZZUOLO",931,44,11,986,"2017","025"
"21367","GEMMANO",21,66,0,87,"2017","004"
"21368","GEMONIO",0,0,1,1,"2017","074"
"21369","GENIVOLTA",175,2018,0,2193,"2017","047"
"21370","GENOLA",2183,1956,233,4372,"2017","096"
"21371","GERA LARIO",39,225,10,274,"2017","107"
"21372","GERENZAGO",11,0,0,11,"2017","071"
"21373","GERENZANO",106,116,0,222,"2017","075"
"21374","GERMAGNANO",14,0,15,29,"2017","113"
"21375","GERMAGNO",2,0,0,2,"2017","032"
"21376","GERMIGNAGA",11,89,0,100,"2017","076"
"21377","GERRE DE' CAPRIOLI",0,441,0,441,"2017","048"
"21378","GESSATE",5,433,0,438,"2017","106"
"21379","GHEDI",3596,6548,34,10178,"2017","078"
"21380","GHEMME",25,0,22,47,"2017","073"
"21381","GHIFFA",2,0,0,2,"2017","033"
"21382","GHISALBA",1,729,0,730,"2017","113"
"21383","GHISLARENGO",23,0,0,23,"2017","062"
"21384","GIAGLIONE",24,0,0,24,"2017","114"
"21385","GIANICO",180,164,176,520,"2017","079"
"21386","GIAVENO",172,402,187,761,"2017","115"
"21387","GIAVERA DEL MONTELLO",707,146,0,853,"2017","032"
"21388","GIGNESE",2,0,5,7,"2017","034"
"21389","GIUSSAGO",18,137,0,155,"2017","072"
"21390","GIUSSANO",2,0,0,2,"2017",NA
"21391","GIVOLETTO",18,0,0,18,"2017","116"
"21392","GODEGA DI SANT'URBANO",37,105,0,142,"2017","033"
"21393","GODIASCO",6,0,0,6,"2017","073"
"21394","GOITO",4046,4867,1306,10219,"2017","026"
"21395","GOLASECCA",21,24,0,45,"2017","077"
"21396","GOLFERENZO",0,0,23,23,"2017","074"
"21397","GOMBITO",2,869,0,871,"2017","049"
"21398","GONZAGA",17830,2372,4084,24286,"2017","027"
"21399","GORDONA",96,124,17,237,"2017","032"
"21400","GORGO AL MONTICANO",41,325,22,388,"2017","034"
"21401","GORGONZOLA",33,249,0,282,"2017","108"
"21402","GORLA MAGGIORE",9,0,174,183,"2017","078"
"21403","GORLA MINORE",74,0,0,74,"2017","079"
"21404","GORLAGO",66,300,4,370,"2017","114"
"21405","GORLE",6,0,0,6,"2017","115"
"21406","GORNATE-OLONA",19,0,0,19,"2017","080"
"21407","GORNO",28,71,0,99,"2017","116"
"21408","GORZEGNO",25,0,0,25,"2017","097"
"21409","GOSSOLENGO",1,707,0,708,"2017","023"
"21410","GOTTASECCA",39,0,0,39,"2017","098"
"21411","GOTTOLENGO",12875,1265,88,14228,"2017","080"
"21412","GOVONE",305,0,0,305,"2017","099"
"21413","GOZZANO",4,0,0,4,"2017","076"
"21414","GRAFFIGNANA",62,215,69,346,"2017","028"
"21415","GRAGLIA",76,15,68,159,"2017","028"
"21416","GRAGNANO TREBBIENSE",3,2683,0,2686,"2017","024"
"21417","GRANA",61,0,0,61,"2017","056"
"21418","GRANAROLO DELL'EMILIA",34,258,211,503,"2017","030"
"21419","GRANDOLA ED UNITI",4,15,36,55,"2017","111"
"21420","GRANOZZO CON MONTICELLO",2,58,0,60,"2017","077"
"21421","GRANTOLA",59,0,0,59,"2017","081"
"21422","GRANTORTO",54,908,2,964,"2017","042"
"21423","GRANZE",870,0,0,870,"2017","043"
"21424","GRASSOBBIO",14,154,0,168,"2017","117"
"21425","GRAVEDONA ED UNITI",14,27,47,88,"2017","249"
"21426","GRAVELLONA LOMELLINA",9,25,0,34,"2017","075"
"21427","GRAVELLONA TOCE",22,0,0,22,"2017","035"
"21428","GRAVERE",4,0,0,4,"2017","117"
"21429","GRAZZANO BADOGLIO",561,0,0,561,"2017","057"
"21430","GREMIASCO",22,0,0,22,"2017","083"
"21431","GREZZAGO",4,0,0,4,"2017","110"
"21432","GREZZANA",120,586,0,706,"2017","038"
"21433","GRIANTE",5,0,4,9,"2017","113"
"21434","GRIGNASCO",40,0,0,40,"2017","079"
"21435","GRINZANE CAVOUR",18,0,0,18,"2017","100"
"21436","GRISIGNANO DI ZOCCO",37,436,12,485,"2017","046"
"21437","GRIZZANA MORANDI",73,0,0,73,"2017","031"
"21438","GROMO",34,78,7,119,"2017","118"
"21439","GRONDONA",6,0,0,6,"2017","085"
"21440","GRONE",33,27,0,60,"2017","119"
"21441","GRONTARDO",0,2054,0,2054,"2017","050"
"21442","GROPELLO CAIROLI",28,0,0,28,"2017","076"
"21443","GROPPARELLO",100,30,0,130,"2017","025"
"21444","GROSCAVALLO",25,13,25,63,"2017","118"
"21445","GROSIO",24,199,5,228,"2017","033"
"21446","GROSOTTO",8,35,14,57,"2017","034"
"21447","GROSSO",72,0,0,72,"2017","119"
"21448","GRUARO",9,211,1,221,"2017","018"
"21449","GRUGLIASCO",86,10,26,122,"2017","120"
"21450","GRUMELLO CREMONESE ED UNITI",160,1515,328,2003,"2017","051"
"21451","GRUMELLO DEL MONTE",125,108,0,233,"2017","120"
"21452","GRUMOLO DELLE ABBADESSE",41,194,0,235,"2017","047"
"21453","GUALTIERI",1298,613,0,1911,"2017","023"
"21454","GUANZATE",19,0,1,20,"2017","114"
"21455","GUARDA VENETA",785,0,0,785,"2017","028"
"21456","GUARDABOSONE",73,12,0,85,"2017","066"
"21457","GUARDAMIGLIO",10,73,257,340,"2017","029"
"21458","GUARENE",314,0,0,314,"2017","101"
"21459","GUASTALLA",59,1094,0,1153,"2017","024"
"21460","GUDO VISCONTI",16,0,0,16,"2017","112"
"21461","GUIDIZZOLO",1501,856,277,2634,"2017","028"
"21462","GUIGLIA",23,499,0,522,"2017","017"
"21463","GUSSAGO",60,897,110,1067,"2017","081"
"21464","GUSSOLA",2,46,3,51,"2017","052"
"21465","IDRO",6,0,0,6,"2017","082"
"21466","IESOLO",5,36,5,46,"2017","019"
"21467","IGLIANO",65,0,24,89,"2017","102"
"21468","ILLASI",0,75,0,75,"2017","039"
"21469","IMBERSAGO",2,0,0,2,"2017","039"
"21470","IMOLA",111,0,0,111,"2017","032"
"21471","INARZO",10,0,0,10,"2017","082"
"21472","INCISA SCAPACCINO",33,0,0,33,"2017","058"
"21473","INCUDINE",2,0,0,2,"2017","083"
"21474","INDUNO OLONA",22,87,0,109,"2017","083"
"21475","INTRAGNA",1,0,0,1,"2017","037"
"21476","INTROBIO",69,29,0,98,"2017","040"
"21477","INVERIGO",117,0,0,117,"2017","118"
"21478","INVERNO E MONTELEONE",91,129,21,241,"2017","077"
"21479","INVERSO PINASCA",36,0,0,36,"2017","122"
"21480","INVERUNO",2,99,0,101,"2017","113"
"21481","INVORIO",29,108,0,137,"2017","082"
"21482","INZAGO",301,762,0,1063,"2017","114"
"21483","IRMA",7,0,0,7,"2017","084"
"21484","ISASCA",37,0,0,37,"2017","103"
"21485","ISEO",26,22,0,48,"2017","085"
"21486","ISOLA D'ASTI",355,0,0,355,"2017","059"
"21487","ISOLA DELLA SCALA",7368,386,0,7754,"2017","040"
"21488","ISOLA DI FONDRA",6,22,0,28,"2017","121"
"21489","ISOLA DOVARESE",0,689,0,689,"2017","053"
"21490","ISOLA RIZZA",2065,308,0,2373,"2017","041"
"21491","ISOLA VICENTINA",2198,737,18,2953,"2017","048"
"21492","ISOLABELLA",31,0,494,525,"2017","123"
"21493","ISORELLA",11241,723,0,11964,"2017","086"
"21494","ISPRA",55,159,0,214,"2017","084"
"21495","ISSIGLIO",66,13,4,83,"2017","124"
"21496","ISSO",7,1210,0,1217,"2017","122"
"21497","ISTRANA",3323,384,53,3760,"2017","035"
"21498","IVREA",201,193,0,394,"2017","125"
"21499","IZANO",3,983,0,986,"2017","054"
"21500","JERAGO CON ORAGO",2,0,0,2,"2017","085"
"21501","JOLANDA DI SAVOIA",4354,0,0,4354,"2017","010"
"21502","LA CASSA",1,343,0,344,"2017","126"
"21503","LA LOGGIA",91,0,95,186,"2017","127"
"21504","LA MORRA",56,0,0,56,"2017","105"
"21505","LA VALLE AGORDINA",8,31,2,41,"2017","027"
"21506","LA VALLETTA BRIANZA",16,9,14,39,"2017",NA
"21507","LACCHIARELLA",37,32,0,69,"2017","115"
"21508","LAGNASCO",29,33,0,62,"2017","104"
"21509","LAGOSANTO",33,0,0,33,"2017","011"
"21510","LAINATE",14,0,4,18,"2017","116"
"21511","LAINO",6,1,0,7,"2017","120"
"21512","LAMA MOCOGNO",94,423,0,517,"2017","018"
"21513","LAMBRUGO",0,113,0,113,"2017","121"
"21514","LAMON",14,23,0,37,"2017","026"
"21515","LAMPORO",24,0,0,24,"2017","067"
"21516","LANDRIANO",15,257,0,272,"2017","078"
"21517","LANGHIRANO",7,893,0,900,"2017","018"
"21518","LANGOSCO",5,0,0,5,"2017","079"
"21519","LANZADA",17,64,0,81,"2017","036"
"21520","LANZO TORINESE",151,0,28,179,"2017","128"
"21521","LASNIGO",0,18,0,18,"2017","123"
"21522","LAURIANO",12,0,0,12,"2017","129"
"21523","LAVENA PONTE TRESA",7,0,0,7,"2017","086"
"21524","LAVENO-MOMBELLO",2,0,0,2,"2017","087"
"21525","LAVENONE",19,0,0,19,"2017","087"
"21526","LAZISE",69,145,0,214,"2017","043"
"21527","LAZZATE",26,0,0,26,"2017",NA
"21528","LECCO",16,44,5,65,"2017","042"
"21529","LEFFE",15,83,0,98,"2017","124"
"21530","LEGGIUNO",2,0,0,2,"2017","088"
"21531","LEGNAGO",73,46,0,119,"2017","044"
"21532","LEGNANO",0,68,0,68,"2017","118"
"21533","LEGNARO",98,37,55,190,"2017","044"
"21534","LEINI'",595,649,102,1346,"2017","130"
"21535","LEMIE",12,0,72,84,"2017","131"
"21536","LENDINARA",653,103,0,756,"2017","029"
"21537","LENNA",2,6,0,8,"2017","125"
"21538","LENO",6249,6888,1067,14204,"2017","088"
"21539","LENTA",0,19,0,19,"2017","068"
"21540","LENTATE SUL SEVESO",1,84,99,184,"2017",NA
"21541","LENTIAI",29,136,0,165,"2017","028"
"21542","LEQUIO BERRIA",35,0,0,35,"2017","106"
"21543","LEQUIO TANARO",2101,0,0,2101,"2017","107"
"21544","LERMA",4,0,0,4,"2017","088"
"21545","LESA",2,0,0,2,"2017","084"
"21546","LESEGNO",860,0,0,860,"2017","108"
"21547","LESIGNANO DE' BAGNI",46,1393,0,1439,"2017","019"
"21548","LESMO",2,156,0,158,"2017",NA
"21549","LESSOLO",145,4,0,149,"2017","132"
"21550","LESSONA",3,14,0,17,"2017","029"
"21551","LEVATE",12,0,0,12,"2017","126"
"21552","LEVICE",88,0,0,88,"2017","109"
"21553","LEZZENO",0,0,1,1,"2017","126"
"21554","LIERNA",5,5,0,10,"2017","043"
"21555","LIMANA",60,136,0,196,"2017","029"
"21556","LIMENA",730,662,81,1473,"2017","045"
"21557","LIMIDO COMASCO",2,41,1,44,"2017","128"
"21558","LIMONE PIEMONTE",95,0,0,95,"2017","110"
"21559","LINAROLO",6,348,0,354,"2017","081"
"21560","LIPOMO",1,0,0,1,"2017",NA
"21561","LIRIO",32,0,0,32,"2017","082"
"21562","LISCATE",14,0,0,14,"2017","122"
"21563","LISIO",58,0,0,58,"2017","111"
"21564","LISSONE",237,0,0,237,"2017",NA
"21565","LIVIGNO",58,329,3,390,"2017","037"
"21566","LIVINALLONGO DEL COL DI LANA",4,57,0,61,"2017","030"
"21567","LIVO",3,3,0,6,"2017","130"
"21568","LIVORNO FERRARIS",2,59,0,61,"2017","071"
"21569","LIVRAGA",63,1053,7,1123,"2017","030"
"21570","LIZZANO IN BELVEDERE",22,48,19,89,"2017","033"
"21571","LOAZZOLO",6,0,1,7,"2017","060"
"21572","LOCANA",148,97,1,246,"2017","134"
"21573","LOCATE DI TRIULZI",0,909,0,909,"2017","125"
"21574","LOCATE VARESINO",12,0,0,12,"2017","131"
"21575","LOCATELLO",33,26,0,59,"2017","127"
"21576","LODI",302,1278,53,1633,"2017","031"
"21577","LODI VECCHIO",1,1164,0,1165,"2017","032"
"21578","LODRINO",12,9,0,21,"2017","090"
"21579","LOGRATO",1373,550,3,1926,"2017","091"
"21580","LOIANO",45,293,0,338,"2017","034"
"21581","LOMAZZO",1,0,0,1,"2017","133"
"21582","LOMBARDORE",20,0,0,20,"2017","135"
"21583","LOMBRIASCO",94,127,0,221,"2017","136"
"21584","LOMELLO",2,158,0,160,"2017","083"
"21585","LONATE CEPPINO",2,266,0,268,"2017","089"
"21586","LONATE POZZOLO",15,0,7,22,"2017","090"
"21587","LONATO",2764,4742,485,7991,"2017","092"
"21588","LONGARE",73,227,0,300,"2017","051"
"21589","LONGARONE",6,0,0,6,"2017","031"
"21590","LONGHENA",0,420,0,420,"2017","093"
"21591","LONGIANO",23,0,0,23,"2017","018"
"21592","LONIGO",5962,495,0,6457,"2017","052"
"21593","LORANZE'",13,0,0,13,"2017","137"
"21594","LOREGGIA",240,463,5,708,"2017","046"
"21595","LOREGLIA",7,0,0,7,"2017","038"
"21596","LORENZAGO DI CADORE",9,0,0,9,"2017","032"
"21597","LOREO",1074,84,0,1158,"2017","030"
"21598","LORIA",6338,28,2,6368,"2017","036"
"21599","LOSINE",0,49,0,49,"2017","094"
"21600","LOVERE",5,25,0,30,"2017","128"
"21601","LOVERO",2,9,0,11,"2017","038"
"21602","LOZIO",0,4,0,4,"2017","095"
"21603","LOZZA",0,121,0,121,"2017","091"
"21604","LOZZO ATESTINO",1529,3,0,1532,"2017","047"
"21605","LU",84,0,0,84,"2017","089"
"21606","LUGAGNANO VAL D'ARDA",64,156,0,220,"2017","026"
"21607","LUGNACCO",1,0,0,1,"2017","138"
"21608","LUGO",458,126,0,584,"2017","012"
"21609","LUGO DI VICENZA",18,142,7,167,"2017","053"
"21610","LUINO",8,16,0,24,"2017","092"
"21611","LUISAGO",8,0,0,8,"2017","135"
"21612","LUMEZZANE",16,0,0,16,"2017","096"
"21613","LURAGO D'ERBA",8,0,1,9,"2017","136"
"21614","LURAGO MARINONE",0,136,0,136,"2017","137"
"21615","LURANO",38,0,0,38,"2017","129"
"21616","LURATE CACCIVIO",30,0,93,123,"2017","138"
"21617","LUSERNA SAN GIOVANNI",420,81,46,547,"2017","139"
"21618","LUSERNETTA",84,0,0,84,"2017","140"
"21619","LUSIA",16,0,0,16,"2017","031"
"21620","LUSIANA",16,97,3,116,"2017","054"
"21621","LUSIGLIE'",70,0,0,70,"2017","141"
"21622","LUZZANA",22,0,0,22,"2017","130"
"21623","LUZZARA",1584,1147,9,2740,"2017","026"
"21624","MACCAGNO CON PINO E VEDDASCA",1,0,16,17,"2017",NA
"21625","MACCASTORNA",551,73,0,624,"2017","033"
"21626","MACELLO",1433,218,356,2007,"2017","142"
"21627","MACLODIO",28,444,0,472,"2017","097"
"21628","MACRA",3,0,0,3,"2017",NA
"21629","MACUGNAGA",0,6,0,6,"2017","039"
"21630","MADESIMO",0,6,0,6,"2017","035"
"21631","MADIGNANO",62,636,0,698,"2017","055"
"21632","MADONE",14,0,0,14,"2017","131"
"21633","MADONNA DEL SASSO",12,0,0,12,"2017","040"
"21634","MAGASA",11,17,0,28,"2017","098"
"21635","MAGENTA",32,748,0,780,"2017","130"
"21636","MAGGIORA",118,66,0,184,"2017","088"
"21637","MAGHERNO",0,91,0,91,"2017","085"
"21638","MAGLIANO ALFIERI",435,0,0,435,"2017","113"
"21639","MAGLIANO ALPI",604,85,0,689,"2017","114"
"21640","MAGNACAVALLO",64,281,478,823,"2017","029"
"21641","MAGNAGO",51,0,0,51,"2017","131"
"21642","MAGNANO",14,11,0,25,"2017","030"
"21643","MAIOLO",113,0,0,113,"2017","022"
"21644","MAIRAGO",2,458,0,460,"2017","034"
"21645","MAIRANO",351,639,55,1045,"2017","099"
"21646","MALAGNINO",158,630,0,788,"2017","056"
"21647","MALALBERGO",1,0,0,1,"2017","035"
"21648","MALCESINE",10,81,0,91,"2017","045"
"21649","MALEGNO",10,39,8,57,"2017","100"
"21650","MALEO",38,1485,0,1523,"2017","035"
"21651","MALESCO",18,0,7,25,"2017","041"
"21652","MALGESSO",80,0,0,80,"2017","095"
"21653","MALNATE",56,49,0,105,"2017","096"
"21654","MALO",2345,309,0,2654,"2017","055"
"21655","MALONNO",14,230,23,267,"2017","101"
"21656","MALVICINO",7,1,0,8,"2017","090"
"21657","MANDELLO DEL LARIO",19,0,0,19,"2017","046"
"21658","MANDELLO VITTA",1,0,0,1,"2017","090"
"21659","MANERBA DEL GARDA",14,0,19,33,"2017","102"
"21660","MANERBIO",820,1418,0,2238,"2017","103"
"21661","MANGO",18,0,0,18,"2017","115"
"21662","MANSUE'",64,341,8,413,"2017","037"
"21663","MANTA",3,0,0,3,"2017","116"
"21664","MANTELLO",6,122,0,128,"2017","039"
"21665","MANTOVA",846,944,129,1919,"2017","030"
"21666","MAPELLO",5,0,23,28,"2017","132"
"21667","MARANELLO",23,595,0,618,"2017","019"
"21668","MARANO DI VALPOLICELLA",26,57,17,100,"2017","046"
"21669","MARANO SUL PANARO",47,656,0,703,"2017","020"
"21670","MARANO TICINO",4,238,0,242,"2017","091"
"21671","MARANO VICENTINO",194,264,49,507,"2017","056"
"21672","MARCALLO CON CASONE",0,301,0,301,"2017","134"
"21673","MARCARIA",2144,3341,794,6279,"2017","031"
"21674","MARCHENO",19,8,0,27,"2017","104"
"21675","MARCHIROLO",1,0,0,1,"2017","097"
"21676","MARCIGNAGO",4,0,0,4,"2017","086"
"21677","MARCON",470,10,0,480,"2017","020"
"21678","MARENE",3095,2213,92,5400,"2017","117"
"21679","MARENO DI PIAVE",1596,183,0,1779,"2017","038"
"21680","MARENTINO",120,0,0,120,"2017","144"
"21681","MARETTO",130,0,0,130,"2017","062"
"21682","MARGARITA",797,0,0,797,"2017","118"
"21683","MARGNO",4,5,0,9,"2017","047"
"21684","MARIANA MANTOVANA",50,290,45,385,"2017","032"
"21685","MARIANO COMENSE",837,65,0,902,"2017","143"
"21686","MARMENTINO",22,12,5,39,"2017","105"
"21687","MARMIROLO",3648,2137,3085,8870,"2017","033"
"21688","MARMORA",28,0,92,120,"2017","119"
"21689","MARNATE",2,0,0,2,"2017",NA
"21690","MARONE",40,9,14,63,"2017","106"
"21691","MAROSTICA",156,708,0,864,"2017","057"
"21692","MARSAGLIA",155,0,0,155,"2017","120"
"21693","MARTELLAGO",35,11,0,46,"2017","021"
"21694","MARTIGNANA DI PO",1,0,0,1,"2017","057"
"21695","MARTINENGO",229,2564,0,2793,"2017","133"
"21696","MARTINIANA PO",125,33,34,192,"2017","121"
"21697","MARUDO",0,275,0,275,"2017","036"
"21698","MARZABOTTO",19,80,0,99,"2017","036"
"21699","MARZANO",168,316,5,489,"2017","087"
"21700","MARZIO",8,0,1,9,"2017","099"
"21701","MASATE",0,0,183,183,"2017","136"
"21702","MASCIAGO PRIMO",43,0,0,43,"2017","100"
"21703","MASER",4904,52,0,4956,"2017","039"
"21704","MASERA",18,35,1,54,"2017","042"
"21705","MASERA' DI PADOVA",246,141,88,475,"2017","048"
"21706","MASERADA SUL PIAVE",2378,125,0,2503,"2017","040"
"21707","MASI",92,0,0,92,"2017","049"
"21708","MASI TORELLO",5,45,0,50,"2017","012"
"21709","MASIO",783,0,0,783,"2017","091"
"21710","MASLIANICO",0,0,1,1,"2017","144"
"21711","MASON VICENTINO",77,466,0,543,"2017","058"
"21712","MASSA LOMBARDA",16,0,0,16,"2017","013"
"21713","MASSALENGO",0,130,0,130,"2017","037"
"21714","MASSANZAGO",660,211,0,871,"2017","050"
"21715","MASSAZZA",31,0,0,31,"2017","031"
"21716","MASSELLO",8,0,0,8,"2017","145"
"21717","MASSERANO",59,0,0,59,"2017","032"
"21718","MASSINO VISCONTI",10,0,2,12,"2017","093"
"21719","MASSIOLA",1,0,0,1,"2017","043"
"21720","MATHI",73,0,0,73,"2017","146"
"21721","MATTIE",12,0,0,12,"2017","147"
"21722","MAZZANO",40,695,6,741,"2017","107"
"21723","MAZZE'",891,0,0,891,"2017","148"
"21724","MAZZO DI VALTELLINA",21,17,8,46,"2017","040"
"21725","MEANA DI SUSA",1,0,0,1,"2017","149"
"21726","MEDA",1,0,0,1,"2017",NA
"21727","MEDE",30,64,0,94,"2017","088"
"21728","MEDESANO",84,1540,0,1624,"2017","020"
"21729","MEDICINA",128,118,0,246,"2017","037"
"21730","MEDIGLIA",17,1368,82,1467,"2017","139"
"21731","MEDOLAGO",7,0,0,7,"2017","250"
"21732","MEDOLE",572,520,598,1690,"2017","034"
"21733","MEDOLLA",0,571,0,571,"2017","021"
"21734","MEDUNA DI LIVENZA",15,12,0,27,"2017","041"
"21735","MEGLIADINO SAN FIDENZIO",1028,0,0,1028,"2017","051"
"21736","MEGLIADINO SAN VITALE",1817,0,0,1817,"2017","052"
"21737","MEINA",1,0,0,1,"2017","095"
"21738","MEL",63,178,0,241,"2017","034"
"21739","MELARA",178,0,0,178,"2017","032"
"21740","MELAZZO",192,0,0,192,"2017","092"
"21741","MELDOLA",147,31,0,178,"2017","019"
"21742","MELEGNANO",1,146,0,147,"2017","140"
"21743","MELETI",33,420,0,453,"2017","038"
"21744","MELLE",218,0,24,242,"2017","122"
"21745","MELLO",26,37,0,63,"2017","041"
"21746","MELZO",150,268,0,418,"2017","142"
"21747","MENAGGIO",1,0,1,2,"2017","145"
"21748","MENCONICO",10,0,0,10,"2017","089"
"21749","MEOLO",40,171,0,211,"2017","022"
"21750","MERANA",24,0,0,24,"2017","093"
"21751","MERATE",85,286,36,407,"2017","048"
"21752","MERCATO SARACENO",227,17,1,245,"2017","020"
"21753","MERCENASCO",278,0,1,279,"2017","150"
"21754","MERGOZZO",29,0,0,29,"2017","044"
"21755","MERLARA",591,8,0,599,"2017","053"
"21756","MERLINO",4,991,0,995,"2017","039"
"21757","MERONE",37,49,0,86,"2017","147"
"21758","MESE",20,24,6,50,"2017","043"
"21759","MESENZANA",1,37,0,38,"2017","102"
"21760","MESERO",3,62,0,65,"2017","144"
"21761","MESOLA",1298,234,0,1532,"2017","014"
"21762","MESTRINO",34,85,114,233,"2017","054"
"21763","MEUGLIANO",4,0,0,4,"2017","151"
"21764","MEZZANA BIGLI",128,0,0,128,"2017","090"
"21765","MEZZANE DI SOTTO",1,23,0,24,"2017","047"
"21766","MEZZANI",11,312,0,323,"2017","021"
"21767","MEZZANINO",1,0,0,1,"2017","092"
"21768","MEZZENILE",31,0,33,64,"2017","152"
"21769","MEZZOLDO",1,24,0,25,"2017","134"
"21770","MEZZOMERICO",8,0,0,8,"2017","097"
"21771","MIAGLIANO",6,0,0,6,"2017","034"
"21772","MIANE",9,8,0,17,"2017","042"
"21773","MIASINO",0,0,38,38,"2017","098"
"21774","MIAZZINA",1,0,0,1,"2017","045"
"21775","MILANO",367,81,0,448,"2017","146"
"21776","MILZANO",3,973,0,976,"2017","108"
"21777","MINERBE",2116,242,0,2358,"2017","048"
"21778","MINERBIO",65,0,0,65,"2017","038"
"21779","MIRA",1899,528,20,2447,"2017","023"
"21780","MIRABELLO MONFERRATO",69,0,0,69,"2017","094"
"21781","MIRADOLO TERME",22,7,47,76,"2017","093"
"21782","MIRANDOLA",309,1401,0,1710,"2017","022"
"21783","MIRANO",1513,683,2,2198,"2017","024"
"21784","MISANO ADRIATICO",20,0,0,20,"2017","005"
"21785","MISANO DI GERA D'ADDA",5,227,13,245,"2017","135"
"21786","MISINTO",1,0,0,1,"2017",NA
"21787","MISSAGLIA",15,254,274,543,"2017","049"
"21788","MODENA",106,2261,0,2367,"2017","023"
"21789","MODIGLIANA",91,0,1,92,"2017","022"
"21790","MOGLIA",3476,768,1258,5502,"2017","035"
"21791","MOGLIANO VENETO",1052,297,284,1633,"2017","043"
"21792","MOIO DE' CALVI",2,9,0,11,"2017","136"
"21793","MOIOLA",14,4,13,31,"2017","123"
"21794","MOLARE",5,0,0,5,"2017","095"
"21795","MOLINELLA",2214,162,0,2376,"2017","039"
"21796","MOLLIA",1,0,0,1,"2017","078"
"21797","MOLTENO",13,51,0,64,"2017","051"
"21798","MOLVENA",11,4,0,15,"2017","059"
"21799","MOMBALDONE",47,0,2,49,"2017","064"
"21800","MOMBARCARO",111,0,0,111,"2017","124"
"21801","MOMBARUZZO",6,0,0,6,"2017","065"
"21802","MOMBASIGLIO",90,0,0,90,"2017","125"
"21803","MOMBELLO DI TORINO",33,0,0,33,"2017","153"
"21804","MOMBELLO MONFERRATO",32,0,0,32,"2017","097"
"21805","MOMBERCELLI",38,0,0,38,"2017","066"
"21806","MOMO",191,494,0,685,"2017","100"
"21807","MOMPERONE",4,0,0,4,"2017","098"
"21808","MONALE",30,0,0,30,"2017","067"
"21809","MONASTERO BORMIDA",398,0,0,398,"2017","068"
"21810","MONASTERO DI LANZO",16,67,1,84,"2017","155"
"21811","MONASTERO DI VASCO",362,0,47,409,"2017","126"
"21812","MONASTEROLO CASOTTO",51,0,0,51,"2017","127"
"21813","MONASTEROLO DEL CASTELLO",8,13,0,21,"2017","137"
"21814","MONASTEROLO DI SAVIGLIANO",371,306,100,777,"2017","128"
"21815","MONASTIER DI TREVISO",2090,352,0,2442,"2017","044"
"21816","MONCALIERI",213,382,0,595,"2017","156"
"21817","MONCALVO",116,0,0,116,"2017","069"
"21818","MONCENISIO",4,0,0,4,"2017","157"
"21819","MONCESTINO",3,0,0,3,"2017","099"
"21820","MONCHIERO",212,0,0,212,"2017","129"
"21821","MONCHIO DELLE CORTI",37,111,0,148,"2017","022"
"21822","MONCRIVELLO",133,249,0,382,"2017","079"
"21823","MONCUCCO TORINESE",39,0,0,39,"2017","070"
"21824","MONDAINO",9,0,0,9,"2017","006"
"21825","MONDOVI'",5582,22,337,5941,"2017","130"
"21826","MONESIGLIO",69,0,0,69,"2017","131"
"21827","MONFORTE D'ALBA",257,0,0,257,"2017","132"
"21828","MONFUMO",42,231,0,273,"2017","045"
"21829","MONGARDINO",22,0,0,22,"2017","071"
"21830","MONGHIDORO",28,57,0,85,"2017","040"
"21831","MONGIARDINO LIGURE",0,0,24,24,"2017","100"
"21832","MONGRANDO",107,102,10,219,"2017","035"
"21833","MONGUZZO",19,0,0,19,"2017","153"
"21834","MONIGA DEL GARDA",0,4,0,4,"2017","109"
"21835","MONNO",3,35,1,39,"2017","110"
"21836","MONSELICE",468,63,0,531,"2017","055"
"21837","MONTA'",166,0,0,166,"2017","133"
"21838","MONTABONE",90,0,0,90,"2017","072"
"21839","MONTACUTO",32,0,0,32,"2017","102"
"21840","MONTAFIA",38,0,0,38,"2017","073"
"21841","MONTAGNA IN VALTELLINA",10,67,0,77,"2017","044"
"21842","MONTAGNANA",1657,42,0,1699,"2017","056"
"21843","MONTALDO DI MONDOVI'",95,7,18,120,"2017","134"
"21844","MONTALDO SCARAMPI",32,0,0,32,"2017","074"
"21845","MONTALDO TORINESE",574,0,0,574,"2017","158"
"21846","MONTALENGHE",4,0,0,4,"2017","159"
"21847","MONTALTO DORA",32,0,0,32,"2017","160"
"21848","MONTALTO PAVESE",77,0,0,77,"2017","094"
"21849","MONTANARO",140,107,25,272,"2017","161"
"21850","MONTANASO LOMBARDO",57,340,0,397,"2017","040"
"21851","MONTANERA",1708,1069,133,2910,"2017","136"
"21852","MONTANO LUCINO",12,4,13,29,"2017","154"
"21853","MONTE CREMASCO",279,100,25,404,"2017","058"
"21854","MONTE DI MALO",631,160,0,791,"2017","063"
"21855","MONTE ISOLA",15,0,0,15,"2017","111"
"21856","MONTE MARENZO",7,0,1,8,"2017","052"
"21857","MONTE SAN PIETRO",112,172,0,284,"2017","042"
"21858","MONTEBELLO DELLA BATTAGLIA",0,34,0,34,"2017","095"
"21859","MONTEBELLO VICENTINO",78,0,55,133,"2017","060"
"21860","MONTEBELLUNA",4168,579,48,4795,"2017","046"
"21861","MONTECALVO VERSIGGIA",1,0,0,1,"2017",NA
"21862","MONTECASTELLO",2,0,0,2,"2017","105"
"21863","MONTECCHIA DI CROSARA",826,0,0,826,"2017","049"
"21864","MONTECCHIO EMILIA",0,1433,0,1433,"2017","027"
"21865","MONTECCHIO MAGGIORE",181,43,18,242,"2017","061"
"21866","MONTECCHIO PRECALCINO",153,173,81,407,"2017","062"
"21867","MONTECHIARO D'ACQUI",42,0,0,42,"2017","106"
"21868","MONTECHIARO D'ASTI",243,0,0,243,"2017","075"
"21869","MONTECHIARUGOLO",9,3358,0,3367,"2017","023"
"21870","MONTECRESTESE",29,22,0,51,"2017","046"
"21871","MONTECRETO",13,429,0,442,"2017","024"
"21872","MONTEFIORE CONCA",32,3,0,35,"2017","008"
"21873","MONTEFIORINO",7,320,0,327,"2017","025"
"21874","MONTEFORTE D'ALPONE",676,4,0,680,"2017","050"
"21875","MONTEGALDA",35,341,0,376,"2017","064"
"21876","MONTEGALDELLA",46,301,0,347,"2017","065"
"21877","MONTEGIOCO",50,0,0,50,"2017","107"
"21878","MONTEGRINO VALTRAVAGLIA",12,0,0,12,"2017","103"
"21879","MONTEGROSSO D'ASTI",35,0,0,35,"2017","076"
"21880","MONTEGROTTO TERME",15,0,34,49,"2017","057"
"21881","MONTELLO",2,0,0,2,"2017","139"
"21882","MONTELUPO ALBESE",93,0,0,93,"2017","137"
"21883","MONTEMAGNO",116,0,0,116,"2017","077"
"21884","MONTEMALE DI CUNEO",157,0,0,157,"2017","138"
"21885","MONTEMEZZO",1,0,0,1,"2017","155"
"21886","MONTERENZIO",298,200,0,498,"2017","041"
"21887","MONTEROSSO GRANA",3,165,0,168,"2017","139"
"21888","MONTESCANO",1,0,0,1,"2017","097"
"21889","MONTESCUDO-MONTE COLOMBO",210,0,0,210,"2017",NA
"21890","MONTESE",54,1388,0,1442,"2017","026"
"21891","MONTESEGALE",10,0,0,10,"2017","098"
"21892","MONTEU DA PO",81,0,0,81,"2017","162"
"21893","MONTEU ROERO",605,0,0,605,"2017","140"
"21894","MONTEVECCHIA",9,0,1,10,"2017","053"
"21895","MONTEVIALE",43,2,1,46,"2017","066"
"21896","MONTEZEMOLO",42,0,0,42,"2017","141"
"21897","MONTICELLI BRUSATI",12,230,1,243,"2017","112"
"21898","MONTICELLI D'ONGINA",232,548,0,780,"2017","027"
"21899","MONTICELLI PAVESE",1637,389,0,2026,"2017","099"
"21900","MONTICELLO BRIANZA",14,0,297,311,"2017","054"
"21901","MONTICELLO CONTE OTTO",123,828,0,951,"2017","067"
"21902","MONTICELLO D'ALBA",89,0,0,89,"2017","142"
"21903","MONTICHIARI",8954,7348,514,16816,"2017","113"
"21904","MONTIGLIO MONFERRATO",197,0,0,197,"2017","121"
"21905","MONTIRONE",3116,445,0,3561,"2017","114"
"21906","MONTODINE",3,1242,0,1245,"2017","059"
"21907","MONTORFANO",19,0,0,19,"2017","157"
"21908","MONTORSO VICENTINO",623,141,0,764,"2017","068"
"21909","MONTU' BECCARIA",2,0,0,2,"2017","100"
"21910","MONVALLE",7,31,0,38,"2017","104"
"21911","MONZA",30,58,0,88,"2017",NA
"21912","MONZAMBANO",1213,584,729,2526,"2017","036"
"21913","MONZUNO",73,56,0,129,"2017","044"
"21914","MORANO SUL PO",2,0,0,2,"2017","109"
"21915","MORANSENGO",131,0,0,131,"2017","079"
"21916","MORAZZONE",6,77,19,102,"2017","105"
"21917","MORBEGNO",12,81,4,97,"2017","045"
"21918","MORDANO",1,0,0,1,"2017","045"
"21919","MORENGO",80,66,0,146,"2017","140"
"21920","MORETTA",1519,539,230,2288,"2017","143"
"21921","MORFASSO",114,11,0,125,"2017","028"
"21922","MORGANO",2022,12,0,2034,"2017","047"
"21923","MORIAGO DELLA BATTAGLIA",2255,70,0,2325,"2017","048"
"21924","MORIMONDO",31,1488,0,1519,"2017","150"
"21925","MORIONDO TORINESE",280,0,0,280,"2017","163"
"21926","MORNAGO",37,0,0,37,"2017","106"
"21927","MORNESE",29,0,0,29,"2017","111"
"21928","MORNICO AL SERIO",7,420,118,545,"2017","141"
"21929","MORNICO LOSANA",30,0,0,30,"2017","101"
"21930","MOROZZO",2255,584,491,3330,"2017","144"
"21931","MORSASCO",128,0,0,128,"2017","112"
"21932","MORTARA",52,0,0,52,"2017","102"
"21933","MORTERONE",8,11,29,48,"2017","055"
"21934","MOSCAZZANO",1,1254,145,1400,"2017","060"
"21935","MOSSANO",474,58,0,532,"2017","069"
"21936","MOSSO",39,7,9,55,"2017","084"
"21937","MOTTA BALUFFI",2,79,0,81,"2017","061"
"21938","MOTTA DI LIVENZA",27,20,0,47,"2017","049"
"21939","MOTTA VISCONTI",3,0,0,3,"2017","151"
"21940","MOTTALCIATA",76,63,0,139,"2017","037"
"21941","MOTTEGGIANA",715,950,1048,2713,"2017","037"
"21942","MOZZANICA",168,674,0,842,"2017","142"
"21943","MOZZATE",28,112,0,140,"2017","159"
"21944","MOZZECANE",3515,1040,0,4555,"2017","051"
"21945","MUGGIÒ",5,0,0,5,"2017",NA
"21946","MULAZZANO",12,1132,0,1144,"2017","041"
"21947","MURA",18,5,26,49,"2017","115"
"21948","MURAZZANO",295,0,16,311,"2017","145"
"21949","MURELLO",444,1231,220,1895,"2017","146"
"21950","MURISENGO",347,0,0,347,"2017","113"
"21951","MUSCOLINE",99,479,0,578,"2017","116"
"21952","MUSILE DI PIAVE",15,21,4,40,"2017","025"
"21953","MUSSO",3,2,9,14,"2017","160"
"21954","MUSSOLENTE",70,247,98,415,"2017","070"
"21955","MUZZANO",26,0,0,26,"2017","038"
"21956","NANTO",301,233,0,534,"2017","071"
"21957","NARZOLE",1692,166,0,1858,"2017","147"
"21958","NAVE",64,175,0,239,"2017","117"
"21959","NEBBIUNO",57,0,15,72,"2017","103"
"21960","NEGRAR",14,75,0,89,"2017","052"
"21961","NEIVE",24,0,0,24,"2017","148"
"21962","NEMBRO",39,0,0,39,"2017","144"
"21963","NERVESA DELLA BATTAGLIA",576,201,0,777,"2017","050"
"21964","NERVIANO",37,113,0,150,"2017","154"
"21965","NESSO",0,11,0,11,"2017","161"
"21966","NETRO",104,53,0,157,"2017","039"
"21967","NEVIANO DEGLI ARDUINI",31,1928,0,1959,"2017","024"
"21968","NEVIGLIE",2,0,0,2,"2017","149"
"21969","NIARDO",0,149,12,161,"2017","118"
"21970","NIBBIANO",216,0,0,216,"2017","029"
"21971","NIBBIOLA",2,0,0,2,"2017",NA
"21972","NIBIONNO",6,0,0,6,"2017","056"
"21973","NICHELINO",57,0,14,71,"2017","164"
"21974","NICORVO",2,0,0,2,"2017","103"
"21975","NIELLA BELBO",144,0,0,144,"2017","150"
"21976","NIELLA TANARO",412,0,0,412,"2017","151"
"21977","NIZZA MONFERRATO",57,1,0,58,"2017","080"
"21978","NOALE",407,63,9,479,"2017","026"
"21979","NOASCA",12,21,40,73,"2017","165"
"21980","NOCETO",36,3398,14,3448,"2017","025"
"21981","NOGARA",2340,383,29,2752,"2017","053"
"21982","NOGAROLE ROCCA",308,302,0,610,"2017","054"
"21983","NOGAROLE VICENTINO",11,18,2,31,"2017","072"
"21984","NOLE",201,51,77,329,"2017","166"
"21985","NONANTOLA",9,149,0,158,"2017","027"
"21986","NONE",796,858,409,2063,"2017","168"
"21987","NONIO",2,0,0,2,"2017",NA
"21988","NOSATE",11,0,0,11,"2017","155"
"21989","NOVA MILANESE",0,61,0,61,"2017",NA
"21990","NOVAFELTRIA",1008,138,0,1146,"2017","023"
"21991","NOVALESA",47,16,0,63,"2017","169"
"21992","NOVARA",31,289,0,320,"2017","106"
"21993","NOVATE MEZZOLA",0,6,6,12,"2017","046"
"21994","NOVATE MILANESE",1,0,0,1,"2017",NA
"21995","NOVE",19,258,0,277,"2017","073"
"21996","NOVEDRATE",1178,0,0,1178,"2017","163"
"21997","NOVELLARA",2944,2197,0,5141,"2017","028"
"21998","NOVELLO",1050,0,0,1050,"2017","152"
"21999","NOVENTA DI PIAVE",4,17,0,21,"2017","027"
"22000","NOVENTA PADOVANA",13,0,0,13,"2017","058"
"22001","NOVENTA VICENTINA",3999,0,0,3999,"2017","074"
"22002","NOVI DI MODENA",724,701,0,1425,"2017","028"
"22003","NOVI LIGURE",564,0,0,564,"2017","114"
"22004","NOVIGLIO",19,476,0,495,"2017","158"
"22005","NUVOLENTO",11,943,12,966,"2017","119"
"22006","NUVOLERA",1413,343,0,1756,"2017","120"
"22007","OCCHIEPPO INFERIORE",20,133,0,153,"2017","040"
"22008","OCCHIEPPO SUPERIORE",59,41,34,134,"2017","041"
"22009","OCCHIOBELLO",2,164,0,166,"2017","033"
"22010","OCCIMIANO",27,0,0,27,"2017","115"
"22011","ODALENGO GRANDE",76,0,0,76,"2017","116"
"22012","ODERZO",81,279,0,360,"2017","051"
"22013","ODOLO",3,0,0,3,"2017","121"
"22014","OFFANENGO",274,493,0,767,"2017","062"
"22015","OFFLAGA",636,3613,82,4331,"2017","122"
"22016","OGGEBBIO",2,0,0,2,"2017","049"
"22017","OGGIONA CON SANTO STEFANO",4,27,0,31,"2017","107"
"22018","OGGIONO",65,41,4,110,"2017","057"
"22019","OGLIANICO",124,316,0,440,"2017","170"
"22020","OLEGGIO",189,993,0,1182,"2017","108"
"22021","OLEGGIO CASTELLO",1,0,0,1,"2017","109"
"22022","OLGIATE COMASCO",35,36,16,87,"2017","165"
"22023","OLGIATE MOLGORA",14,96,0,110,"2017","058"
"22024","OLGIATE OLONA",2,0,0,2,"2017","108"
"22025","OLGINATE",14,0,0,14,"2017","059"
"22026","OLIVA GESSI",6,0,0,6,"2017",NA
"22027","OLIVETO LARIO",7,0,0,7,"2017","060"
"22028","OLMENETA",17,374,119,510,"2017","063"
"22029","OLMO AL BREMBO",6,3,0,9,"2017","145"
"22030","OLMO GENTILE",30,0,12,42,"2017","081"
"22031","OLTRE IL COLLE",7,85,1,93,"2017","146"
"22032","OLTRESSENDA ALTA",5,34,0,39,"2017","147"
"22033","OLTRONA DI SAN MAMETTE",14,0,0,14,"2017","169"
"22034","OME",14,20,0,34,"2017","123"
"22035","OMEGNA",32,0,0,32,"2017","050"
"22036","ONCINO",0,0,102,102,"2017","154"
"22037","ONETA",2,38,0,40,"2017","148"
"22038","ONO SAN PIETRO",1,14,1,16,"2017","124"
"22039","ONORE",18,23,0,41,"2017","149"
"22040","OPERA",0,172,0,172,"2017","159"
"22041","OPPEANO",5007,858,0,5865,"2017","055"
"22042","ORBASSANO",697,0,164,861,"2017","171"
"22043","ORGIANO",528,20,0,548,"2017","075"
"22044","ORIGGIO",51,0,18,69,"2017","109"
"22045","ORINO",1,0,0,1,"2017","110"
"22046","ORIO CANAVESE",0,78,0,78,"2017","172"
"22047","ORIO LITTA",2,91,0,93,"2017","042"
"22048","ORMEA",127,0,13,140,"2017","155"
"22049","ORMELLE",17,123,0,140,"2017","052"
"22050","ORNAGO",16,58,0,74,"2017",NA
"22051","ORNAVASSO",8,0,5,13,"2017","051"
"22052","ORNICA",3,0,0,3,"2017","151"
"22053","ORSAGO",7,110,0,117,"2017","053"
"22054","ORSARA BORMIDA",13,0,0,13,"2017","119"
"22055","ORSENIGO",6,51,6,63,"2017","170"
"22056","ORTA SAN GIULIO",1,0,0,1,"2017","112"
"22057","ORZINUOVI",218,4985,35,5238,"2017","125"
"22058","ORZIVECCHI",21,700,0,721,"2017","126"
"22059","OSASCO",325,0,92,417,"2017","173"
"22060","OSASIO",220,140,119,479,"2017","174"
"22061","OSIO SOPRA",16,613,0,629,"2017","152"
"22062","OSIO SOTTO",1,0,0,1,"2017","153"
"22063","OSMATE",25,0,0,25,"2017","111"
"22064","OSNAGO",0,79,174,253,"2017","061"
"22065","OSPEDALETTO EUGANEO",103,11,0,114,"2017","059"
"22066","OSPEDALETTO LODIGIANO",0,880,0,880,"2017","043"
"22067","OSPITALETTO",116,173,0,289,"2017","127"
"22068","OSSAGO LODIGIANO",40,1537,10,1587,"2017","044"
"22069","OSSIMO",0,7,11,18,"2017","128"
"22070","OSSONA",24,0,0,24,"2017","164"
"22071","OSTANA",13,0,54,67,"2017","156"
"22072","OSTELLATO",3816,15,0,3831,"2017","017"
"22073","OSTIANO",470,1426,34,1930,"2017","064"
"22074","OSTIGLIA",23,40,49,112,"2017","038"
"22075","OTTIGLIO",91,0,0,91,"2017","120"
"22076","OTTOBIANO",2,39,0,41,"2017","106"
"22077","OTTONE",80,0,0,80,"2017","030"
"22078","OULX",50,0,0,50,"2017","175"
"22079","OVADA",36,0,0,36,"2017","121"
"22080","OVIGLIO",31,16,0,47,"2017","122"
"22081","OZEGNA",154,7,0,161,"2017","176"
"22082","OZZANO DELL'EMILIA",159,267,0,426,"2017","046"
"22083","OZZANO MONFERRATO",60,0,0,60,"2017","123"
"22084","OZZERO",28,324,0,352,"2017","165"
"22085","PADENGHE SUL GARDA",42,0,28,70,"2017","129"
"22086","PADERNO D'ADDA",0,19,0,19,"2017","062"
"22087","PADERNO DEL GRAPPA",31,153,0,184,"2017","054"
"22088","PADERNO DUGNANO",30,0,0,30,"2017","166"
"22089","PADERNO FRANCIACORTA",2,126,159,287,"2017","130"
"22090","PADERNO PONCHIELLI",144,2178,121,2443,"2017","065"
"22091","PADOVA",629,303,56,988,"2017","060"
"22092","PAESANA",679,9,0,688,"2017","157"
"22093","PAESE",1808,695,82,2585,"2017","055"
"22094","PAGNO",56,0,0,56,"2017","158"
"22095","PAGNONA",0,4,5,9,"2017","063"
"22096","PAISCO LOVENO",0,9,5,14,"2017","131"
"22097","PAITONE",40,22,0,62,"2017","132"
"22098","PALADINA",1,5,0,6,"2017","155"
"22099","PALAGANO",70,675,0,745,"2017","029"
"22100","PALANZANO",9,503,0,512,"2017","026"
"22101","PALAZZAGO",86,97,0,183,"2017","156"
"22102","PALAZZO CANAVESE",8,0,0,8,"2017","177"
"22103","PALAZZO PIGNANO",1,823,0,824,"2017","066"
"22104","PALAZZOLO SULL'OGLIO",1317,1449,127,2893,"2017","133"
"22105","PALAZZOLO VERCELLESE",11,0,0,11,"2017","090"
"22106","PALESTRO",2,0,15,17,"2017","107"
"22107","PALLANZENO",38,0,0,38,"2017","052"
"22108","PALOSCO",457,424,0,881,"2017","157"
"22109","PALU'",173,0,0,173,"2017","056"
"22110","PAMPARATO",42,0,0,42,"2017","159"
"22111","PANCALIERI",111,149,0,260,"2017","178"
"22112","PANDINO",86,3529,7,3622,"2017","067"
"22113","PANTIGLIATE",1,0,0,1,"2017","167"
"22114","PAPOZZE",163,88,0,251,"2017","034"
"22115","PARABIAGO",63,48,0,111,"2017","168"
"22116","PARATICO",8,53,0,61,"2017","134"
"22117","PARETO",58,2,0,60,"2017","125"
"22118","PARMA",320,10097,0,10417,"2017","027"
"22119","PARODI LIGURE",44,0,39,83,"2017","126"
"22120","PAROLDO",31,0,0,31,"2017","160"
"22121","PARONA",7,0,0,7,"2017","109"
"22122","PARRE",24,74,0,98,"2017","158"
"22123","PARUZZARO",53,37,0,90,"2017","114"
"22124","PARZANICA",3,0,8,11,"2017","159"
"22125","PASPARDO",0,4,2,6,"2017","135"
"22126","PASSERANO MARMORITO",115,0,0,115,"2017","082"
"22127","PASSIRANO",166,165,68,399,"2017","136"
"22128","PASTRENGO",0,153,0,153,"2017","057"
"22129","PASTURO",58,135,40,233,"2017","065"
"22130","PAULLO",0,530,0,530,"2017","169"
"22131","PAVAROLO",64,0,0,64,"2017","180"
"22132","PAVIA",83,247,17,347,"2017","110"
"22133","PAVONE CANAVESE",139,0,3,142,"2017","181"
"22134","PAVONE DEL MELLA",1888,347,18,2253,"2017","137"
"22135","PAVULLO NEL FRIGNANO",176,3919,0,4095,"2017","030"
"22136","PECETTO DI VALENZA",10,0,0,10,"2017","128"
"22137","PECETTO TORINESE",97,0,0,97,"2017","183"
"22138","PECORARA",314,140,0,454,"2017","031"
"22139","PEDAVENA",4,124,0,128,"2017","036"
"22140","PEDEMONTE",0,6,10,16,"2017","076"
"22141","PEDEROBBA",59,145,7,211,"2017","056"
"22142","PEDRENGO",11,179,28,218,"2017","160"
"22143","PEGLIO",2,0,21,23,"2017","178"
"22144","PEGOGNAGA",2051,1948,2070,6069,"2017","039"
"22145","PEIA",17,7,0,24,"2017","161"
"22146","PELLEGRINO PARMENSE",13,766,0,779,"2017","028"
"22147","PENANGO",75,0,0,75,"2017","083"
"22148","PENNABILLI",324,15,0,339,"2017","024"
"22149","PERLEDO",2,0,0,2,"2017","067"
"22150","PERLETTO",204,0,0,204,"2017","161"
"22151","PERLO",39,0,0,39,"2017","162"
"22152","PERNUMIA",360,143,0,503,"2017","061"
"22153","PERO",10,0,0,10,"2017",NA
"22154","PEROSA ARGENTINA",47,8,0,55,"2017","184"
"22155","PEROSA CANAVESE",61,198,31,290,"2017","185"
"22156","PERRERO",27,0,0,27,"2017","186"
"22157","PERSICO DOSIMO",1,1965,0,1966,"2017","068"
"22158","PERTENGO",1,0,0,1,"2017","091"
"22159","PERTICA ALTA",8,1,4,13,"2017","139"
"22160","PERTICA BASSA",25,42,13,80,"2017","140"
"22161","PERTUSIO",53,0,0,53,"2017","187"
"22162","PESCANTINA",42,70,9,121,"2017","058"
"22163","PESCAROLO ED UNITI",60,876,6,942,"2017","069"
"22164","PESCHIERA BORROMEO",33,450,0,483,"2017","171"
"22165","PESSANO CON BORNAGO",55,123,0,178,"2017","172"
"22166","PESSINA CREMONESE",501,2944,0,3445,"2017","070"
"22167","PESSINETTO",2,0,0,2,"2017","188"
"22168","PETTENASCO",9,0,0,9,"2017","116"
"22169","PETTINENGO",7,0,19,26,"2017","042"
"22170","PETTORAZZA GRIMANI",242,234,0,476,"2017","035"
"22171","PEVERAGNO",1143,528,53,1724,"2017","163"
"22172","PEZZAZE",13,29,0,42,"2017","141"
"22173","PEZZOLO VALLE UZZONE",55,0,0,55,"2017","164"
"22174","PIACENZA",407,1318,0,1725,"2017","032"
"22175","PIACENZA D'ADIGE",822,0,0,822,"2017","062"
"22176","PIADENA",0,418,3,421,"2017","071"
"22177","PIAN CAMUNO",0,297,0,297,"2017","142"
"22178","PIANCOGNO",7,38,42,87,"2017","206"
"22179","PIANELLO DEL LARIO",10,0,9,19,"2017","183"
"22180","PIANELLO VAL TIDONE",387,128,0,515,"2017","033"
"22181","PIANENGO",5,159,0,164,"2017","072"
"22182","PIANEZZA",284,415,168,867,"2017","189"
"22183","PIANEZZE",209,130,0,339,"2017","077"
"22184","PIANFEI",815,63,63,941,"2017","165"
"22185","PIANICO",8,75,0,83,"2017","162"
"22186","PIANIGA",40,41,9,90,"2017","028"
"22187","PIANORO",173,210,5,388,"2017","047"
"22188","PIANTEDO",13,322,3,338,"2017","048"
"22189","PIARIO",0,0,7,7,"2017","163"
"22190","PIASCO",255,244,32,531,"2017","166"
"22191","PIATEDA",29,50,0,79,"2017","049"
"22192","PIATTO",28,0,0,28,"2017","043"
"22193","PIAZZA BREMBANA",3,0,0,3,"2017","164"
"22194","PIAZZATORRE",0,2,0,2,"2017","165"
"22195","PIAZZOLA SUL BRENTA",1605,1063,0,2668,"2017","063"
"22196","PIAZZOLO",13,0,1,14,"2017","166"
"22197","PIEA",67,0,0,67,"2017","084"
"22198","PIEDIMULERA",0,28,0,28,"2017","053"
"22199","PIERANICA",53,0,0,53,"2017","073"
"22200","PIETRA DE' GIORGI",26,0,0,26,"2017","111"
"22201","PIEVE D'OLMI",2,1438,465,1905,"2017","074"
"22202","PIEVE DEL CAIRO",7,80,0,87,"2017","113"
"22203","PIEVE DI CADORE",0,16,0,16,"2017","039"
"22204","PIEVE DI CORIANO",0,0,56,56,"2017","040"
"22205","PIEVE DI SOLIGO",35,122,2,159,"2017","057"
"22206","PIEVE EMANUELE",0,376,106,482,"2017","173"
"22207","PIEVE FISSIRAGA",46,1405,7,1458,"2017","045"
"22208","PIEVE PORTO MORONE",145,0,0,145,"2017","114"
"22209","PIEVE SAN GIACOMO",0,1928,0,1928,"2017","075"
"22210","PIEVE VERGONTE",36,9,58,103,"2017","054"
"22211","PIEVEPELAGO",35,74,0,109,"2017","031"
"22212","PINAROLO PO",1916,0,0,1916,"2017","115"
"22213","PINASCA",83,36,0,119,"2017","190"
"22214","PINCARA",476,0,0,476,"2017","036"
"22215","PINEROLO",2044,169,170,2383,"2017","191"
"22216","PINO TORINESE",529,0,46,575,"2017","192"
"22217","PIOBESI TORINESE",446,956,285,1687,"2017","193"
"22218","PIODE",0,6,13,19,"2017","097"
"22219","PIOLTELLO",1,0,0,1,"2017","175"
"22220","PIOMBINO DESE",5537,449,0,5986,"2017","064"
"22221","PIOSSASCO",445,742,166,1353,"2017","194"
"22222","PIOVA' MASSAIA",272,0,0,272,"2017","086"
"22223","PIOVE DI SACCO",3366,137,0,3503,"2017","065"
"22224","PIOVENE ROCCHETTE",1982,108,0,2090,"2017","078"
"22225","PIOVERA",190,158,0,348,"2017","130"
"22226","PIOZZANO",154,8,0,162,"2017","034"
"22227","PIOZZO",386,0,0,386,"2017","169"
"22228","PISCINA",1660,0,0,1660,"2017","195"
"22229","PISOGNE",9,214,19,242,"2017","143"
"22230","PIUBEGA",3844,879,66,4789,"2017","041"
"22231","PIURO",10,183,5,198,"2017","050"
"22232","PIVERONE",51,97,0,148,"2017","196"
"22233","PIZZIGHETTONE",56,3171,0,3227,"2017","076"
"22234","PLESIO",1,0,0,1,"2017","185"
"22235","POCAPAGLIA",232,53,0,285,"2017","170"
"22236","PODENZANO",69,594,0,663,"2017","035"
"22237","POGGIO RENATICO",9,444,0,453,"2017","018"
"22238","POGGIO RUSCO",342,403,480,1225,"2017","042"
"22239","POGGIO TORRIANA",515,0,0,515,"2017",NA
"22240","POGGIRIDENTI",10,2,0,12,"2017","051"
"22241","POGNANO",11,371,44,426,"2017","167"
"22242","POIRINO",3638,641,0,4279,"2017","197"
"22243","POJANA MAGGIORE",1456,31,0,1487,"2017","079"
"22244","POLAVENO",60,6,0,66,"2017","144"
"22245","POLESINE ZIBELLO",14,1532,0,1546,"2017",NA
"22246","POLINAGO",99,776,0,875,"2017","032"
"22247","POLLONE",179,55,0,234,"2017","046"
"22248","POLONGHERA",151,133,39,323,"2017","171"
"22249","POLPENAZZE DEL GARDA",17,96,0,113,"2017","145"
"22250","POLVERARA",7,63,0,70,"2017","066"
"22251","POMARETTO",45,0,18,63,"2017","198"
"22252","POMARO MONFERRATO",8,0,250,258,"2017","131"
"22253","POMBIA",0,94,0,94,"2017","121"
"22254","POMPIANO",20,1390,0,1410,"2017","146"
"22255","POMPONESCO",4,444,12,460,"2017","043"
"22256","PONCARALE",427,748,116,1291,"2017","147"
"22257","PONDERANO",36,46,40,122,"2017","047"
"22258","PONNA",1,0,8,9,"2017","187"
"22259","PONSO",49,0,0,49,"2017","067"
"22260","PONT-CANAVESE",47,28,0,75,"2017","199"
"22261","PONTE DELL'OLIO",119,128,0,247,"2017","036"
"22262","PONTE DI LEGNO",2,9,0,11,"2017","148"
"22263","PONTE DI PIAVE",63,72,2,137,"2017","058"
"22264","PONTE IN VALTELLINA",10,10,0,20,"2017","052"
"22265","PONTE LAMBRO",2,16,0,18,"2017","188"
"22266","PONTE NELLE ALPI",38,155,0,193,"2017","040"
"22267","PONTE NIZZA",92,31,0,123,"2017","117"
"22268","PONTE NOSSA",0,34,0,34,"2017","168"
"22269","PONTE SAN NICOLO'",268,34,12,314,"2017","069"
"22270","PONTE SAN PIETRO",4,0,0,4,"2017","170"
"22271","PONTECCHIO POLESINE",1177,0,0,1177,"2017","038"
"22272","PONTECHIANALE",192,0,0,192,"2017","172"
"22273","PONTECURONE",2,0,0,2,"2017","132"
"22274","PONTELONGO",290,0,0,290,"2017","068"
"22275","PONTENURE",52,126,0,178,"2017","037"
"22276","PONTERANICA",4,0,0,4,"2017","169"
"22277","PONTESTURA",7,0,0,7,"2017","133"
"22278","PONTEVICO",275,3496,472,4243,"2017","149"
"22279","PONTI",73,0,10,83,"2017","134"
"22280","PONTI SUL MINCIO",203,436,31,670,"2017","044"
"22281","PONTIDA",24,0,0,24,"2017","171"
"22282","PONTIROLO NUOVO",296,516,0,812,"2017","172"
"22283","PONTOGLIO",781,1242,132,2155,"2017","150"
"22284","PONZANO MONFERRATO",39,0,0,39,"2017","135"
"22285","PONZANO VENETO",365,211,0,576,"2017","059"
"22286","PONZONE",29,5,0,34,"2017","136"
"22287","PORLEZZA",5,30,15,50,"2017","189"
"22288","PORTACOMARO",43,0,0,43,"2017","087"
"22289","PORTE",11,0,0,11,"2017","200"
"22290","PORTICO E SAN BENEDETTO",81,0,0,81,"2017","031"
"22291","PORTO CERESIO",2,0,0,2,"2017","113"
"22292","PORTO MANTOVANO",955,437,2664,4056,"2017","045"
"22293","PORTO TOLLE",13,0,0,13,"2017","039"
"22294","PORTO VALTRAVAGLIA",16,0,9,25,"2017","114"
"22295","PORTO VIRO",4659,0,0,4659,"2017","052"
"22296","PORTOBUFFOLE'",3,0,3,6,"2017","060"
"22297","PORTOGRUARO",1354,90,0,1444,"2017","029"
"22298","PORTOMAGGIORE",647,424,0,1071,"2017","019"
"22299","PORTULA",7,0,0,7,"2017","048"
"22300","POSINA",0,8,0,8,"2017","080"
"22301","POSSAGNO",11,15,0,26,"2017","061"
"22302","POSTALESIO",3,0,0,3,"2017","053"
"22303","POSTUA",1,4,0,5,"2017","102"
"22304","POVE DEL GRAPPA",10,2,0,12,"2017","081"
"22305","POVEGLIANO",131,203,16,350,"2017","062"
"22306","POVEGLIANO VERONESE",2456,498,1,2955,"2017","060"
"22307","POVIGLIO",9,1337,0,1346,"2017","029"
"22308","POZZAGLIO ED UNITI",18,2374,285,2677,"2017","077"
"22309","POZZO D'ADDA",258,0,0,258,"2017","177"
"22310","POZZOL GROPPO",43,0,0,43,"2017","137"
"22311","POZZOLENGO",692,353,63,1108,"2017","151"
"22312","POZZOLEONE",105,2298,0,2403,"2017","082"
"22313","POZZOLO FORMIGARO",19,0,278,297,"2017","138"
"22314","POZZONOVO",2552,0,0,2552,"2017","070"
"22315","POZZUOLO MARTESANA",27,213,0,240,"2017","178"
"22316","PRADALUNGA",20,0,0,20,"2017","173"
"22317","PRADLEVES",2,8,0,10,"2017","173"
"22318","PRAGELATO",11,0,5,16,"2017","201"
"22319","PRALBOINO",1108,900,12,2020,"2017","152"
"22320","PRALI",45,0,0,45,"2017","202"
"22321","PRALORMO",1192,309,0,1501,"2017","203"
"22322","PRALUNGO",93,0,24,117,"2017","049"
"22323","PRAMAGGIORE",10,10,0,20,"2017","030"
"22324","PRAMOLLO",3,0,0,3,"2017","204"
"22325","PRAROSTINO",35,7,0,42,"2017","205"
"22326","PRASCO",18,0,0,18,"2017","139"
"22327","PRASCORSANO",3,0,0,3,"2017","206"
"22328","PRATA CAMPORTACCIO",21,143,39,203,"2017","054"
"22329","PRATIGLIONE",2,0,0,2,"2017","207"
"22330","PRATO SESIA",0,6,0,6,"2017","122"
"22331","PRAY",63,0,0,63,"2017","050"
"22332","PRAZZO",210,17,17,244,"2017","174"
"22333","PREDAPPIO",148,32,0,180,"2017","032"
"22334","PREDORE",11,0,0,11,"2017","174"
"22335","PREDOSA",140,89,0,229,"2017","140"
"22336","PREGANZIOL",15,178,0,193,"2017","063"
"22337","PREGNANA MILANESE",2,133,0,135,"2017","179"
"22338","PREMANA",6,17,3,26,"2017","069"
"22339","PREMENO",4,0,0,4,"2017","055"
"22340","PREMIA",25,196,0,221,"2017","056"
"22341","PREMILCUORE",365,0,48,413,"2017","033"
"22342","PREMOLO",7,17,0,24,"2017","175"
"22343","PREMOSELLO-CHIOVENDA",16,0,0,16,"2017","057"
"22344","PRESEGLIE",48,0,0,48,"2017","153"
"22345","PRESEZZO",3,0,0,3,"2017",NA
"22346","PRESSANA",4448,46,0,4494,"2017","061"
"22347","PREVALLE",125,542,57,724,"2017","155"
"22348","PRIERO",32,0,0,32,"2017","175"
"22349","PRIGNANO SULLA SECCHIA",118,1238,47,1403,"2017","033"
"22350","PRIMALUNA",32,59,4,95,"2017","070"
"22351","PRIOCCA",595,0,0,595,"2017","176"
"22352","PRIOLA",53,0,0,53,"2017","177"
"22353","PROSERPIO",3,4,0,7,"2017","192"
"22354","PROVAGLIO D'ISEO",125,195,3,323,"2017","156"
"22355","PROVAGLIO VAL SABBIA",28,0,3,31,"2017","157"
"22356","PRUNETTO",61,0,0,61,"2017","178"
"22357","PUEGNAGO SUL GARDA",15,146,0,161,"2017","158"
"22358","PUMENENGO",1630,636,216,2482,"2017","177"
"22359","PUSIANO",0,0,1,1,"2017","193"
"22360","QUAGLIUZZO",11,0,0,11,"2017","208"
"22361","QUARGNENTO",1262,0,0,1262,"2017","141"
"22362","QUARNA SOPRA",4,0,0,4,"2017","058"
"22363","QUARNA SOTTO",7,0,0,7,"2017","059"
"22364","QUARONA",10,7,0,17,"2017","107"
"22365","QUARTO D'ALTINO",11,83,0,94,"2017","031"
"22366","QUASSOLO",44,34,0,78,"2017","209"
"22367","QUATTORDIO",574,0,0,574,"2017","142"
"22368","QUATTRO CASTELLA",17,1496,0,1513,"2017","030"
"22369","QUERO VAS",31,70,3,104,"2017",NA
"22370","QUINCINETTO",29,38,0,67,"2017","210"
"22371","QUINGENTOLE",608,77,86,771,"2017","046"
"22372","QUINTANO",0,326,1,327,"2017","078"
"22373","QUINTO DI TREVISO",145,171,27,343,"2017","064"
"22374","QUINTO VERCELLESE",56,0,0,56,"2017","108"
"22375","QUINTO VICENTINO",30,721,68,819,"2017","083"
"22376","QUINZANO D'OGLIO",339,2963,0,3302,"2017","159"
"22377","QUISTELLO",187,1615,735,2537,"2017","047"
"22378","RACCONIGI",2300,1968,143,4411,"2017","179"
"22379","RANCIO VALCUVIA",5,0,0,5,"2017","115"
"22380","RANCO",0,0,21,21,"2017","116"
"22381","RANICA",26,16,0,42,"2017","178"
"22382","RANZANICO",17,31,0,48,"2017","179"
"22383","RAVENNA",1196,1298,0,2494,"2017","014"
"22384","RE",18,0,0,18,"2017","060"
"22385","REANO",22,0,0,22,"2017","211"
"22386","RECOARO TERME",60,101,0,161,"2017","084"
"22387","REDAVALLE",52,0,0,52,"2017","120"
"22388","REDONDESCO",77,451,626,1154,"2017","048"
"22389","REFRANCORE",35,0,0,35,"2017","089"
"22390","REFRONTOLO",10,27,2,39,"2017","065"
"22391","REGGIO NELL'EMILIA",80,11042,9,11131,"2017","033"
"22392","REGGIOLO",1047,2300,0,3347,"2017","032"
"22393","REMEDELLO",7001,2253,156,9410,"2017","160"
"22394","RENATE",3,0,1,4,"2017",NA
"22395","RESANA",2763,53,14,2830,"2017","066"
"22396","RETORBIDO",1,0,0,1,"2017",NA
"22397","REVELLO",7258,1764,277,9299,"2017","180"
"22398","REVERE",1,211,20,232,"2017","049"
"22399","REVIGLIASCO D'ASTI",329,0,0,329,"2017","090"
"22400","REVINE LAGO",16,21,0,37,"2017","067"
"22401","REZZATO",495,561,0,1056,"2017","161"
"22402","RHO",24,448,0,472,"2017","182"
"22403","RIBORDONE",6,0,0,6,"2017","212"
"22404","RICCIONE",3,0,0,3,"2017","013"
"22405","RICENGO",34,2288,57,2379,"2017","079"
"22406","RIESE PIO X",8868,440,35,9343,"2017","068"
"22407","RIFREDDO",859,17,30,906,"2017","181"
"22408","RIMA SAN GIUSEPPE",5,0,0,5,"2017","111"
"22409","RIMASCO",0,10,0,10,"2017","112"
"22410","RIMELLA",2,9,16,27,"2017","113"
"22411","RIMINI",101,110,0,211,"2017","014"
"22412","RIO SALICETO",899,368,0,1267,"2017","034"
"22413","RIOLO TERME",337,0,0,337,"2017","015"
"22414","RIOLUNATO",66,14,0,80,"2017","035"
"22415","RIPALTA ARPINA",0,303,67,370,"2017","080"
"22416","RIPALTA CREMASCA",3,174,0,177,"2017","081"
"22417","RIPALTA GUERINA",7,463,46,516,"2017","082"
"22418","RIVA DI SOLTO",7,0,0,7,"2017","180"
"22419","RIVA PRESSO CHIERI",3321,113,0,3434,"2017","215"
"22420","RIVA VALDOBBIA",2,15,2,19,"2017","114"
"22421","RIVALBA",73,0,0,73,"2017","213"
"22422","RIVALTA DI TORINO",135,4,0,139,"2017","214"
"22423","RIVAMONTE AGORDINO",0,23,0,23,"2017","043"
"22424","RIVANAZZANO",140,0,0,140,"2017","122"
"22425","RIVARA",111,118,0,229,"2017","216"
"22426","RIVAROLO CANAVESE",964,578,443,1985,"2017","217"
"22427","RIVAROLO DEL RE ED UNITI",3545,349,0,3894,"2017","083"
"22428","RIVAROLO MANTOVANO",69,1087,269,1425,"2017","050"
"22429","RIVAROSSA",5,148,0,153,"2017","218"
"22430","RIVERGARO",82,1063,0,1145,"2017","038"
"22431","RIVOLI",1600,0,127,1727,"2017","219"
"22432","RIVOLI VERONESE",133,8,0,141,"2017","062"
"22433","RIVOLTA D'ADDA",2092,2767,18,4877,"2017","084"
"22434","RO",7,49,0,56,"2017","020"
"22435","ROANA",31,463,4,498,"2017","085"
"22436","ROASCIO",11,0,0,11,"2017","184"
"22437","ROASIO",7,0,0,7,"2017","116"
"22438","ROATTO",95,0,0,95,"2017","091"
"22439","ROBASSOMERO",53,65,0,118,"2017","220"
"22440","ROBBIO",4,199,0,203,"2017","123"
"22441","ROBECCHETTO CON INDUNO",137,188,1,326,"2017","183"
"22442","ROBECCO D'OGLIO",20,2756,0,2776,"2017","085"
"22443","ROBECCO SUL NAVIGLIO",80,675,0,755,"2017","184"
"22444","ROBELLA",409,0,0,409,"2017","092"
"22445","ROBILANTE",221,0,0,221,"2017","185"
"22446","ROBURENT",21,0,0,21,"2017","186"
"22447","ROCCA CANAVESE",100,0,0,100,"2017","221"
"22448","ROCCA CIGLIE'",19,0,0,19,"2017","188"
"22449","ROCCA D'ARAZZO",391,0,0,391,"2017","093"
"22450","ROCCA DE' BALDI",2730,922,704,4356,"2017","189"
"22451","ROCCA GRIMALDA",9,0,0,9,"2017","147"
"22452","ROCCA PIETORE",0,5,0,5,"2017","044"
"22453","ROCCA SAN CASCIANO",126,0,0,126,"2017","036"
"22454","ROCCA SUSELLA",6,0,0,6,"2017",NA
"22455","ROCCABIANCA",4,856,0,860,"2017","030"
"22456","ROCCABRUNA",287,53,2,342,"2017","187"
"22457","ROCCAFORTE LIGURE",55,0,0,55,"2017","146"
"22458","ROCCAFORTE MONDOVI'",764,0,13,777,"2017","190"
"22459","ROCCAFRANCA",1441,1471,29,2941,"2017","162"
"22460","ROCCASPARVERA",412,0,0,412,"2017","191"
"22461","ROCCAVERANO",143,0,0,143,"2017","094"
"22462","ROCCAVIONE",37,0,0,37,"2017","192"
"22463","ROCCHETTA LIGURE",39,0,0,39,"2017","148"
"22464","ROCCHETTA PALAFEA",8,0,0,8,"2017","095"
"22465","ROCCHETTA TANARO",380,0,0,380,"2017","096"
"22466","RODANO",36,152,0,188,"2017","185"
"22467","RODDI",81,13,0,94,"2017","194"
"22468","RODDINO",82,0,0,82,"2017","195"
"22469","RODELLO",106,0,0,106,"2017","196"
"22470","RODENGO-SAIANO",6,257,131,394,"2017","163"
"22471","RODERO",3,6,0,9,"2017",NA
"22472","RODIGO",732,752,1711,3195,"2017","051"
"22473","ROE' VOLCIANO",6,0,0,6,"2017","164"
"22474","ROGENO",16,234,56,306,"2017","072"
"22475","ROGNANO",18,0,0,18,"2017","127"
"22476","ROGNO",8,74,0,82,"2017","182"
"22477","ROGOLO",4,18,0,22,"2017","056"
"22478","ROLETTO",222,90,0,312,"2017","222"
"22479","ROLO",0,266,0,266,"2017","035"
"22480","ROMAGNANO SESIA",42,0,0,42,"2017","130"
"22481","ROMAGNESE",115,0,0,115,"2017","128"
"22482","ROMANENGO",0,1560,590,2150,"2017","086"
"22483","ROMANO CANAVESE",35,0,0,35,"2017","223"
"22484","ROMANO D'EZZELINO",274,449,7,730,"2017","086"
"22485","ROMANO DI LOMBARDIA",180,3430,0,3610,"2017","183"
"22486","ROMENTINO",19,0,0,19,"2017","131"
"22487","RONAGO",6,0,42,48,"2017","199"
"22488","RONCA'",4,0,2,6,"2017","063"
"22489","RONCADE",2245,123,0,2368,"2017","069"
"22490","RONCADELLE",193,705,0,898,"2017","165"
"22491","RONCARO",1,0,0,1,"2017","129"
"22492","RONCELLO",1,0,0,1,"2017",NA
"22493","RONCO ALL'ADIGE",6872,0,0,6872,"2017","064"
"22494","RONCO BIELLESE",8,54,0,62,"2017","053"
"22495","RONCO BRIANTINO",0,148,0,148,"2017",NA
"22496","RONCO CANAVESE",97,0,0,97,"2017","224"
"22497","RONCOFERRARO",3267,455,562,4284,"2017","052"
"22498","RONCOFREDDO",20,47,0,67,"2017","037"
"22499","RONCOLA",30,28,0,58,"2017","185"
"22500","RONDISSONE",3,0,0,3,"2017","225"
"22501","RONSECCO",4,0,0,4,"2017",NA
"22502","ROPPOLO",3,0,0,3,"2017","054"
"22503","RORA'",12,0,0,12,"2017","226"
"22504","ROSA'",82,884,15,981,"2017","087"
"22505","ROSASCO",1,0,0,1,"2017","130"
"22506","ROSATE",3003,521,0,3524,"2017","188"
"22507","ROSIGNANO MONFERRATO",93,0,0,93,"2017","149"
"22508","ROSOLINA",7,0,0,7,"2017","040"
"22509","ROSSA",6,8,0,14,"2017","121"
"22510","ROSSANA",79,117,0,196,"2017","197"
"22511","ROSSANO VENETO",359,188,7,554,"2017","088"
"22512","ROSTA",22,0,101,123,"2017","228"
"22513","ROTA D'IMAGNA",15,44,0,59,"2017","186"
"22514","ROTTOFRENO",492,787,0,1279,"2017","039"
"22515","ROTZO",102,0,0,102,"2017","089"
"22516","ROURE",8,0,0,8,"2017","227"
"22517","ROVASENDA",18,0,0,18,"2017","122"
"22518","ROVATO",1564,2144,156,3864,"2017","166"
"22519","ROVELLASCA",12,64,0,76,"2017","201"
"22520","ROVELLO PORRO",3,0,0,3,"2017",NA
"22521","ROVERBELLA",13150,537,366,14053,"2017","053"
"22522","ROVERCHIARA",4077,4,103,4184,"2017","065"
"22523","ROVERE' VERONESE",338,1203,5,1546,"2017","067"
"22524","ROVEREDO DI GUA'",1495,84,11,1590,"2017","066"
"22525","ROVESCALA",10,0,0,10,"2017","131"
"22526","ROVETTA",42,149,0,191,"2017","187"
"22527","ROVIGO",1549,0,0,1549,"2017","041"
"22528","ROVOLON",246,12,55,313,"2017","071"
"22529","ROZZANO",0,1,0,1,"2017","189"
"22530","RUBANO",22,37,42,101,"2017","072"
"22531","RUBIANA",4,0,0,4,"2017","229"
"22532","RUBIERA",0,451,0,451,"2017","036"
"22533","RUDIANO",488,1214,80,1782,"2017","167"
"22534","RUEGLIO",106,74,0,180,"2017","230"
"22535","RUFFIA",242,247,55,544,"2017","198"
"22536","RUINO",105,0,0,105,"2017","132"
"22537","RUSSI",17,0,0,17,"2017","016"
"22538","SABBIO CHIESE",32,28,11,71,"2017","168"
"22539","SABBIONETA",6,82,29,117,"2017","054"
"22540","SACCOLONGO",76,479,55,610,"2017","073"
"22541","SAGLIANO MICCA",44,0,0,44,"2017","056"
"22542","SALA BAGANZA",8,131,0,139,"2017","031"
"22543","SALA BIELLESE",3,0,0,3,"2017","057"
"22544","SALA BOLOGNESE",347,0,0,347,"2017","050"
"22545","SALA COMACINA",0,0,1,1,"2017","203"
"22546","SALA MONFERRATO",89,0,0,89,"2017","150"
"22547","SALARA",2,0,0,2,"2017","042"
"22548","SALASSA",15,0,0,15,"2017","231"
"22549","SALBERTRAND",37,0,0,37,"2017","232"
"22550","SALCEDO",883,62,0,945,"2017","090"
"22551","SALE",14,0,0,14,"2017","151"
"22552","SALE DELLE LANGHE",98,0,0,98,"2017","199"
"22553","SALE MARASINO",45,31,1,77,"2017","169"
"22554","SALE SAN GIOVANNI",75,0,0,75,"2017","200"
"22555","SALERANO SUL LAMBRO",2,322,0,324,"2017","046"
"22556","SALETTO",2,34,0,36,"2017","074"
"22557","SALGAREDA",2103,223,0,2326,"2017","070"
"22558","SALICETO",69,0,0,69,"2017","201"
"22559","SALIZZOLE",2499,489,24,3012,"2017","068"
"22560","SALMOUR",245,0,0,245,"2017","202"
"22561","SALO'",2,33,0,35,"2017","170"
"22562","SALSOMAGGIORE TERME",24,1095,14,1133,"2017","032"
"22563","SALTRIO",53,0,0,53,"2017","117"
"22564","SALUDECIO",72,65,0,137,"2017","015"
"22565","SALUGGIA",517,160,0,677,"2017","128"
"22566","SALUSSOLA",479,90,0,569,"2017","058"
"22567","SALUZZO",3187,3374,522,7083,"2017","203"
"22568","SALVIROLA",681,90,0,771,"2017","087"
"22569","SALZANO",267,29,2,298,"2017","032"
"22570","SAMARATE",29,0,0,29,"2017","118"
"22571","SAMBUCO",32,0,0,32,"2017","204"
"22572","SAMOLACO",193,701,33,927,"2017","057"
"22573","SAMONE",16,0,0,16,"2017","235"
"22574","SAMPEYRE",283,50,0,333,"2017","205"
"22575","SAN BARTOLOMEO VAL CAVARGNA",2,0,5,7,"2017","204"
"22576","SAN BASSANO",8,1640,0,1648,"2017","088"
"22577","SAN BELLINO",1897,0,0,1897,"2017","043"
"22578","SAN BENEDETTO BELBO",28,0,77,105,"2017","206"
"22579","SAN BENEDETTO PO",906,1639,1090,3635,"2017","055"
"22580","SAN BENEDETTO VAL DI SAMBRO",273,96,0,369,"2017","051"
"22581","SAN BENIGNO CANAVESE",204,0,44,248,"2017","236"
"22582","SAN BERNARDINO VERBANO",2,0,0,2,"2017","061"
"22583","SAN BIAGIO DI CALLALTA",325,58,0,383,"2017","071"
"22584","SAN BONIFACIO",2032,0,0,2032,"2017","069"
"22585","SAN CARLO CANAVESE",233,170,71,474,"2017","237"
"22586","SAN CESARIO SUL PANARO",21,765,0,786,"2017","036"
"22587","SAN CIPRIANO PO",15,344,0,359,"2017","133"
"22588","SAN CLEMENTE",10,0,0,10,"2017","016"
"22589","SAN COLOMBANO AL LAMBRO",23,253,0,276,"2017","191"
"22590","SAN COLOMBANO BELMONTE",4,8,0,12,"2017","238"
"22591","SAN CRISTOFORO",14,0,0,14,"2017","152"
"22592","SAN DAMIANO D'ASTI",4308,0,0,4308,"2017","097"
"22593","SAN DAMIANO MACRA",39,0,0,39,"2017","207"
"22594","SAN DANIELE PO",19,1757,0,1776,"2017","089"
"22595","SAN DIDERO",0,11,0,11,"2017","239"
"22596","SAN DONA' DI PIAVE",295,363,14,672,"2017","033"
"22597","SAN DONATO MILANESE",4,0,0,4,"2017","192"
"22598","SAN FEDELE INTELVI",55,2,6,63,"2017","205"
"22599","SAN FELICE DEL BENACO",2,0,0,2,"2017","171"
"22600","SAN FELICE SUL PANARO",0,951,0,951,"2017","037"
"22601","SAN FERMO DELLA BATTAGLIA",16,0,29,45,"2017","206"
"22602","SAN FIOR",19,28,12,59,"2017","072"
"22603","SAN FIORANO",0,176,0,176,"2017","047"
"22604","SAN FRANCESCO AL CAMPO",558,324,0,882,"2017","240"
"22605","SAN GENESIO ED UNITI",7,537,0,544,"2017","135"
"22606","SAN GERMANO CHISONE",73,19,0,92,"2017","242"
"22607","SAN GERMANO VERCELLESE",2,0,0,2,"2017","131"
"22608","SAN GERVASIO BRESCIANO",1,239,0,240,"2017","172"
"22609","SAN GIACOMO DELLE SEGNATE",393,177,184,754,"2017","056"
"22610","SAN GIACOMO VERCELLESE",1846,0,0,1846,"2017","035"
"22611","SAN GILLIO",148,46,0,194,"2017","243"
"22612","SAN GIORGIO CANAVESE",166,25,0,191,"2017","244"
"22613","SAN GIORGIO DELLE PERTICHE",274,87,1,362,"2017","075"
"22614","SAN GIORGIO DI LOMELLINA",5,0,0,5,"2017","136"
"22615","SAN GIORGIO DI MANTOVA",260,78,8,346,"2017","057"
"22616","SAN GIORGIO DI PIANO",24,0,0,24,"2017","052"
"22617","SAN GIORGIO IN BOSCO",288,885,0,1173,"2017","076"
"22618","SAN GIORGIO MONFERRATO",12,0,0,12,"2017","153"
"22619","SAN GIORGIO PIACENTINO",199,735,0,934,"2017","040"
"22620","SAN GIORGIO SCARAMPI",76,0,0,76,"2017","098"
"22621","SAN GIORIO DI SUSA",0,9,0,9,"2017","245"
"22622","SAN GIOVANNI BIANCO",39,23,0,62,"2017","188"
"22623","SAN GIOVANNI DEL DOSSO",0,312,65,377,"2017","058"
"22624","SAN GIOVANNI ILARIONE",850,3,0,853,"2017","070"
"22625","SAN GIOVANNI IN CROCE",0,467,2,469,"2017","090"
"22626","SAN GIOVANNI IN MARIGNANO",5,0,0,5,"2017","017"
"22627","SAN GIOVANNI IN PERSICETO",28,780,0,808,"2017","053"
"22628","SAN GIOVANNI LUPATOTO",717,100,0,817,"2017","071"
"22629","SAN GIULIANO MILANESE",4,682,0,686,"2017","195"
"22630","SAN GIUSTO CANAVESE",123,16,0,139,"2017","246"
"22631","SAN GREGORIO NELLE ALPI",14,76,0,90,"2017","045"
"22632","SAN LAZZARO DI SAVENA",5,0,0,5,"2017","054"
"22633","SAN LEO",301,350,0,651,"2017","025"
"22634","SAN MARTINO ALFIERI",13,0,0,13,"2017","099"
"22635","SAN MARTINO BUON ALBERGO",376,1117,0,1493,"2017","073"
"22636","SAN MARTINO CANAVESE",42,0,0,42,"2017","247"
"22637","SAN MARTINO DALL'ARGINE",570,810,43,1423,"2017","059"
"22638","SAN MARTINO DEL LAGO",8,0,0,8,"2017","091"
"22639","SAN MARTINO DI LUPARI",2389,347,8,2744,"2017","077"
"22640","SAN MARTINO IN RIO",1,853,0,854,"2017","037"
"22641","SAN MARTINO IN STRADA",0,970,0,970,"2017","048"
"22642","SAN MARTINO SICCOMARIO",0,2,0,2,"2017","137"
"22643","SAN MARZANO OLIVETO",36,0,0,36,"2017","100"
"22644","SAN MAURIZIO CANAVESE",150,254,271,675,"2017","248"
"22645","SAN MAURIZIO D'OPAGLIO",14,0,0,14,"2017","133"
"22646","SAN MAURO DI SALINE",48,255,52,355,"2017","074"
"22647","SAN MAURO TORINESE",14,0,0,14,"2017","249"
"22648","SAN MICHELE AL TAGLIAMENTO",2335,54,0,2389,"2017","034"
"22649","SAN MICHELE MONDOVI'",175,0,0,175,"2017","210"
"22650","SAN NAZARIO",23,0,0,23,"2017","093"
"22651","SAN NAZZARO SESIA",126,0,0,126,"2017","134"
"22652","SAN NAZZARO VAL CAVARGNA",6,0,6,12,"2017","207"
"22653","SAN NICOLO' DI COMELICO",0,17,0,17,"2017","046"
"22654","SAN PAOLO",425,2557,33,3015,"2017","138"
"22655","SAN PAOLO D'ARGON",17,32,8,57,"2017","189"
"22656","SAN PAOLO SOLBRITO",23,0,0,23,"2017","101"
"22657","SAN PELLEGRINO TERME",51,40,0,91,"2017","190"
"22658","SAN PIETRO DI CADORE",2,62,0,64,"2017","047"
"22659","SAN PIETRO DI FELETTO",21,18,0,39,"2017","073"
"22660","SAN PIETRO DI MORUBIO",3,0,0,3,"2017","075"
"22661","SAN PIETRO IN CASALE",21,141,0,162,"2017","055"
"22662","SAN PIETRO IN CERRO",105,916,0,1021,"2017","041"
"22663","SAN PIETRO IN GU",805,3487,0,4292,"2017","078"
"22664","SAN PIETRO MOSEZZO",6,0,0,6,"2017","135"
"22665","SAN PIETRO MUSSOLINO",11,0,0,11,"2017","094"
"22666","SAN PIETRO VAL LEMINA",8,0,0,8,"2017","250"
"22667","SAN PIETRO VIMINARIO",378,29,0,407,"2017","079"
"22668","SAN POLO D'ENZA",0,676,0,676,"2017","038"
"22669","SAN POLO DI PIAVE",686,73,0,759,"2017","074"
"22670","SAN PONSO",0,51,0,51,"2017","251"
"22671","SAN POSSIDONIO",216,434,0,650,"2017","038"
"22672","SAN PROSPERO",3,345,0,348,"2017","039"
"22673","SAN RAFFAELE CIMENA",29,0,0,29,"2017","252"
"22674","SAN ROCCO AL PORTO",212,753,0,965,"2017","049"
"22675","SAN SALVATORE MONFERRATO",137,0,0,137,"2017","154"
"22676","SAN SEBASTIANO CURONE",28,0,0,28,"2017","155"
"22677","SAN SEBASTIANO DA PO",339,0,0,339,"2017","253"
"22678","SAN SECONDO DI PINEROLO",552,54,68,674,"2017","254"
"22679","SAN SECONDO PARMENSE",6,1477,0,1483,"2017","033"
"22680","SAN SIRO",0,0,2,2,"2017","248"
"22681","SAN VENDEMIANO",65,123,21,209,"2017","076"
"22682","SAN VITO DI CADORE",5,0,0,5,"2017","051"
"22683","SAN VITO DI LEGUZZANO",425,117,0,542,"2017","096"
"22684","SAN VITTORE OLONA",24,31,0,55,"2017","201"
"22685","SAN ZENO DI MONTAGNA",235,171,60,466,"2017","079"
"22686","SAN ZENO NAVIGLIO",1,470,0,471,"2017","173"
"22687","SAN ZENONE AL LAMBRO",0,766,0,766,"2017","202"
"22688","SAN ZENONE DEGLI EZZELINI",2693,460,1,3154,"2017","077"
"22689","SANDIGLIANO",56,86,0,142,"2017","059"
"22690","SANDRIGO",1435,1770,0,3205,"2017","091"
"22691","SANFRE'",626,0,66,692,"2017","208"
"22692","SANFRONT",2027,127,72,2226,"2017","209"
"22693","SANGANO",84,0,31,115,"2017","241"
"22694","SANGIANO",4,41,0,45,"2017","141"
"22695","SANGUINETTO",10,192,0,202,"2017","072"
"22696","SANNAZZARO DE' BURGONDI",31,56,0,87,"2017","138"
"22697","SANT'AGATA BOLOGNESE",5,516,0,521,"2017","056"
"22698","SANT'AGATA FELTRIA",154,38,0,192,"2017","026"
"22699","SANT'AGATA FOSSILI",62,0,0,62,"2017","156"
"22700","SANT'AGATA SUL SANTERNO",22,0,0,22,"2017","017"
"22701","SANT'ALBANO STURA",4603,736,14,5353,"2017","211"
"22702","SANT'AMBROGIO DI TORINO",48,23,31,102,"2017","255"
"22703","SANT'AMBROGIO DI VALPOLICELLA",2,51,0,53,"2017","077"
"22704","SANT'ANGELO DI PIOVE DI SACCO",312,55,0,367,"2017","082"
"22705","SANT'ANGELO LODIGIANO",29,317,0,346,"2017","050"
"22706","SANT'ANGELO LOMELLINA",0,392,0,392,"2017","144"
"22707","SANT'ANNA D'ALFAEDO",185,1342,110,1637,"2017","078"
"22708","SANT'ANTONINO DI SUSA",8,44,33,85,"2017","256"
"22709","SANT'ELENA",40,0,0,40,"2017","083"
"22710","SANT'ILARIO D'ENZA",2,817,0,819,"2017","039"
"22711","SANT'OMOBONO TERME",86,41,0,127,"2017","192"
"22712","SANT'URBANO",715,0,1,716,"2017","084"
"22713","SANTA BRIGIDA",6,23,0,29,"2017","191"
"22714","SANTA CRISTINA E BISSONE",7,123,0,130,"2017","139"
"22715","SANTA GIULETTA",6,0,0,6,"2017","140"
"22716","SANTA GIUSTINA",1875,115,0,1990,"2017","048"
"22717","SANTA GIUSTINA IN COLLE",1312,364,4,1680,"2017","080"
"22718","SANTA LUCIA DI PIAVE",35,84,9,128,"2017","075"
"22719","SANTA MARGHERITA D'ADIGE",583,0,12,595,"2017","081"
"22720","SANTA MARGHERITA DI STAFFORA",17,0,39,56,"2017","142"
"22721","SANTA MARIA DELLA VERSA",2,0,0,2,"2017","143"
"22722","SANTA MARIA DI SALA",80,178,12,270,"2017","035"
"22723","SANTA MARIA HOE'",8,0,0,8,"2017","074"
"22724","SANTA MARIA MAGGIORE",28,0,10,38,"2017","062"
"22725","SANTA SOFIA",247,0,4,251,"2017","043"
"22726","SANTA VITTORIA D'ALBA",40,0,0,40,"2017","212"
"22727","SANTARCANGELO DI ROMAGNA",26,0,0,26,"2017","018"
"22728","SANTENA",486,0,0,486,"2017","257"
"22729","SANTHIA'",236,38,0,274,"2017","133"
"22730","SANTO STEFANO BELBO",7,0,0,7,"2017","213"
"22731","SANTO STEFANO DI CADORE",5,16,0,21,"2017","050"
"22732","SANTO STEFANO LODIGIANO",39,360,0,399,"2017","051"
"22733","SANTO STEFANO ROERO",86,0,0,86,"2017","214"
"22734","SANTO STEFANO TICINO",0,0,35,35,"2017","200"
"22735","SANTO STINO DI LIVENZA",3471,106,0,3577,"2017","036"
"22736","SANTORSO",438,176,0,614,"2017","095"
"22737","SAONARA",250,4,2,256,"2017","085"
"22738","SAPPADA",10,63,0,73,"2017","052"
"22739","SARCEDO",1655,335,0,1990,"2017","097"
"22740","SARDIGLIANO",2,0,0,2,"2017","157"
"22741","SAREGO",343,20,0,363,"2017","098"
"22742","SAREZZANO",17,0,0,17,"2017",NA
"22743","SAREZZO",6,26,0,32,"2017","174"
"22744","SARMATO",2,242,0,244,"2017","042"
"22745","SARMEDE",51,75,2,128,"2017","078"
"22746","SARNICO",9,0,0,9,"2017","193"
"22747","SARONNO",0,0,8,8,"2017","119"
"22748","SARSINA",153,0,9,162,"2017","044"
"22749","SARTIRANA LOMELLINA",2,0,0,2,"2017","146"
"22750","SASSO MARCONI",47,0,0,47,"2017","057"
"22751","SASSUOLO",41,310,0,351,"2017","040"
"22752","SAUZE D'OULX",66,0,0,66,"2017","259"
"22753","SAUZE DI CESANA",69,0,0,69,"2017","258"
"22754","SAVIGLIANO",10020,5217,152,15389,"2017","215"
"22755","SAVIGNANO SUL PANARO",59,72,0,131,"2017","041"
"22756","SAVIGNANO SUL RUBICONE",53,0,0,53,"2017","045"
"22757","SAVIORE DELL'ADAMELLO",4,33,7,44,"2017","175"
"22758","SCAGNELLO",164,0,0,164,"2017","216"
"22759","SCALDASOLE",2,19,0,21,"2017","147"
"22760","SCALENGHE",1829,2081,405,4315,"2017","260"
"22761","SCANDIANO",35,1253,0,1288,"2017","040"
"22762","SCANDOLARA RAVARA",0,678,0,678,"2017","092"
"22763","SCANDOLARA RIPA D'OGLIO",21,759,68,848,"2017","093"
"22764","SCANZOROSCIATE",34,0,0,34,"2017","194"
"22765","SCARMAGNO",4,0,0,4,"2017","261"
"22766","SCARNAFIGI",1330,1632,33,2995,"2017","217"
"22767","SCHIAVON",1913,1697,0,3610,"2017","099"
"22768","SCHIGNANO",3,1,17,21,"2017","211"
"22769","SCHILPARIO",0,74,0,74,"2017","195"
"22770","SCHIO",338,276,0,614,"2017","100"
"22771","SCIOLZE",136,0,0,136,"2017","262"
"22772","SCOPA",3,0,0,3,"2017","134"
"22773","SCOPELLO",23,8,0,31,"2017","135"
"22774","SCORZE'",4558,30,0,4588,"2017","037"
"22775","SECUGNAGO",14,1491,0,1505,"2017","052"
"22776","SEDICO",1705,137,2,1844,"2017","053"
"22777","SEDRIANO",13,707,0,720,"2017","204"
"22778","SEDRINA",22,18,0,40,"2017","196"
"22779","SEGRATE",13,0,0,13,"2017","205"
"22780","SEGUSINO",8,60,0,68,"2017","079"
"22781","SELLERO",3,20,6,29,"2017","176"
"22782","SELVA DI CADORE",0,10,0,10,"2017","054"
"22783","SELVA DI PROGNO",51,616,56,723,"2017","080"
"22784","SELVAZZANO DENTRO",33,0,57,90,"2017","086"
"22785","SELVINO",4,0,0,4,"2017","197"
"22786","SEMIANA",2,0,0,2,"2017","148"
"22787","SENAGO",1,0,0,1,"2017",NA
"22788","SENIGA",2092,1860,0,3952,"2017","177"
"22789","SENNA COMASCO",2,84,13,99,"2017","212"
"22790","SENNA LODIGIANA",12,903,0,915,"2017","053"
"22791","SEREGNO",3,0,0,3,"2017",NA
"22792","SEREN DEL GRAPPA",88,32,192,312,"2017","055"
"22793","SERGNANO",2,1692,0,1694,"2017","094"
"22794","SERIATE",83,92,0,175,"2017","198"
"22795","SERINA",7,106,0,113,"2017","199"
"22796","SERLE",22,14,12,48,"2017","178"
"22797","SERMIDE E FELONICA",2,202,134,338,"2017",NA
"22798","SERNAGLIA DELLA BATTAGLIA",932,16,6,954,"2017","080"
"22799","SERNIO",3,0,0,3,"2017","059"
"22800","SEROLE",67,0,4,71,"2017","104"
"22801","SERRALUNGA D'ALBA",21,0,0,21,"2017","218"
"22802","SERRALUNGA DI CREA",23,0,0,23,"2017","159"
"22803","SERRAMAZZONI",29,1612,0,1641,"2017","042"
"22804","SERRAVALLE A PO",76,0,170,246,"2017","062"
"22805","SERRAVALLE LANGHE",89,0,0,89,"2017","219"
"22806","SERRAVALLE SCRIVIA",5,0,0,5,"2017","160"
"22807","SERRAVALLE SESIA",4,0,0,4,"2017","137"
"22808","SESTO CALENDE",32,0,0,32,"2017","120"
"22809","SESTO ED UNITI",6,1511,413,1930,"2017","095"
"22810","SESTOLA",97,326,24,447,"2017","043"
"22811","SETTALA",35,190,71,296,"2017","210"
"22812","SETTIME",154,0,0,154,"2017","106"
"22813","SETTIMO MILANESE",5,300,7,312,"2017","211"
"22814","SETTIMO ROTTARO",25,34,0,59,"2017","264"
"22815","SETTIMO TORINESE",389,302,144,835,"2017","265"
"22816","SETTIMO VITTONE",174,174,5,353,"2017","266"
"22817","SEZZADIO",38,0,0,38,"2017","161"
"22818","SILEA",5,99,0,104,"2017","081"
"22819","SILLAVENGO",19,121,0,140,"2017","138"
"22820","SILVANO D'ORBA",8,0,0,8,"2017","162"
"22821","SILVANO PIETRA",1,0,0,1,"2017",NA
"22822","SINIO",8,6,0,14,"2017","220"
"22823","SIRONE",11,77,2,90,"2017","075"
"22824","SIRTORI",5,0,0,5,"2017","076"
"22825","SISSA TRECASALI",12,899,0,911,"2017",NA
"22826","SIZIANO",62,75,0,137,"2017","150"
"22827","SIZZANO",226,15,143,384,"2017","139"
"22828","SOAVE",52,0,0,52,"2017","081"
"22829","SOGLIANO AL RUBICONE",207,53,0,260,"2017","046"
"22830","SOIANO DEL LAGO",4,0,0,4,"2017","180"
"22831","SOLAGNA",0,17,0,17,"2017","101"
"22832","SOLARO",0,28,0,28,"2017","213"
"22833","SOLAROLO RAINERIO",13,284,0,297,"2017","096"
"22834","SOLBIATE",2,145,2,149,"2017","215"
"22835","SOLERO",270,0,0,270,"2017","163"
"22836","SOLESINO",4,0,0,4,"2017","087"
"22837","SOLFERINO",683,222,220,1125,"2017","063"
"22838","SOLIERA",30,969,0,999,"2017","044"
"22839","SOLIGNANO",25,244,0,269,"2017","035"
"22840","SOLONGHELLO",109,0,0,109,"2017","164"
"22841","SOLTO COLLINA",18,7,3,28,"2017","200"
"22842","SOMAGLIA",3,1159,0,1162,"2017","054"
"22843","SOMANO",41,0,0,41,"2017","221"
"22844","SOMMA LOMBARDO",34,10,0,44,"2017","123"
"22845","SOMMACAMPAGNA",1818,391,72,2281,"2017","082"
"22846","SOMMARIVA DEL BOSCO",1384,529,155,2068,"2017","222"
"22847","SOMMARIVA PERNO",22,0,0,22,"2017","223"
"22848","SOMMO",26,0,0,26,"2017","151"
"22849","SONA",2572,627,0,3199,"2017","083"
"22850","SONCINO",558,4673,591,5822,"2017","097"
"22851","SONDALO",29,65,5,99,"2017","060"
"22852","SONDRIO",6,33,0,39,"2017","061"
"22853","SONGAVAZZO",1,0,0,1,"2017","201"
"22854","SONICO",2,82,16,100,"2017","181"
"22855","SORAGNA",15,1575,0,1590,"2017","036"
"22856","SORBOLO",0,1400,0,1400,"2017","037"
"22857","SORDEVOLO",78,33,11,122,"2017","063"
"22858","SORDIO",0,242,0,242,"2017","055"
"22859","SORESINA",42,1293,207,1542,"2017","098"
"22860","SORGA'",1840,17,0,1857,"2017","084"
"22861","SORICO",5,15,76,96,"2017","216"
"22862","SORISO",3,0,0,3,"2017","140"
"22863","SORISOLE",52,67,0,119,"2017","202"
"22864","SORMANO",22,0,2,24,"2017","217"
"22865","SOSPIRO",68,405,0,473,"2017","099"
"22866","SOSPIROLO",3,102,0,105,"2017","056"
"22867","SOSSANO",46,358,0,404,"2017","102"
"22868","SOSTEGNO",2,14,0,16,"2017","064"
"22869","SOTTO IL MONTE GIOVANNI XXIII",56,85,0,141,"2017","203"
"22870","SOVERE",59,45,10,114,"2017","204"
"22871","SOVERZENE",1,0,0,1,"2017","057"
"22872","SOVICO",2,0,0,2,"2017",NA
"22873","SOVIZZO",500,113,0,613,"2017","103"
"22874","SOVRAMONTE",13,75,0,88,"2017","058"
"22875","SOZZAGO",1,0,0,1,"2017","141"
"22876","SPARONE",47,61,0,108,"2017","267"
"22877","SPESSA",5,0,0,5,"2017","152"
"22878","SPIGNO MONFERRATO",134,13,61,208,"2017","165"
"22879","SPILAMBERTO",2063,1393,0,3456,"2017","045"
"22880","SPINADESCO",0,0,2,2,"2017","100"
"22881","SPINEA",44,143,0,187,"2017","038"
"22882","SPINEDA",2,727,0,729,"2017","101"
"22883","SPINETO SCRIVIA",151,0,0,151,"2017","166"
"22884","SPINO D'ADDA",720,2141,0,2861,"2017","102"
"22885","SPINONE AL LAGO",6,1,0,7,"2017","205"
"22886","SPIRANO",18,1013,0,1031,"2017","206"
"22887","SPRESIANO",84,228,4,316,"2017","082"
"22888","STAGNO LOMBARDO",5,6712,51,6768,"2017","103"
"22889","STANGHELLA",372,0,0,372,"2017","088"
"22890","STAZZANO",12,0,0,12,"2017","167"
"22891","STAZZONA",13,7,9,29,"2017","218"
"22892","STEZZANO",180,342,177,699,"2017","207"
"22893","STIENTA",37,0,2,39,"2017","045"
"22894","STRADELLA",7,32,0,39,"2017","153"
"22895","STRAMBINO",172,0,0,172,"2017","269"
"22896","STRESA",56,0,0,56,"2017","064"
"22897","STREVI",31,0,0,31,"2017","168"
"22898","STROPPO",13,0,0,13,"2017","224"
"22899","SUARDI",3,0,0,3,"2017","154"
"22900","SUEGLIO",3,0,0,3,"2017","077"
"22901","SUELLO",8,0,8,16,"2017","078"
"22902","SUISIO",1,82,0,83,"2017","209"
"22903","SULBIATE",31,0,0,31,"2017",NA
"22904","SULZANO",33,229,0,262,"2017","182"
"22905","SUMIRAGO",54,96,0,150,"2017","124"
"22906","SUNO",49,435,0,484,"2017","143"
"22907","SUSA",118,34,0,152,"2017","270"
"22908","SUSEGANA",829,62,0,891,"2017","083"
"22909","SUSTINENTE",493,511,238,1242,"2017","064"
"22910","SUZZARA",1366,1237,1819,4422,"2017","065"
"22911","TACENO",8,0,12,20,"2017","079"
"22912","TAGLIO DI PO",7197,0,0,7197,"2017","046"
"22913","TAGLIOLO MONFERRATO",49,0,0,49,"2017","169"
"22914","TAIBON AGORDINO",3,20,0,23,"2017","059"
"22915","TAINO",31,114,0,145,"2017","125"
"22916","TALAMELLO",1,0,0,1,"2017","027"
"22917","TALAMONA",12,151,0,163,"2017","063"
"22918","TALEGGIO",52,26,0,78,"2017","210"
"22919","TAMBRE",19,157,0,176,"2017","060"
"22920","TARANTASCA",2293,625,0,2918,"2017","225"
"22921","TARTANO",20,14,0,34,"2017","064"
"22922","TARZO",13,24,0,37,"2017","084"
"22923","TAVAGNASCO",95,12,0,107,"2017","271"
"22924","TAVAZZANO CON VILLAVESCO",0,1121,44,1165,"2017","056"
"22925","TAVERNOLA BERGAMASCA",2,9,1,12,"2017","211"
"22926","TAVERNOLE SUL MELLA",18,56,7,81,"2017","183"
"22927","TAVIGLIANO",39,0,0,39,"2017","066"
"22928","TEGLIO",37,201,51,289,"2017","065"
"22929","TELGATE",1708,181,0,1889,"2017","212"
"22930","TEMU'",8,3,7,18,"2017","184"
"22931","TEOLO",35,35,7,77,"2017","089"
"22932","TERDOBBIATE",11,123,0,134,"2017","144"
"22933","TERENZO",56,659,0,715,"2017","038"
"22934","TERNO D'ISOLA",25,21,0,46,"2017","213"
"22935","TERRANOVA DEI PASSERINI",37,316,230,583,"2017","057"
"22936","TERRASSA PADOVANA",1832,0,0,1832,"2017","090"
"22937","TERRAZZO",0,19,0,19,"2017","085"
"22938","TERRUGGIA",32,0,0,32,"2017","171"
"22939","TERZO",32,0,0,32,"2017","172"
"22940","TEZZE SUL BRENTA",74,293,0,367,"2017","104"
"22941","THIENE",475,413,0,888,"2017","105"
"22942","TICENGO",0,436,0,436,"2017","104"
"22943","TIGLIOLE",985,0,0,985,"2017","108"
"22944","TIGNALE",9,0,4,13,"2017","185"
"22945","TIRANO",9,0,17,26,"2017","066"
"22946","TIZZANO VAL PARMA",4,644,0,648,"2017","039"
"22947","TOANO",26,1804,0,1830,"2017","041"
"22948","TOCENO",38,18,7,63,"2017","065"
"22949","TOLLEGNO",3,17,0,20,"2017","068"
"22950","TOMBOLO",755,49,0,804,"2017","091"
"22951","TONCO",739,0,0,739,"2017","109"
"22952","TONENGO",97,0,0,97,"2017","110"
"22953","TONEZZA DEL CIMONE",4,0,0,4,"2017","106"
"22954","TORBOLE CASAGLIA",9,828,25,862,"2017","186"
"22955","TORINO",171,0,12,183,"2017","272"
"22956","TORLINO VIMERCATI",0,296,109,405,"2017","105"
"22957","TORNACO",0,102,0,102,"2017",NA
"22958","TORNATA",3,148,0,151,"2017","106"
"22959","TORNOLO",84,4,0,88,"2017","040"
"22960","TORRAZZA COSTE",4,0,0,4,"2017","155"
"22961","TORRAZZA PIEMONTE",219,0,0,219,"2017","273"
"22962","TORRAZZO",6,0,0,6,"2017","069"
"22963","TORRE BERETTI E CASTELLARO",25,371,0,396,"2017","156"
"22964","TORRE BOLDONE",5,0,0,5,"2017","214"
"22965","TORRE BORMIDA",8,0,1,9,"2017","226"
"22966","TORRE D'ISOLA",0,539,0,539,"2017","159"
"22967","TORRE DE' BUSI",9,0,0,9,"2017","080"
"22968","TORRE DE' NEGRI",18,79,204,301,"2017","158"
"22969","TORRE DE' PICENARDI",6,1217,63,1286,"2017","107"
"22970","TORRE DE' ROVERI",17,0,0,17,"2017","216"
"22971","TORRE DI MOSTO",29,571,0,600,"2017","041"
"22972","TORRE DI SANTA MARIA",31,7,0,38,"2017","067"
"22973","TORRE MONDOVI'",1,0,0,1,"2017","227"
"22974","TORRE PALLAVICINA",504,400,0,904,"2017","217"
"22975","TORRE PELLICE",73,0,0,73,"2017","275"
"22976","TORRE SAN GIORGIO",58,15,17,90,"2017","228"
"22977","TORREBELVICINO",754,17,0,771,"2017","107"
"22978","TORREGLIA",2,0,0,2,"2017","092"
"22979","TORRESINA",2,0,0,2,"2017","229"
"22980","TORREVECCHIA PIA",52,11,20,83,"2017","160"
"22981","TORRI DI QUARTESOLO",33,162,6,201,"2017","108"
"22982","TORRICELLA VERZATE",1,0,0,1,"2017",NA
"22983","TORRILE",0,2621,0,2621,"2017","041"
"22984","TORTONA",3155,247,0,3402,"2017","174"
"22985","TOSCOLANO-MADERNO",13,0,4,17,"2017","187"
"22986","TOVO DI SANT'AGATA",2,46,3,51,"2017","068"
"22987","TRADATE",40,0,9,49,"2017","127"
"22988","TRANA",56,0,42,98,"2017","276"
"22989","TRAONA",51,86,97,234,"2017","069"
"22990","TRAREGO VIGGIONA",3,0,0,3,"2017","066"
"22991","TRASQUERA",18,0,7,25,"2017","067"
"22992","TRAUSELLA",15,29,0,44,"2017","277"
"22993","TRAVAGLIATO",890,484,0,1374,"2017","188"
"22994","TRAVEDONA-MONATE",14,0,7,21,"2017","128"
"22995","TRAVERSELLA",43,27,2,72,"2017","278"
"22996","TRAVERSETOLO",43,1051,0,1094,"2017","042"
"22997","TRAVES",6,0,0,6,"2017","279"
"22998","TRAVO",60,30,0,90,"2017","043"
"22999","TREBASELEGHE",7434,108,0,7542,"2017","093"
"23000","TRECATE",0,201,0,201,"2017","149"
"23001","TRECENTA",25,139,0,164,"2017","047"
"23002","TREDOZIO",120,0,0,120,"2017","049"
"23003","TREGNAGO",552,135,0,687,"2017","087"
"23004","TREMENICO",0,0,1,1,"2017","081"
"23005","TREMEZZINA",15,11,57,83,"2017",NA
"23006","TREMOSINE",19,444,51,514,"2017","189"
"23007","TRENZANO",857,1363,141,2361,"2017","190"
"23008","TRESCORE BALNEARIO",19,59,13,91,"2017","218"
"23009","TRESCORE CREMASCO",67,354,189,610,"2017","109"
"23010","TRESIVIO",10,36,0,46,"2017","070"
"23011","TREVENZUOLO",63,844,0,907,"2017","088"
"23012","TREVIGLIO",728,1453,16,2197,"2017","219"
"23013","TREVIGNANO",2114,153,5,2272,"2017","085"
"23014","TREVILLE",3,0,0,3,"2017","175"
"23015","TREVIOLO",110,132,0,242,"2017","220"
"23016","TREVISO",666,148,2,816,"2017","086"
"23017","TREVISO BRESCIANO",14,41,0,55,"2017","191"
"23018","TREZZO SULL'ADDA",0,419,0,419,"2017","221"
"23019","TREZZO TINELLA",24,0,0,24,"2017","231"
"23020","TREZZONE",1,0,3,4,"2017","226"
"23021","TRIBANO",5,0,0,5,"2017","094"
"23022","TRIBIANO",0,38,0,38,"2017","222"
"23023","TRICHIANA",67,476,0,543,"2017","061"
"23024","TRIGOLO",0,1562,2,1564,"2017","110"
"23025","TRINITA'",2538,390,389,3317,"2017","232"
"23026","TRINO",3,165,0,168,"2017","148"
"23027","TRISOBBIO",84,0,0,84,"2017","176"
"23028","TRISSINO",51,296,0,347,"2017","110"
"23029","TRIUGGIO",39,297,1,337,"2017",NA
"23030","TRIVERO",9,25,0,34,"2017","070"
"23031","TROFARELLO",589,62,0,651,"2017","280"
"23032","TROMELLO",18,103,264,385,"2017","164"
"23033","TRONTANO",6,10,7,23,"2017","068"
"23034","TRONZANO LAGO MAGGIORE",2,0,0,2,"2017","129"
"23035","TRONZANO VERCELLESE",159,0,0,159,"2017","150"
"23036","TROVO",12,44,0,56,"2017","165"
"23037","TRUCCAZZANO",74,1916,0,1990,"2017","224"
"23038","TURANO LODIGIANO",68,2074,192,2334,"2017","058"
"23039","TURATE",1,0,0,1,"2017","227"
"23040","TURBIGO",1,47,0,48,"2017","226"
"23041","UBIALE CLANEZZO",2,0,0,2,"2017","221"
"23042","UBOLDO",7,0,0,7,"2017","130"
"23043","UGGIATE-TREVANO",14,57,9,80,"2017","228"
"23044","URAGO D'OGLIO",405,1269,0,1674,"2017","192"
"23045","URBANA",1217,0,0,1217,"2017","095"
"23046","URGNANO",116,221,0,337,"2017","222"
"23047","USMATE VELATE",6,43,11,60,"2017",NA
"23048","USSEAUX",61,68,0,129,"2017","281"
"23049","USSEGLIO",26,0,0,26,"2017","282"
"23050","VAIANO CREMASCO",12,457,170,639,"2017","111"
"23051","VAIE",0,4,56,60,"2017","283"
"23052","VAILATE",5,747,8,760,"2017","112"
"23053","VAL BREMBILLA",100,53,7,160,"2017",NA
"23054","VAL DELLA TORRE",349,0,0,349,"2017","284"
"23055","VAL DI ZOLDO",24,3,0,27,"2017",NA
"23056","VAL LIONA",48,114,0,162,"2017",NA
"23057","VAL MASINO",1,11,0,12,"2017","074"
"23058","VAL REZZO",7,0,5,12,"2017","233"
"23059","VALBONDIONE",1,10,0,11,"2017","223"
"23060","VALBREMBO",58,0,0,58,"2017","224"
"23061","VALBRONA",5,0,2,7,"2017","229"
"23062","VALDAGNO",41,196,0,237,"2017","111"
"23063","VALDASTICO",1058,23,0,1081,"2017","112"
"23064","VALDENGO",12,51,0,63,"2017","071"
"23065","VALDIDENTRO",36,131,39,206,"2017","071"
"23066","VALDISOTTO",33,102,9,144,"2017","072"
"23067","VALDOBBIADENE",102,372,2,476,"2017","087"
"23068","VALDUGGIA",6,0,0,6,"2017","152"
"23069","VALEGGIO",52,0,0,52,"2017","167"
"23070","VALEGGIO SUL MINCIO",2190,2245,20,4455,"2017","089"
"23071","VALENZA",61,0,0,61,"2017","177"
"23072","VALERA FRATTA",201,220,0,421,"2017","059"
"23073","VALFENERA",1087,105,187,1379,"2017","112"
"23074","VALFURVA",16,88,15,119,"2017","073"
"23075","VALGANNA",22,0,0,22,"2017","131"
"23076","VALGOGLIO",13,56,0,69,"2017","225"
"23077","VALGRANA",103,0,0,103,"2017","234"
"23078","VALGREGHENTINO",2,0,0,2,"2017","082"
"23079","VALLADA AGORDINA",5,4,0,9,"2017","062"
"23080","VALLE DI CADORE",2,0,0,2,"2017","063"
"23081","VALLE LOMELLINA",17,756,0,773,"2017","168"
"23082","VALLE MOSSO",2,0,0,2,"2017","073"
"23083","VALLE SALIMBENE",0,96,0,96,"2017","169"
"23084","VALLE SAN NICOLAO",7,0,0,7,"2017","074"
"23085","VALLEVE",0,10,0,10,"2017","226"
"23086","VALLI DEL PASUBIO",4,6,0,10,"2017","113"
"23087","VALLIO TERME",3,0,0,3,"2017","193"
"23088","VALLO TORINESE",21,0,0,21,"2017","286"
"23089","VALMADRERA",14,0,3,17,"2017","083"
"23090","VALMOREA",5,36,0,41,"2017","232"
"23091","VALMOZZOLA",48,10,0,58,"2017","044"
"23092","VALPERGA",215,134,0,349,"2017","287"
"23093","VALPRATO SOANA",61,0,0,61,"2017","288"
"23094","VALSAMOGGIA",175,910,6,1091,"2017",NA
"23095","VALSOLDA",5,5,5,15,"2017","234"
"23096","VALSTAGNA",4,0,0,4,"2017","114"
"23097","VALSTRONA",17,0,0,17,"2017","069"
"23098","VALTORTA",5,31,0,36,"2017","229"
"23099","VALVERDE",10,0,0,10,"2017","170"
"23100","VALVESTINO",5,6,0,11,"2017","194"
"23101","VANZAGO",43,0,0,43,"2017","229"
"23102","VAPRIO D'ADDA",21,361,0,382,"2017","230"
"23103","VARALLO",51,41,0,92,"2017","156"
"23104","VARALLO POMBIA",1,0,0,1,"2017","154"
"23105","VARANO DE' MELEGARI",17,445,0,462,"2017","045"
"23106","VAREDO",2,0,0,2,"2017",NA
"23107","VARESE",94,106,0,200,"2017","133"
"23108","VARISELLA",14,0,0,14,"2017","289"
"23109","VARSI",3,471,0,474,"2017","046"
"23110","VARZI",83,2,0,85,"2017","171"
"23111","VARZO",8,19,9,36,"2017","071"
"23112","VAUDA CANAVESE",52,0,0,52,"2017","290"
"23113","VAZZOLA",1341,144,6,1491,"2017","088"
"23114","VEDANO OLONA",109,114,0,223,"2017","134"
"23115","VEDELAGO",20350,395,91,20836,"2017","089"
"23116","VEDESETA",1,52,90,143,"2017","230"
"23117","VEGGIANO",118,92,36,246,"2017","096"
"23118","VEGLIO",34,0,0,34,"2017","075"
"23119","VELESO",0,0,4,4,"2017","236"
"23120","VELEZZO LOMELLINA",1,0,0,1,"2017","172"
"23121","VELLEZZO BELLINI",19,373,0,392,"2017","173"
"23122","VELO D'ASTICO",1064,24,0,1088,"2017","115"
"23123","VELO VERONESE",541,1711,0,2252,"2017","090"
"23124","VENARIA REALE",50,17,273,340,"2017","292"
"23125","VENASCA",42,0,0,42,"2017","237"
"23126","VENAUS",31,32,7,70,"2017","291"
"23127","VENDROGNO",7,6,2,15,"2017","085"
"23128","VENEGONO INFERIORE",0,97,2,99,"2017","136"
"23129","VENEGONO SUPERIORE",12,4,1,17,"2017","137"
"23130","VENEZIA",1559,223,0,1782,"2017","042"
"23131","VENIANO",47,87,0,134,"2017","238"
"23132","VENTASSO",79,368,0,447,"2017",NA
"23133","VERBANIA",65,0,0,65,"2017","072"
"23134","VERCANA",9,5,0,14,"2017","239"
"23135","VERCEIA",9,0,7,16,"2017","075"
"23136","VERCELLI",80,206,0,286,"2017","158"
"23137","VERDELLINO",0,69,0,69,"2017","232"
"23138","VERDELLO",248,66,0,314,"2017","233"
"23139","VERDERIO",1,0,47,48,"2017",NA
"23140","VERDUNO",96,0,0,96,"2017","238"
"23141","VERGATO",55,0,19,74,"2017","059"
"23142","VERGHERETO",532,0,48,580,"2017","050"
"23143","VERGIATE",31,0,0,31,"2017","138"
"23144","VERMEZZO",0,410,0,410,"2017","235"
"23145","VERNANTE",271,57,0,328,"2017","239"
"23146","VERNASCA",40,68,0,108,"2017","044"
"23147","VERNATE",4,95,0,99,"2017","236"
"23148","VEROLANUOVA",806,2291,123,3220,"2017","195"
"23149","VEROLAVECCHIA",45,3104,626,3775,"2017","196"
"23150","VEROLENGO",192,109,0,301,"2017","293"
"23151","VERONA",3324,926,0,4250,"2017","091"
"23152","VERONELLA",5289,282,0,5571,"2017","092"
"23153","VERRONE",65,0,0,65,"2017","076"
"23154","VERRUA SAVOIA",503,0,0,503,"2017","294"
"23155","VERTEMATE CON MINOPRIO",2,0,0,2,"2017","242"
"23156","VERTOVA",17,40,0,57,"2017","234"
"23157","VERUCCHIO",192,0,0,192,"2017","020"
"23158","VERUNO",9,0,0,9,"2017","157"
"23159","VERVIO",4,1,0,5,"2017","076"
"23160","VERZUOLO",6,0,0,6,"2017","240"
"23161","VESCOVANA",1,0,0,1,"2017","097"
"23162","VESCOVATO",2546,706,534,3786,"2017","113"
"23163","VESIME",620,1,0,621,"2017","113"
"23164","VESPOLATE",38,115,0,153,"2017","158"
"23165","VESTENANOVA",530,158,21,709,"2017","093"
"23166","VESTIGNE'",6,74,0,80,"2017","295"
"23167","VESTONE",5,0,0,5,"2017","197"
"23168","VETTO",25,381,0,406,"2017","042"
"23169","VEZZA D'ALBA",2,0,0,2,"2017","241"
"23170","VEZZA D'OGLIO",18,113,43,174,"2017","198"
"23171","VEZZANO SUL CROSTOLO",14,126,0,140,"2017","043"
"23172","VIADANA",284,1222,76,1582,"2017","066"
"23173","VIADANICA",24,24,0,48,"2017","235"
"23174","VIALE",297,0,0,297,"2017","114"
"23175","VIALFRE'",13,0,0,13,"2017","296"
"23176","VIANO",16,845,0,861,"2017","044"
"23177","VIARIGI",22,0,0,22,"2017","115"
"23178","VICENZA",238,963,0,1201,"2017","116"
"23179","VICO CANAVESE",148,123,3,274,"2017","297"
"23180","VICOFORTE",419,0,12,431,"2017","242"
"23181","VIDIGULFO",2,417,0,419,"2017","176"
"23182","VIDOR",23,345,0,368,"2017","090"
"23183","VIDRACCO",1,0,0,1,"2017","298"
"23184","VIGANO SAN MARTINO",13,0,0,13,"2017","236"
"23185","VIGASIO",1201,489,0,1690,"2017","094"
"23186","VIGEVANO",189,53,192,434,"2017","177"
"23187","VIGGIU'",27,58,0,85,"2017","139"
"23188","VIGHIZZOLO D'ESTE",125,22,0,147,"2017","098"
"23189","VIGLIANO BIELLESE",4,12,0,16,"2017","077"
"23190","VIGLIANO D'ASTI",27,0,0,27,"2017","116"
"23191","VIGNALE MONFERRATO",230,0,0,230,"2017","179"
"23192","VIGNATE",30,405,0,435,"2017","237"
"23193","VIGNOLA",5,81,0,86,"2017","046"
"23194","VIGNOLE BORBERA",19,0,0,19,"2017","180"
"23195","VIGNOLO",1167,0,0,1167,"2017","243"
"23196","VIGNONE",2,0,0,2,"2017","074"
"23197","VIGO DI CADORE",0,9,4,13,"2017","065"
"23198","VIGODARZERE",335,85,0,420,"2017","099"
"23199","VIGOLO",8,173,0,181,"2017","237"
"23200","VIGOLZONE",89,481,0,570,"2017","045"
"23201","VIGONE",2785,1188,177,4150,"2017","299"
"23202","VIGONOVO",18,0,1,19,"2017","043"
"23203","VIGONZA",679,188,0,867,"2017","100"
"23204","VIGUZZOLO",2,0,0,2,"2017",NA
"23205","VILLA BARTOLOMEA",111,0,0,111,"2017","095"
"23206","VILLA CARCINA",3,0,0,3,"2017","199"
"23207","VILLA CORTESE",161,0,0,161,"2017","248"
"23208","VILLA D'ADDA",6,0,0,6,"2017","238"
"23209","VILLA D'ALME'",67,20,0,87,"2017","239"
"23210","VILLA D'OGNA",1,64,0,65,"2017","241"
"23211","VILLA DEL BOSCO",1,0,0,1,"2017","078"
"23212","VILLA DEL CONTE",752,699,0,1451,"2017","101"
"23213","VILLA DI CHIAVENNA",5,6,1,12,"2017","077"
"23214","VILLA DI SERIO",9,0,0,9,"2017","240"
"23215","VILLA DI TIRANO",7,125,57,189,"2017","078"
"23216","VILLA ESTENSE",233,0,0,233,"2017","102"
"23217","VILLA GUARDIA",157,0,0,157,"2017","245"
"23218","VILLA MINOZZO",50,800,0,850,"2017","045"
"23219","VILLA POMA",0,646,96,742,"2017","067"
"23220","VILLA SAN SECONDO",7,0,0,7,"2017","119"
"23221","VILLACHIARA",476,1901,1047,3424,"2017","200"
"23222","VILLADEATI",15,0,0,15,"2017","182"
"23223","VILLADOSE",177,0,124,301,"2017","048"
"23224","VILLADOSSOLA",18,0,0,18,"2017","075"
"23225","VILLAFALLETTO",2343,868,238,3449,"2017","244"
"23226","VILLAFRANCA D'ASTI",263,0,0,263,"2017","117"
"23227","VILLAFRANCA DI VERONA",8496,3286,85,11867,"2017","096"
"23228","VILLAFRANCA PADOVANA",708,1875,14,2597,"2017","103"
"23229","VILLAFRANCA PIEMONTE",2539,1929,426,4894,"2017","300"
"23230","VILLAGA",198,107,100,405,"2017","117"
"23231","VILLALVERNIA",1,0,0,1,"2017",NA
"23232","VILLAMARZANA",754,95,0,849,"2017","049"
"23233","VILLAMIROGLIO",6,0,0,6,"2017","184"
"23234","VILLANOVA BIELLESE",322,0,0,322,"2017","079"
"23235","VILLANOVA CANAVESE",44,13,5,62,"2017","301"
"23236","VILLANOVA D'ARDENGHI",4,0,1,5,"2017","179"
"23237","VILLANOVA D'ASTI",3956,85,0,4041,"2017","118"
"23238","VILLANOVA DEL GHEBBO",27,0,0,27,"2017","050"
"23239","VILLANOVA DEL SILLARO",0,951,7,958,"2017","060"
"23240","VILLANOVA DI CAMPOSAMPIERO",19,27,3,49,"2017","104"
"23241","VILLANOVA MARCHESANA",0,67,0,67,"2017","051"
"23242","VILLANOVA MONDOVI'",2009,472,125,2606,"2017","245"
"23243","VILLANOVA MONFERRATO",0,82,0,82,"2017","185"
"23244","VILLANOVA SOLARO",229,639,8,876,"2017","246"
"23245","VILLANOVA SULL'ARDA",81,1411,0,1492,"2017","046"
"23246","VILLANTERIO",3,0,196,199,"2017","180"
"23247","VILLANUOVA SUL CLISI",5,0,0,5,"2017","201"
"23248","VILLAR DORA",48,0,45,93,"2017","303"
"23249","VILLAR FOCCHIARDO",18,21,61,100,"2017","305"
"23250","VILLAR PELLICE",200,35,10,245,"2017","306"
"23251","VILLAR PEROSA",8,0,32,40,"2017","307"
"23252","VILLAR SAN COSTANZO",403,165,2,570,"2017","247"
"23253","VILLARBASSE",223,14,0,237,"2017","302"
"23254","VILLAREGGIA",59,15,0,74,"2017","304"
"23255","VILLAROMAGNANO",37,0,0,37,"2017","186"
"23256","VILLASTELLONE",795,598,0,1393,"2017","308"
"23257","VILLATA",14,33,0,47,"2017","164"
"23258","VILLAVERLA",93,1267,0,1360,"2017","118"
"23259","VILLETTE",44,0,0,44,"2017","076"
"23260","VILLIMPENTA",698,1,88,787,"2017","068"
"23261","VILLONGO",16,0,0,16,"2017","242"
"23262","VILLORBA",126,5,0,131,"2017","091"
"23263","VILMINORE DI SCALVE",9,164,0,173,"2017","243"
"23264","VIMERCATE",3,54,0,57,"2017",NA
"23265","VINADIO",192,0,0,192,"2017","248"
"23266","VINCHIO",17,0,0,17,"2017","120"
"23267","VINOVO",424,145,24,593,"2017","309"
"23268","VINZAGLIO",13,38,0,51,"2017","164"
"23269","VIOLA",90,0,0,90,"2017","249"
"23270","VIONE",1,55,2,58,"2017","202"
"23271","VIRLE PIEMONTE",307,210,162,679,"2017","310"
"23272","VISANO",1645,494,9,2148,"2017","203"
"23273","VISCHE",8,0,0,8,"2017","311"
"23274","VISONE",57,0,0,57,"2017","187"
"23275","VISTARINO",34,0,14,48,"2017","181"
"23276","VISTRORIO",12,0,0,12,"2017","312"
"23277","VITTORIO VENETO",224,127,20,371,"2017","092"
"23278","VITTUONE",1,204,0,205,"2017","243"
"23279","VIU'",60,0,69,129,"2017","313"
"23280","VIVERONE",41,0,0,41,"2017","080"
"23281","VIZZOLO PREDABISSI",25,0,43,68,"2017","244"
"23282","VO'",72,81,0,153,"2017","105"
"23283","VOBARNO",41,82,5,128,"2017","204"
"23284","VOCCA",0,23,0,23,"2017","166"
"23285","VODO CADORE",0,0,29,29,"2017","066"
"23286","VOGHERA",72,0,0,72,"2017","182"
"23287","VOGHIERA",4,0,0,4,"2017","023"
"23288","VOGOGNA",11,6,0,17,"2017","077"
"23289","VOLONGO",37,0,0,37,"2017","114"
"23290","VOLPAGO DEL MONTELLO",1206,586,22,1814,"2017","093"
"23291","VOLPEDO",2,0,0,2,"2017","188"
"23292","VOLPIANO",248,164,31,443,"2017","314"
"23293","VOLTA MANTOVANA",3417,1238,921,5576,"2017","070"
"23294","VOLTAGGIO",12,0,58,70,"2017","190"
"23295","VOLTIDO",0,375,0,375,"2017","115"
"23296","VOLVERA",1229,140,0,1369,"2017","315"
"23297","VOTTIGNASCO",1887,81,83,2051,"2017","250"
"23298","ZANDOBBIO",13,0,0,13,"2017","244"
"23299","ZANE'",323,173,0,496,"2017","119"
"23300","ZANICA",245,1235,0,1480,"2017","245"
"23301","ZAVATTARELLO",91,0,0,91,"2017","184"
"23302","ZECCONE",9,248,0,257,"2017","185"
"23303","ZELBIO",0,0,11,11,"2017","246"
"23304","ZELO BUON PERSICO",0,1185,15,1200,"2017","061"
"23305","ZELO SURRIGONE",10,254,0,264,"2017","246"
"23306","ZEME",59,21,0,80,"2017","186"
"23307","ZENEVREDO",2,0,0,2,"2017","187"
"23308","ZENSON DI PIAVE",13,0,0,13,"2017","094"
"23309","ZERBOLO'",0,187,0,187,"2017","189"
"23310","ZERMEGHEDO",0,39,0,39,"2017","120"
"23311","ZERO BRANCO",245,169,3,417,"2017","095"
"23312","ZEVIO",4368,706,79,5153,"2017","097"
"23313","ZIANO PIACENTINO",91,0,0,91,"2017","048"
"23314","ZIBIDO SAN GIACOMO",37,469,60,566,"2017","247"
"23315","ZIMELLA",8832,432,64,9328,"2017","098"
"23316","ZIMONE",4,0,0,4,"2017",NA
"23317","ZINASCO",28,0,0,28,"2017","190"
"23318","ZOCCA",60,856,0,916,"2017","047"
"23319","ZOGNO",99,56,0,155,"2017","246"
"23320","ZOLA PREDOSA",17,242,0,259,"2017","060"
"23321","ZONE",8,32,0,40,"2017","205"
"23322","ZOPPE' DI CADORE",0,6,0,6,"2017",NA
"23323","ZOVENCEDO",7,0,0,7,"2017","121"
"23324","ZUBIENA",33,3,23,59,"2017","082"
"23325","ZUGLIANO",470,147,20,637,"2017","122"
"23326","ZUMAGLIA",54,0,0,54,"2017","083"
"23327","ABANO TERME",33,129,33,195,"2018","001"
"23328","ABBADIA CERRETO",0,1231,0,1231,"2018","001"
"23329","ABBADIA LARIANA",12,24,2,38,"2018","001"
"23330","ABBIATEGRASSO",71,1460,13,1544,"2018","002"
"23331","ACCEGLIO",118,0,0,118,"2018","001"
"23332","ACQUAFREDDA",1591,112,0,1703,"2018","001"
"23333","ACQUANEGRA CREMONESE",0,193,476,669,"2018","001"
"23334","ACQUANEGRA SUL CHIESE",1011,761,173,1945,"2018","001"
"23335","ACQUI TERME",250,0,0,250,"2018","001"
"23336","ADRARA SAN MARTINO",38,22,13,73,"2018","001"
"23337","ADRARA SAN ROCCO",5,0,6,11,"2018","002"
"23338","ADRIA",2504,271,0,2775,"2018","001"
"23339","ADRO",527,16,0,543,"2018","002"
"23340","AGAZZANO",71,359,0,430,"2018","001"
"23341","AGLIANO TERME",56,0,0,56,"2018","001"
"23342","AGLIE'",192,28,29,249,"2018","001"
"23343","AGNA",368,0,0,368,"2018","002"
"23344","AGNADELLO",0,1264,447,1711,"2018","002"
"23345","AGNOSINE",12,40,0,52,"2018","003"
"23346","AGORDO",4,12,0,16,"2018","001"
"23347","AGRATE CONTURBIA",39,0,0,39,"2018","001"
"23348","AGUGLIARO",370,18,0,388,"2018","001"
"23349","AICURZIO",8,58,0,66,"2018",NA
"23350","AILOCHE",0,10,0,10,"2018","001"
"23351","AIRASCA",739,460,131,1330,"2018","002"
"23352","AIRUNO",3,0,0,3,"2018","002"
"23353","AISONE",25,0,0,25,"2018","002"
"23354","ALA DI STURA",26,40,0,66,"2018","003"
"23355","ALAGNA VALSESIA",22,16,0,38,"2018","002"
"23356","ALANO DI PIAVE",422,65,0,487,"2018","002"
"23357","ALBA",731,0,0,731,"2018","003"
"23358","ALBAIRATE",35,613,0,648,"2018","005"
"23359","ALBANO SANT'ALESSANDRO",11,0,2,13,"2018","003"
"23360","ALBAREDO D'ADIGE",11406,194,0,11600,"2018","002"
"23361","ALBAREDO PER SAN MARCO",3,32,0,35,"2018","001"
"23362","ALBARETO",126,67,0,193,"2018","001"
"23363","ALBARETTO DELLA TORRE",25,0,0,25,"2018","004"
"23364","ALBAVILLA",1,0,0,1,"2018","003"
"23365","ALBERA LIGURE",27,0,0,27,"2018","002"
"23366","ALBESE CON CASSANO",0,0,6,6,"2018","004"
"23367","ALBETTONE",1857,693,60,2610,"2018","002"
"23368","ALBIANO D'IVREA",147,35,0,182,"2018","004"
"23369","ALBIATE",317,0,0,317,"2018",NA
"23370","ALBIGNASEGO",152,209,11,372,"2018","003"
"23371","ALBINEA",30,1043,0,1073,"2018","001"
"23372","ALBINO",55,54,10,119,"2018","004"
"23373","ALBIOLO",23,0,0,23,"2018","005"
"23374","ALBIZZATE",6,0,0,6,"2018","002"
"23375","ALBOSAGGIA",39,60,28,127,"2018","002"
"23376","ALBUGNANO",35,0,0,35,"2018","002"
"23377","ALBUZZANO",29,0,0,29,"2018","004"
"23378","ALESSANDRIA",11140,2246,0,13386,"2018","003"
"23379","ALFIANELLO",11,479,4,494,"2018","004"
"23380","ALFIANO NATTA",33,0,0,33,"2018","004"
"23381","ALFONSINE",53,0,0,53,"2018","001"
"23382","ALGUA",8,2,0,10,"2018","248"
"23383","ALICE BEL COLLE",2,0,0,2,"2018","005"
"23384","ALICE CASTELLO",706,24,0,730,"2018","004"
"23385","ALICE SUPERIORE",26,0,0,26,"2018","005"
"23386","ALLEGHE",3,0,0,3,"2018","003"
"23387","ALLUVIONI PIOVERA",201,162,0,363,"2018",NA
"23388","ALME'",2,0,2,4,"2018","005"
"23389","ALMENNO SAN BARTOLOMEO",29,8,0,37,"2018","006"
"23390","ALMENNO SAN SALVATORE",4,0,0,4,"2018","007"
"23391","ALMESE",56,20,0,76,"2018","006"
"23392","ALONTE",687,13,0,700,"2018","003"
"23393","ALPAGO",29,241,0,270,"2018",NA
"23394","ALPETTE",1,0,0,1,"2018","007"
"23395","ALPIGNANO",336,163,31,530,"2018","008"
"23396","ALSENO",634,875,0,1509,"2018","002"
"23397","ALSERIO",4,0,0,4,"2018","006"
"23398","ALTA VAL TIDONE",645,151,0,796,"2018",NA
"23399","ALTA VALLE INTELVI",41,31,17,89,"2018",NA
"23400","ALTAVILLA MONFERRATO",77,0,0,77,"2018","007"
"23401","ALTAVILLA VICENTINA",118,0,0,118,"2018","004"
"23402","ALTISSIMO",42,42,0,84,"2018","005"
"23403","ALTIVOLE",12558,72,20,12650,"2018","001"
"23404","ALTO RENO TERME",47,0,0,47,"2018",NA
"23405","ALTO SERMENZA",1,7,0,8,"2018",NA
"23406","ALZANO LOMBARDO",17,42,0,59,"2018","008"
"23407","ALZANO SCRIVIA",3,0,0,3,"2018","008"
"23408","ALZATE BRIANZA",5,154,0,159,"2018","007"
"23409","AMBIVERE",1,0,0,1,"2018","009"
"23410","AMENO",10,4,24,38,"2018","002"
"23411","ANDALO VALTELLINO",12,0,0,12,"2018",NA
"23412","ANDEZENO",360,0,0,360,"2018","009"
"23413","ANDORNO MICCA",21,0,57,78,"2018","002"
"23414","ANDRATE",36,0,0,36,"2018","010"
"23415","ANFO",0,23,0,23,"2018","005"
"23416","ANGERA",55,148,15,218,"2018","003"
"23417","ANGOLO TERME",4,61,2,67,"2018","006"
"23418","ANGROGNA",87,0,32,119,"2018","011"
"23419","ANGUILLARA VENETA",10,0,0,10,"2018","004"
"23420","ANNICCO",15,842,249,1106,"2018","003"
"23421","ANNONE DI BRIANZA",20,13,0,33,"2018","003"
"23422","ANNONE VENETO",18,38,0,56,"2018","001"
"23423","ANTEGNATE",786,1432,0,2218,"2018","010"
"23424","ANTIGNANO",99,0,0,99,"2018","003"
"23425","ANTRONA SCHIERANCO",8,0,0,8,"2018","001"
"23426","ANZANO DEL PARCO",0,152,0,152,"2018","009"
"23427","ANZOLA D'OSSOLA",2,132,0,134,"2018","002"
"23428","ANZOLA DELL'EMILIA",33,453,0,486,"2018","001"
"23429","APPIANO GENTILE",75,274,22,371,"2018","010"
"23430","APRICA",0,2,0,2,"2018","004"
"23431","ARAMENGO",193,0,0,193,"2018","004"
"23432","ARCADE",1146,64,0,1210,"2018","002"
"23433","ARCENE",4,385,0,389,"2018","011"
"23434","ARCISATE",65,600,327,992,"2018","004"
"23435","ARCOLE",1260,146,0,1406,"2018","004"
"23436","ARCONATE",22,83,0,105,"2018","007"
"23437","ARCORE",38,0,0,38,"2018",NA
"23438","ARCUGNANO",92,4,0,96,"2018","006"
"23439","ARDENNO",19,42,0,61,"2018","005"
"23440","ARDESIO",51,89,1,141,"2018","012"
"23441","ARENA PO",49,471,122,642,"2018","005"
"23442","ARESE",0,116,0,116,"2018","009"
"23443","ARGEGNO",3,0,0,3,"2018","011"
"23444","ARGELATO",47,71,0,118,"2018","002"
"23445","ARGENTA",1527,3,0,1530,"2018","001"
"23446","ARGUELLO",53,0,0,53,"2018","007"
"23447","ARIANO NEL POLESINE",862,164,0,1026,"2018","002"
"23448","ARIGNANO",578,0,0,578,"2018","012"
"23449","ARLUNO",72,249,23,344,"2018","010"
"23450","ARMENO",56,77,2,135,"2018","006"
"23451","AROLA",3,0,7,10,"2018","004"
"23452","ARONA",2,0,0,2,"2018","008"
"23453","AROSIO",1,2,0,3,"2018","012"
"23454","ARQUA' PETRARCA",160,0,0,160,"2018","005"
"23455","ARQUA' POLESINE",907,4,0,911,"2018","003"
"23456","ARQUATA SCRIVIA",6,0,0,6,"2018","009"
"23457","ARRE",1,16,0,17,"2018","006"
"23458","ARSAGO SEPRIO",10,0,0,10,"2018","005"
"23459","ARSIE'",19,4,486,509,"2018","004"
"23460","ARSIERO",4,18,0,22,"2018","007"
"23461","ARTOGNE",1,323,67,391,"2018","007"
"23462","ARZAGO D'ADDA",375,907,0,1282,"2018","013"
"23463","ARZERGRANDE",536,164,0,700,"2018","007"
"23464","ARZIGNANO",189,281,0,470,"2018","008"
"23465","ASIAGO",66,1104,11,1181,"2018","009"
"23466","ASIGLIANO VENETO",191,0,0,191,"2018","010"
"23467","ASIGLIANO VERCELLESE",18,0,0,18,"2018","007"
"23468","ASOLA",8136,1552,1432,11120,"2018","002"
"23469","ASOLO",10050,529,0,10579,"2018","003"
"23470","ASSO",14,0,7,21,"2018","013"
"23471","ASTI",2443,6,0,2449,"2018","005"
"23472","AURANO",13,0,0,13,"2018","005"
"23473","AURONZO DI CADORE",11,18,0,29,"2018","005"
"23474","AVERARA",0,5,0,5,"2018","014"
"23475","AVIATICO",3,21,0,24,"2018","015"
"23476","AVIGLIANA",204,52,9,265,"2018","013"
"23477","AVOLASCA",183,0,0,183,"2018","010"
"23478","AZEGLIO",30,17,60,107,"2018","014"
"23479","AZZANELLO",2,156,0,158,"2018","004"
"23480","AZZANO D'ASTI",1,0,0,1,"2018",NA
"23481","AZZANO MELLA",154,908,0,1062,"2018","008"
"23482","AZZANO SAN PAOLO",18,141,0,159,"2018","016"
"23483","AZZATE",17,0,4,21,"2018","006"
"23484","AZZIO",9,109,0,118,"2018","007"
"23485","AZZONE",0,1,0,1,"2018","017"
"23486","BACENO",7,14,0,21,"2018","006"
"23487","BADIA CALAVENA",1148,203,35,1386,"2018","005"
"23488","BADIA PAVESE",17,0,0,17,"2018","006"
"23489","BADIA POLESINE",199,0,0,199,"2018","004"
"23490","BAGNACAVALLO",37,0,0,37,"2018","002"
"23491","BAGNARA DI ROMAGNA",5,0,0,5,"2018","003"
"23492","BAGNARIA",7,0,0,7,"2018","007"
"23493","BAGNASCO",132,0,0,132,"2018","008"
"23494","BAGNATICA",4,220,0,224,"2018","018"
"23495","BAGNO DI ROMAGNA",847,10,0,857,"2018","001"
"23496","BAGNOLI DI SOPRA",893,7,0,900,"2018","008"
"23497","BAGNOLO CREMASCO",3,1810,0,1813,"2018","005"
"23498","BAGNOLO IN PIANO",2,522,0,524,"2018","002"
"23499","BAGNOLO MELLA",311,2903,330,3544,"2018","009"
"23500","BAGNOLO PIEMONTE",830,0,130,960,"2018","009"
"23501","BAGNOLO SAN VITO",80,2375,1232,3687,"2018","003"
"23502","BAGOLINO",2,285,6,293,"2018","010"
"23503","BAIRO",71,87,0,158,"2018","015"
"23504","BAISO",24,854,0,878,"2018","003"
"23505","BALANGERO",191,15,84,290,"2018","016"
"23506","BALDICHIERI D'ASTI",47,0,0,47,"2018","007"
"23507","BALDISSERO CANAVESE",0,86,0,86,"2018","017"
"23508","BALDISSERO D'ALBA",739,0,0,739,"2018","010"
"23509","BALDISSERO TORINESE",164,0,0,164,"2018","018"
"23510","BALLABIO",20,60,3,83,"2018","004"
"23511","BALME",14,0,0,14,"2018","019"
"23512","BALOCCO",45,0,15,60,"2018","009"
"23513","BANCHETTE",4,0,2,6,"2018","020"
"23514","BANNIO ANZINO",59,0,0,59,"2018","007"
"23515","BAONE",13,0,0,13,"2018","009"
"23516","BARBANIA",21,154,76,251,"2018","021"
"23517","BARBARANO MOSSANO",796,387,0,1183,"2018",NA
"23518","BARBARESCO",26,0,0,26,"2018","011"
"23519","BARBARIGA",1022,1445,0,2467,"2018","011"
"23520","BARBATA",0,787,0,787,"2018","019"
"23521","BARBIANELLO",82,4,0,86,"2018","008"
"23522","BARBONA",328,4,0,332,"2018","010"
"23523","BARDELLO",15,0,0,15,"2018","009"
"23524","BARDI",63,668,0,731,"2018","002"
"23525","BARDOLINO",27,112,0,139,"2018","006"
"23526","BARDONECCHIA",23,37,0,60,"2018","022"
"23527","BAREGGIO",37,122,7,166,"2018","012"
"23528","BARENGO",0,115,0,115,"2018","012"
"23529","BARGE",3872,1545,789,6206,"2018","012"
"23530","BARGHE",8,12,0,20,"2018","012"
"23531","BARIANO",11,330,0,341,"2018","020"
"23532","BARNI",3,4,0,7,"2018","015"
"23533","BAROLO",36,0,0,36,"2018","013"
"23534","BARONE CANAVESE",213,57,0,270,"2018","023"
"23535","BARZAGO",250,11,0,261,"2018","005"
"23536","BARZANO'",5,0,0,5,"2018","006"
"23537","BARZIO",6,41,2,49,"2018","007"
"23538","BASALUZZO",143,0,0,143,"2018","012"
"23539","BASCAPE'",1,848,0,849,"2018","009"
"23540","BASIGLIO",0,69,0,69,"2018","015"
"23541","BASSANO BRESCIANO",0,98,0,98,"2018","013"
"23542","BASSANO DEL GRAPPA",254,169,0,423,"2018","012"
"23543","BASSIGNANA",2,0,0,2,"2018","013"
"23544","BASTIA MONDOVI'",677,0,0,677,"2018","014"
"23545","BASTIDA PANCARANA",2,0,0,2,"2018","011"
"23546","BASTIGLIA",122,0,0,122,"2018","001"
"23547","BATTAGLIA TERME",4,0,0,4,"2018","011"
"23548","BEDERO VALCUVIA",13,0,0,13,"2018","010"
"23549","BEDIZZOLE",4006,1381,28,5415,"2018","014"
"23550","BEDONIA",173,108,0,281,"2018","003"
"23551","BEDULITA",8,0,0,8,"2018","022"
"23552","BEE",1,0,0,1,"2018","009"
"23553","BEINASCO",14,0,0,14,"2018","024"
"23554","BEINETTE",762,356,0,1118,"2018","016"
"23555","BELFIORE",2553,0,0,2553,"2018","007"
"23556","BELGIOIOSO",0,138,0,138,"2018","013"
"23557","BELLAGIO",3,69,23,95,"2018","019"
"23558","BELLANO",7,0,0,7,"2018","008"
"23559","BELLARIA-IGEA MARINA",13,0,0,13,"2018","001"
"23560","BELLINO",137,0,0,137,"2018","017"
"23561","BELLINZAGO LOMBARDO",63,1319,0,1382,"2018","016"
"23562","BELLINZAGO NOVARESE",352,529,0,881,"2018","016"
"23563","BELLUNO",400,341,163,904,"2018","006"
"23564","BELVEDERE LANGHE",133,0,78,211,"2018","018"
"23565","BEMA",0,4,0,4,"2018","006"
"23566","BENE LARIO",1,0,76,77,"2018","021"
"23567","BENE VAGIENNA",1706,468,0,2174,"2018","019"
"23568","BENEVELLO",125,0,0,125,"2018","020"
"23569","BENNA",8,21,22,51,"2018","003"
"23570","BENTIVOGLIO",1,382,0,383,"2018","005"
"23571","BERBENNO",11,35,0,46,"2018","023"
"23572","BERBENNO DI VALTELLINA",42,155,0,197,"2018","007"
"23573","BERCETO",31,250,0,281,"2018","004"
"23574","BEREGAZZO CON FIGLIARO",6,0,0,6,"2018","022"
"23575","BEREGUARDO",14,629,73,716,"2018","014"
"23576","BERGAMASCO",51,0,0,51,"2018","015"
"23577","BERGAMO",117,117,1,235,"2018","024"
"23578","BERLINGO",3428,297,34,3759,"2018","015"
"23579","BERNAREGGIO",0,18,0,18,"2018",NA
"23580","BERNATE TICINO",24,155,0,179,"2018","019"
"23581","BERNEZZO",305,66,22,393,"2018","022"
"23582","BERRA",1760,69,0,1829,"2018","002"
"23583","BERTINORO",188,5,0,193,"2018","003"
"23584","BERTONICO",0,2649,0,2649,"2018","002"
"23585","BERZANO DI SAN PIETRO",4,0,0,4,"2018","009"
"23586","BERZO DEMO",4,68,6,78,"2018","016"
"23587","BERZO INFERIORE",2,126,4,132,"2018","017"
"23588","BERZO SAN FERMO",589,66,30,685,"2018","025"
"23589","BESANA IN BRIANZA",937,47,24,1008,"2018",NA
"23590","BESANO",25,0,9,34,"2018","011"
"23591","BESATE",79,0,0,79,"2018","022"
"23592","BESENZONE",81,1666,0,1747,"2018","003"
"23593","BESNATE",11,195,0,206,"2018","012"
"23594","BESOZZO",9,67,0,76,"2018","013"
"23595","BETTOLA",323,112,0,435,"2018","004"
"23596","BEURA-CARDEZZA",23,3,0,26,"2018","011"
"23597","BEVILACQUA",188,42,0,230,"2018","008"
"23598","BIANDRONNO",17,0,6,23,"2018","014"
"23599","BIANZANO",6,16,0,22,"2018","026"
"23600","BIANZE'",79,336,0,415,"2018","011"
"23601","BIANZONE",4,3,0,7,"2018","008"
"23602","BIASSONO",7,0,0,7,"2018",NA
"23603","BIBBIANO",12,2464,0,2476,"2018","004"
"23604","BIBIANA",616,0,0,616,"2018","025"
"23605","BIELLA",158,38,110,306,"2018","004"
"23606","BIENNO",5,152,9,166,"2018","018"
"23607","BIGARELLO",1375,249,551,2175,"2018","004"
"23608","BINAGO",32,73,76,181,"2018","023"
"23609","BIOGLIO",4,0,0,4,"2018","005"
"23610","BIONE",12,4,4,20,"2018","019"
"23611","BISTAGNO",6,0,0,6,"2018","017"
"23612","BISUSCHIO",6,0,0,6,"2018","015"
"23613","BIZZARONE",7,12,0,19,"2018","024"
"23614","BLELLO",0,81,0,81,"2018","027"
"23615","BLESSAGNO",0,0,5,5,"2018","025"
"23616","BOBBIO",136,156,0,292,"2018","005"
"23617","BOBBIO PELLICE",51,12,122,185,"2018","026"
"23618","BOCCIOLETO",12,0,0,12,"2018","014"
"23619","BOFFALORA D'ADDA",17,316,0,333,"2018","003"
"23620","BOFFALORA SOPRA TICINO",68,92,22,182,"2018","026"
"23621","BOLGARE",57,276,0,333,"2018","028"
"23622","BOLLATE",0,273,13,286,"2018","027"
"23623","BOLLENGO",70,66,0,136,"2018","027"
"23624","BOLOGNA",13,27,9,49,"2018","006"
"23625","BOLTIERE",12,66,0,78,"2018","029"
"23626","BOLZANO NOVARESE",0,24,0,24,"2018","022"
"23627","BOLZANO VICENTINO",197,1263,4,1464,"2018","013"
"23628","BOMPORTO",1198,159,0,1357,"2018","002"
"23629","BONATE SOPRA",297,0,0,297,"2018","030"
"23630","BONATE SOTTO",79,0,0,79,"2018","031"
"23631","BONAVIGO",3721,24,1,3746,"2018","009"
"23632","BONDENO",567,358,0,925,"2018","003"
"23633","BONEMERSE",18,153,0,171,"2018","006"
"23634","BORDOLANO",16,485,0,501,"2018","007"
"23635","BORE",50,6,0,56,"2018","005"
"23636","BORETTO",0,207,0,207,"2018","005"
"23637","BORGARO TORINESE",301,72,0,373,"2018","028"
"23638","BORGHETTO DI BORBERA",135,0,12,147,"2018","018"
"23639","BORGHETTO LODIGIANO",15,2132,46,2193,"2018","004"
"23640","BORGHI",1632,0,0,1632,"2018","004"
"23641","BORGIALLO",3,25,0,28,"2018","029"
"23642","BORGO D'ALE",263,0,0,263,"2018","015"
"23643","BORGO DI TERZO",3,0,0,3,"2018","032"
"23644","BORGO MANTOVANO",1,869,172,1042,"2018",NA
"23645","BORGO PRIOLO",4,0,0,4,"2018","016"
"23646","BORGO SAN DALMAZZO",362,0,73,435,"2018","025"
"23647","BORGO SAN GIACOMO",1242,3634,127,5003,"2018","020"
"23648","BORGO SAN GIOVANNI",8,925,0,933,"2018","005"
"23649","BORGO SAN SIRO",2,706,0,708,"2018","018"
"23650","BORGO TICINO",37,0,0,37,"2018","025"
"23651","BORGO TOSSIGNANO",6,0,0,6,"2018","007"
"23652","BORGO VAL DI TARO",94,212,0,306,"2018","006"
"23653","BORGO VENETO",1754,33,0,1787,"2018",NA
"23654","BORGO VERCELLI",2,0,0,2,"2018","017"
"23655","BORGO VIRGILIO",156,3737,2209,6102,"2018",NA
"23656","BORGOFRANCO D'IVREA",200,0,0,200,"2018","030"
"23657","BORGOFRANCO SUL PO",1,16,58,75,"2018","006"
"23658","BORGOLAVEZZARO",6,0,0,6,"2018","023"
"23659","BORGOMALE",34,0,0,34,"2018","024"
"23660","BORGOMANERO",96,23,0,119,"2018","024"
"23661","BORGOMASINO",152,0,8,160,"2018","031"
"23662","BORGOMEZZAVALLE",2,0,0,2,"2018",NA
"23663","BORGONE SUSA",23,14,0,37,"2018","032"
"23664","BORGONOVO VAL TIDONE",736,2003,0,2739,"2018","006"
"23665","BORGORATTO ALESSANDRINO",30,0,0,30,"2018","019"
"23666","BORGORATTO MORMOROLO",20,0,0,20,"2018","017"
"23667","BORGORICCO",69,26,0,95,"2018","013"
"23668","BORGOSATOLLO",1,574,51,626,"2018","021"
"23669","BORGOSESIA",65,41,0,106,"2018","016"
"23670","BORMIO",23,349,12,384,"2018","009"
"23671","BORNASCO",159,549,2,710,"2018","019"
"23672","BORNO",0,133,62,195,"2018","022"
"23673","BORRIANA",73,51,0,124,"2018","006"
"23674","BORSO DEL GRAPPA",124,197,7,328,"2018","004"
"23675","BOSARO",2,0,0,2,"2018","007"
"23676","BOSCHI SANT'ANNA",6,0,30,36,"2018","010"
"23677","BOSCO CHIESANUOVA",52,1437,0,1489,"2018","011"
"23678","BOSCO MARENGO",68,32,0,100,"2018","021"
"23679","BOSCONERO",74,32,0,106,"2018","033"
"23680","BOSIA",367,0,0,367,"2018","026"
"23681","BOSIO",17,0,5,22,"2018","022"
"23682","BOSISIO PARINI",0,137,0,137,"2018","009"
"23683","BOSSICO",16,65,0,81,"2018","033"
"23684","BOSSOLASCO",55,53,0,108,"2018","027"
"23685","BOTTANUCO",5,220,389,614,"2018","034"
"23686","BOTTICINO",30,0,0,30,"2018","023"
"23687","BOVEGNO",56,62,51,169,"2018","024"
"23688","BOVES",780,699,142,1621,"2018","028"
"23689","BOVEZZO",1,0,0,1,"2018","025"
"23690","BOVOLENTA",3435,344,0,3779,"2018","014"
"23691","BOVOLONE",3537,352,0,3889,"2018","012"
"23692","BOZZOLO",51,1210,17,1278,"2018","007"
"23693","BRA",3579,1319,150,5048,"2018","029"
"23694","BRACCA",4,0,0,4,"2018","035"
"23695","BRALLO DI PREGOLA",11,10,0,21,"2018","021"
"23696","BRANDICO",0,651,0,651,"2018","026"
"23697","BRANDIZZO",0,0,90,90,"2018","034"
"23698","BRANZI",3,33,4,40,"2018","036"
"23699","BRAONE",0,43,1,44,"2018","027"
"23700","BREBBIA",37,0,0,37,"2018","017"
"23701","BREDA DI PIAVE",44,390,5,439,"2018","005"
"23702","BREGANO",4,0,0,4,"2018","018"
"23703","BREGANZE",526,738,108,1372,"2018","014"
"23704","BREGNANO",14,102,0,116,"2018","028"
"23705","BREMBATE",34,0,220,254,"2018","037"
"23706","BREMBATE DI SOPRA",0,242,0,242,"2018","038"
"23707","BREMBIO",201,2122,123,2446,"2018","006"
"23708","BREME",21,0,0,21,"2018","022"
"23709","BRENDOLA",267,88,0,355,"2018","015"
"23710","BRENNA",2,0,0,2,"2018","029"
"23711","BRENO",7,230,4,241,"2018","028"
"23712","BRENTA",4,0,0,4,"2018","019"
"23713","BRENZONE",3,0,0,3,"2018","014"
"23714","BRESCELLO",2,22,0,24,"2018","006"
"23715","BRESCIA",38,580,0,618,"2018","029"
"23716","BRESSANA BOTTARONE",274,0,0,274,"2018","023"
"23717","BRESSANVIDO",48,1269,11,1328,"2018","016"
"23718","BRESSO",3,0,0,3,"2018",NA
"23719","BRIAGLIA",72,0,0,72,"2018","030"
"23720","BRICHERASIO",1028,61,23,1112,"2018","035"
"23721","BRIGA NOVARESE",0,88,0,88,"2018","026"
"23722","BRIGNANO GERA D'ADDA",224,1657,0,1881,"2018","040"
"23723","BRIGNANO-FRASCATA",3,0,0,3,"2018","024"
"23724","BRINZIO",8,0,0,8,"2018","021"
"23725","BRIONA",12,1604,0,1616,"2018","027"
"23726","BRIONE",23,0,0,23,"2018","030"
"23727","BRIOSCO",8,0,0,8,"2018",NA
"23728","BRISIGHELLA",312,69,0,381,"2018","004"
"23729","BRISSAGO-VALTRAVAGLIA",2,0,0,2,"2018","022"
"23730","BRIVIO",27,86,0,113,"2018","010"
"23731","BROGLIANO",42,27,0,69,"2018","017"
"23732","BRONDELLO",5,0,0,5,"2018","032"
"23733","BRONI",71,0,0,71,"2018","024"
"23734","BROSSASCO",66,0,0,66,"2018","033"
"23735","BROSSO",26,13,9,48,"2018","036"
"23736","BROVELLO-CARPUGNINO",15,0,5,20,"2018","013"
"23737","BROZOLO",42,0,0,42,"2018","037"
"23738","BRUGHERIO",6,250,0,256,"2018",NA
"23739","BRUGINE",3555,88,46,3689,"2018","015"
"23740","BRUINO",120,0,0,120,"2018","038"
"23741","BRUMANO",19,20,0,39,"2018","041"
"23742","BRUNELLO",9,0,0,9,"2018","023"
"23743","BRUNO",13,0,0,13,"2018","010"
"23744","BRUSAPORTO",35,0,29,64,"2018","042"
"23745","BRUSASCO",132,0,0,132,"2018","039"
"23746","BRUSNENGO",11,0,0,11,"2018","007"
"23747","BRUZOLO",38,36,8,82,"2018","040"
"23748","BUBBIANO",0,28,0,28,"2018","035"
"23749","BUBBIO",52,0,0,52,"2018","011"
"23750","BUCCINASCO",7,556,0,563,"2018","036"
"23751","BUDRIO",199,236,0,435,"2018","008"
"23752","BUGLIO IN MONTE",29,198,32,259,"2018","010"
"23753","BULCIAGO",11,0,118,129,"2018","011"
"23754","BULGAROGRASSO",45,320,0,365,"2018","034"
"23755","BURIASCO",1089,722,144,1955,"2018","041"
"23756","BUROLO",14,0,0,14,"2018","042"
"23757","BURONZO",1,17,0,18,"2018","021"
"23758","BUSANO",12,36,0,48,"2018","043"
"23759","BUSCA",4687,1323,427,6437,"2018","034"
"23760","BUSCATE",70,0,0,70,"2018","038"
"23761","BUSNAGO",2,3,0,5,"2018",NA
"23762","BUSSERO",1,445,0,446,"2018","040"
"23763","BUSSETO",1,3771,0,3772,"2018","007"
"23764","BUSSOLENGO",436,111,290,837,"2018","015"
"23765","BUSSOLENO",34,227,0,261,"2018","044"
"23766","BUSTO ARSIZIO",29,160,58,247,"2018","026"
"23767","BUSTO GAROLFO",72,212,0,284,"2018","041"
"23768","BUTTAPIETRA",4,152,0,156,"2018","016"
"23769","BUTTIGLIERA ALTA",64,41,0,105,"2018","045"
"23770","BUTTIGLIERA D'ASTI",1964,106,94,2164,"2018","012"
"23771","CA' D'ANDREA",3,1617,0,1620,"2018","008"
"23772","CABELLA LIGURE",95,0,0,95,"2018","025"
"23773","CADEGLIANO-VICONAGO",3,0,0,3,"2018","027"
"23774","CADELBOSCO DI SOPRA",7,1638,0,1645,"2018","008"
"23775","CADEO",32,3106,0,3138,"2018","007"
"23776","CADONEGHE",13,0,14,27,"2018","016"
"23777","CADORAGO",8,0,44,52,"2018","036"
"23778","CADREZZATE",1,0,0,1,"2018","028"
"23779","CAERANO DI SAN MARCO",222,65,0,287,"2018","006"
"23780","CAFASSE",75,42,12,129,"2018","046"
"23781","CAGLIO",53,0,0,53,"2018","037"
"23782","CAGNO",0,29,0,29,"2018","038"
"23783","CAINO",9,0,0,9,"2018","031"
"23784","CAIOLO",3,69,0,72,"2018","011"
"23785","CAIRATE",2,0,0,2,"2018","029"
"23786","CALALZO DI CADORE",1,0,0,1,"2018",NA
"23787","CALAMANDRANA",69,0,0,69,"2018","013"
"23788","CALASCA-CASTIGLIONE",7,0,0,7,"2018","014"
"23789","CALCINATE",220,192,5,417,"2018","043"
"23790","CALCINATO",6873,1767,1336,9976,"2018","032"
"23791","CALCIO",180,1462,0,1642,"2018","044"
"23792","CALCO",13,193,0,206,"2018","012"
"23793","CALDERARA DI RENO",38,52,0,90,"2018","009"
"23794","CALDOGNO",238,331,0,569,"2018","018"
"23795","CALENDASCO",151,406,0,557,"2018","008"
"23796","CALESTANO",1,335,0,336,"2018","008"
"23797","CALLABIANA",19,0,0,19,"2018","008"
"23798","CALLIANO",154,0,0,154,"2018","014"
"23799","CALOLZIOCORTE",6,0,13,19,"2018","013"
"23800","CALOSSO",5,0,0,5,"2018","015"
"23801","CALTIGNAGA",1254,280,0,1534,"2018","030"
"23802","CALTO",19,0,0,19,"2018","008"
"23803","CALTRANO",1522,1,0,1523,"2018","019"
"23804","CALUSCO D'ADDA",11,0,0,11,"2018","046"
"23805","CALUSO",1023,146,0,1169,"2018","047"
"23806","CALVAGESE DELLA RIVIERA",167,214,3,384,"2018","033"
"23807","CALVATONE",16,123,0,139,"2018","009"
"23808","CALVENE",10,38,0,48,"2018","020"
"23809","CALVENZANO",34,622,0,656,"2018","047"
"23810","CALVIGNASCO",1,27,0,28,"2018","042"
"23811","CALVISANO",14607,4371,255,19233,"2018","034"
"23812","CAMAGNA MONFERRATO",20,0,0,20,"2018","026"
"23813","CAMANDONA",9,0,0,9,"2018","009"
"23814","CAMBIAGO",18,104,0,122,"2018","044"
"23815","CAMBIANO",354,0,0,354,"2018","048"
"23816","CAMBIASCA",8,0,0,8,"2018","015"
"23817","CAMBURZANO",81,0,10,91,"2018","010"
"23818","CAMERANA",339,0,2,341,"2018","035"
"23819","CAMERANO CASASCO",18,0,0,18,"2018","016"
"23820","CAMERATA CORNELLO",9,62,1,72,"2018","048"
"23821","CAMERI",95,573,8,676,"2018","032"
"23822","CAMISANO",255,2315,481,3051,"2018","010"
"23823","CAMISANO VICENTINO",293,1141,302,1736,"2018","021"
"23824","CAMPAGNA LUPIA",92,87,0,179,"2018","002"
"23825","CAMPAGNOLA CREMASCA",42,489,267,798,"2018","011"
"23826","CAMPAGNOLA EMILIA",5,785,100,890,"2018","009"
"23827","CAMPEGINE",0,1092,0,1092,"2018","010"
"23828","CAMPERTOGNO",59,46,0,105,"2018","025"
"23829","CAMPIGLIA CERVO",4,2,0,6,"2018","011"
"23830","CAMPIGLIA DEI BERICI",576,116,4,696,"2018","022"
"23831","CAMPIGLIONE-FENILE",566,1,60,627,"2018","049"
"23832","CAMPO SAN MARTINO",450,78,0,528,"2018","020"
"23833","CAMPODARSEGO",1023,48,1,1072,"2018","017"
"23834","CAMPODORO",69,188,0,257,"2018","018"
"23835","CAMPOGALLIANO",0,338,0,338,"2018","003"
"23836","CAMPOLONGO MAGGIORE",25,74,0,99,"2018","003"
"23837","CAMPOLONGO SUL BRENTA",5,0,0,5,"2018","023"
"23838","CAMPONOGARA",129,45,0,174,"2018","004"
"23839","CAMPOSAMPIERO",121,82,0,203,"2018","019"
"23840","CAMUGNANO",297,88,0,385,"2018","010"
"23841","CANALE",790,0,0,790,"2018","037"
"23842","CANARO",517,7,0,524,"2018","009"
"23843","CANDA",21,0,0,21,"2018","010"
"23844","CANDELO",63,50,81,194,"2018","012"
"23845","CANDIA CANAVESE",35,0,0,35,"2018","050"
"23846","CANDIANA",11176,219,0,11395,"2018","021"
"23847","CANDIOLO",121,451,133,705,"2018","051"
"23848","CANELLI",2,0,0,2,"2018","017"
"23849","CANEVINO",42,0,0,42,"2018","028"
"23850","CANISCHIO",11,30,0,41,"2018","052"
"23851","CANNETO SULL'OGLIO",1699,1528,1305,4532,"2018","008"
"23852","CANNOBIO",8,0,0,8,"2018","017"
"23853","CANONICA D'ADDA",15,446,0,461,"2018","049"
"23854","CANOSIO",8,0,107,115,"2018","038"
"23855","CANOSSA",39,272,0,311,"2018","018"
"23856","CANTALUPA",35,0,0,35,"2018","053"
"23857","CANTALUPO LIGURE",1,0,0,1,"2018","028"
"23858","CANTARANA",85,0,0,85,"2018","018"
"23859","CANTELLO",126,159,0,285,"2018","030"
"23860","CANTOIRA",97,16,15,128,"2018","054"
"23861","CANTU'",228,210,31,469,"2018","041"
"23862","CANZO",0,0,20,20,"2018","042"
"23863","CAORLE",728,29,49,806,"2018","005"
"23864","CAORSO",4,441,0,445,"2018","010"
"23865","CAPERGNANICA",286,1249,10,1545,"2018","012"
"23866","CAPIAGO INTIMIANO",3,20,0,23,"2018","043"
"23867","CAPIZZONE",28,14,0,42,"2018","050"
"23868","CAPO DI PONTE",10,151,1,162,"2018","035"
"23869","CAPONAGO",100,0,0,100,"2018",NA
"23870","CAPOVALLE",13,0,9,22,"2018","036"
"23871","CAPPELLA CANTONE",0,364,0,364,"2018","013"
"23872","CAPPELLA DE' PICENARDI",3,397,0,400,"2018","014"
"23873","CAPPELLA MAGGIORE",7,12,0,19,"2018","007"
"23874","CAPRALBA",116,1381,53,1550,"2018","015"
"23875","CAPRAUNA",2,0,0,2,"2018","039"
"23876","CAPRIANO DEL COLLE",14,385,0,399,"2018","037"
"23877","CAPRIATA D'ORBA",13,0,0,13,"2018","029"
"23878","CAPRIE",36,0,0,36,"2018","055"
"23879","CAPRIGLIO",3,0,0,3,"2018","019"
"23880","CAPRILE",27,0,0,27,"2018","013"
"23881","CAPRINO BERGAMASCO",14,12,0,26,"2018","052"
"23882","CAPRINO VERONESE",71,646,121,838,"2018","018"
"23883","CAPRIOLO",327,9,41,377,"2018","038"
"23884","CARAGLIO",3303,821,425,4549,"2018","040"
"23885","CARAMAGNA PIEMONTE",1906,672,20,2598,"2018","041"
"23886","CARATE BRIANZA",8,0,0,8,"2018",NA
"23887","CARAVAGGIO",450,2931,56,3437,"2018","053"
"23888","CARAVATE",4,105,0,109,"2018","031"
"23889","CARBONARA AL TICINO",0,255,0,255,"2018","030"
"23890","CARBONARA DI PO",0,262,290,552,"2018","009"
"23891","CARBONARA SCRIVIA",44,0,0,44,"2018","030"
"23892","CARBONATE",141,50,13,204,"2018","045"
"23893","CARBONERA",60,238,61,359,"2018","008"
"23894","CARCERI",1137,0,0,1137,"2018","022"
"23895","CARCOFORO",0,0,6,6,"2018","029"
"23896","CARDANO AL CAMPO",11,0,0,11,"2018","032"
"23897","CARDE'",2792,1888,22,4702,"2018","042"
"23898","CAREMA",81,14,0,95,"2018","057"
"23899","CARENNO",26,0,6,32,"2018","014"
"23900","CARENTINO",91,562,0,653,"2018","031"
"23901","CARESANA",1,0,0,1,"2018","030"
"23902","CAREZZANO",4,0,0,4,"2018","032"
"23903","CARIGNANO",2860,1514,344,4718,"2018","058"
"23904","CARISIO",32,0,0,32,"2018","032"
"23905","CARLAZZO",24,55,17,96,"2018","047"
"23906","CARMAGNOLA",6442,2935,0,9377,"2018","059"
"23907","CARMIGNANO DI BRENTA",251,1356,0,1607,"2018","023"
"23908","CARNAGO",23,50,0,73,"2018","033"
"23909","CAROBBIO DEGLI ANGELI",75,32,11,118,"2018","055"
"23910","CARONNO PERTUSELLA",4,0,0,4,"2018","034"
"23911","CARONNO VARESINO",45,0,0,45,"2018","035"
"23912","CARPANETO PIACENTINO",112,4582,0,4694,"2018","011"
"23913","CARPENEDOLO",1691,4134,198,6023,"2018","039"
"23914","CARPENETO",123,0,0,123,"2018","033"
"23915","CARPI",5,1957,0,1962,"2018","005"
"23916","CARPIANO",126,1311,242,1679,"2018","050"
"23917","CARPIGNANO SESIA",122,1,0,123,"2018","036"
"23918","CARPINETI",96,1217,0,1313,"2018","011"
"23919","CARRE'",256,122,0,378,"2018","024"
"23920","CARREGA LIGURE",51,0,0,51,"2018","034"
"23921","CARRU'",717,40,86,843,"2018","043"
"23922","CARTIGLIANO",18,17,0,35,"2018","025"
"23923","CARTIGNANO",144,70,0,214,"2018","044"
"23924","CARTOSIO",48,0,0,48,"2018","036"
"23925","CARTURA",425,27,0,452,"2018","026"
"23926","CARUGATE",7,83,0,90,"2018","051"
"23927","CARUGO",3,0,0,3,"2018","048"
"23928","CARVICO",3,0,0,3,"2018","057"
"23929","CASAL CERMELLI",2,0,0,2,"2018","037"
"23930","CASALBELTRAME",1,0,186,187,"2018","037"
"23931","CASALBORGONE",45,0,0,45,"2018","060"
"23932","CASALBUTTANO ED UNITI",7,1812,0,1819,"2018","016"
"23933","CASALE CORTE CERRO",16,0,0,16,"2018","019"
"23934","CASALE CREMASCO-VIDOLASCO",0,1808,0,1808,"2018","017"
"23935","CASALE DI SCODOSIA",660,0,0,660,"2018","027"
"23936","CASALE LITTA",28,160,18,206,"2018","036"
"23937","CASALE MONFERRATO",124,172,0,296,"2018","039"
"23938","CASALE SUL SILE",721,86,18,825,"2018","009"
"23939","CASALEGGIO BOIRO",29,0,0,29,"2018","038"
"23940","CASALEONE",130,0,0,130,"2018","019"
"23941","CASALETTO CEREDANO",13,11,0,24,"2018","018"
"23942","CASALETTO DI SOPRA",11,341,0,352,"2018","019"
"23943","CASALETTO LODIGIANO",64,306,0,370,"2018","008"
"23944","CASALETTO VAPRIO",153,597,0,750,"2018","020"
"23945","CASALFIUMANESE",365,166,0,531,"2018","012"
"23946","CASALGRANDE",18,1071,0,1089,"2018","012"
"23947","CASALGRASSO",295,365,0,660,"2018","045"
"23948","CASALINO",6,247,0,253,"2018","040"
"23949","CASALMAGGIORE",5,694,0,699,"2018","021"
"23950","CASALMAIOCCO",15,468,0,483,"2018","009"
"23951","CASALMORANO",108,2357,194,2659,"2018","022"
"23952","CASALMORO",535,0,547,1082,"2018","010"
"23953","CASALNOCETO",24,0,0,24,"2018","040"
"23954","CASALOLDO",910,1155,1101,3166,"2018","011"
"23955","CASALPUSTERLENGO",0,1180,0,1180,"2018","010"
"23956","CASALROMANO",255,333,187,775,"2018","012"
"23957","CASALSERUGO",78,9,0,87,"2018","028"
"23958","CASALVOLONE",1,51,0,52,"2018","041"
"23959","CASALZUIGNO",2,112,0,114,"2018","037"
"23960","CASARGO",4,18,1,23,"2018","015"
"23961","CASARILE",53,0,0,53,"2018","055"
"23962","CASATENOVO",360,19,0,379,"2018","016"
"23963","CASAZZA",6,17,2,25,"2018","058"
"23964","CASCIAGO",13,0,34,47,"2018","038"
"23965","CASEI GEROLA",424,0,0,424,"2018","033"
"23966","CASELETTE",107,335,34,476,"2018","062"
"23967","CASELLE LANDI",290,454,0,744,"2018","011"
"23968","CASELLE LURANI",50,322,0,372,"2018","012"
"23969","CASELLE TORINESE",393,1278,22,1693,"2018","063"
"23970","CASIER",10,100,0,110,"2018","010"
"23971","CASINA",92,920,0,1012,"2018","013"
"23972","CASIRATE D'ADDA",105,364,0,469,"2018","059"
"23973","CASLINO D'ERBA",11,0,2,13,"2018","052"
"23974","CASNATE CON BERNATE",36,0,0,36,"2018","053"
"23975","CASNIGO",33,118,0,151,"2018","060"
"23976","CASOLA VALSENIO",168,18,0,186,"2018","005"
"23977","CASORATE PRIMO",5,139,0,144,"2018","034"
"23978","CASOREZZO",0,349,0,349,"2018","058"
"23979","CASORZO",1,0,0,1,"2018","020"
"23980","CASPOGGIO",2,33,0,35,"2018","013"
"23981","CASSAGO BRIANZA",7,44,2,53,"2018","017"
"23982","CASSANO D'ADDA",105,283,0,388,"2018","059"
"23983","CASSANO MAGNAGO",11,114,37,162,"2018","040"
"23984","CASSANO SPINOLA",261,0,0,261,"2018","042"
"23985","CASSANO VALCUVIA",3,0,0,3,"2018","041"
"23986","CASSINA DE' PECCHI",0,364,0,364,"2018","060"
"23987","CASSINA RIZZARDI",2,0,0,2,"2018","055"
"23988","CASSINA VALSASSINA",9,48,0,57,"2018","018"
"23989","CASSINASCO",22,21,0,43,"2018","021"
"23990","CASSINE",290,0,0,290,"2018","043"
"23991","CASSINELLE",3,0,0,3,"2018","044"
"23992","CASSINETTA DI LUGAGNANO",2,223,0,225,"2018","061"
"23993","CASSOLA",651,23,0,674,"2018","026"
"23994","CASSOLNOVO",0,37,0,37,"2018","035"
"23995","CASTAGNARO",100,0,0,100,"2018","020"
"23996","CASTAGNETO PO",54,0,0,54,"2018","064"
"23997","CASTAGNITO",161,0,0,161,"2018","046"
"23998","CASTAGNOLE DELLE LANZE",255,0,0,255,"2018","022"
"23999","CASTAGNOLE MONFERRATO",46,0,0,46,"2018","023"
"24000","CASTAGNOLE PIEMONTE",1373,822,68,2263,"2018","065"
"24001","CASTANA",3,0,0,3,"2018","036"
"24002","CASTANO PRIMO",74,0,0,74,"2018","062"
"24003","CASTEGGIO",10,0,0,10,"2018","037"
"24004","CASTEGNATO",18,1001,29,1048,"2018","040"
"24005","CASTEGNERO",20,63,0,83,"2018","027"
"24006","CASTEL BOGLIONE",16,0,0,16,"2018","024"
"24007","CASTEL BOLOGNESE",26,0,0,26,"2018","006"
"24008","CASTEL D'AIANO",20,631,0,651,"2018","013"
"24009","CASTEL D'ARIO",187,21,1170,1378,"2018","014"
"24010","CASTEL D'AZZANO",1694,106,0,1800,"2018","021"
"24011","CASTEL DEL RIO",40,0,0,40,"2018","014"
"24012","CASTEL DI CASIO",50,23,0,73,"2018","015"
"24013","CASTEL GABBIANO",0,1759,0,1759,"2018","024"
"24014","CASTEL GOFFREDO",2023,459,657,3139,"2018","015"
"24015","CASTEL GUELFO DI BOLOGNA",117,266,0,383,"2018","016"
"24016","CASTEL MELLA",4,382,0,386,"2018","042"
"24017","CASTEL ROCCHERO",4,0,0,4,"2018","032"
"24018","CASTEL ROZZONE",2,29,0,31,"2018","063"
"24019","CASTEL SAN GIOVANNI",188,773,0,961,"2018","013"
"24020","CASTEL SAN PIETRO TERME",620,316,0,936,"2018","020"
"24021","CASTELBELFORTE",1720,0,0,1720,"2018","013"
"24022","CASTELCOVATI",11,331,0,342,"2018","041"
"24023","CASTELCUCCO",56,192,0,248,"2018","011"
"24024","CASTELDELCI",217,0,0,217,"2018","021"
"24025","CASTELDELFINO",42,0,0,42,"2018","047"
"24026","CASTELDIDONE",55,0,0,55,"2018","023"
"24027","CASTELFRANCO EMILIA",2181,2662,0,4843,"2018","006"
"24028","CASTELFRANCO VENETO",4505,180,10,4695,"2018","012"
"24029","CASTELGERUNDO",28,1852,0,1880,"2018",NA
"24030","CASTELGOMBERTO",308,427,0,735,"2018","028"
"24031","CASTELGUGLIELMO",503,0,0,503,"2018","011"
"24032","CASTELL'ALFERO",408,0,0,408,"2018","025"
"24033","CASTELL'ARQUATO",77,745,0,822,"2018","012"
"24034","CASTELLAMONTE",323,263,19,605,"2018","066"
"24035","CASTELLAR",8,0,0,8,"2018","048"
"24036","CASTELLARANO",24,330,0,354,"2018","014"
"24037","CASTELLAZZO BORMIDA",136,61,0,197,"2018","047"
"24038","CASTELLAZZO NOVARESE",1,0,0,1,"2018","042"
"24039","CASTELLEONE",680,3759,136,4575,"2018","025"
"24040","CASTELLERO",1,0,0,1,"2018","026"
"24041","CASTELLETTO CERVO",18,29,0,47,"2018","015"
"24042","CASTELLETTO D'ERRO",1,0,0,1,"2018",NA
"24043","CASTELLETTO D'ORBA",6,0,0,6,"2018","049"
"24044","CASTELLETTO DI BRANDUZZO",11,0,0,11,"2018","038"
"24045","CASTELLETTO MERLI",71,0,0,71,"2018","050"
"24046","CASTELLETTO MONFERRATO",100,0,0,100,"2018","051"
"24047","CASTELLETTO SOPRA TICINO",121,45,0,166,"2018","043"
"24048","CASTELLETTO STURA",1583,38,57,1678,"2018","049"
"24049","CASTELLETTO UZZONE",0,0,2,2,"2018","050"
"24050","CASTELLI CALEPIO",36,205,0,241,"2018","062"
"24051","CASTELLINALDO D'ALBA",902,0,0,902,"2018",NA
"24052","CASTELLINO TANARO",152,0,0,152,"2018","052"
"24053","CASTELLO CABIAGLIO",13,0,0,13,"2018","043"
"24054","CASTELLO D'ARGILE",62,0,0,62,"2018","017"
"24055","CASTELLO DELL'ACQUA",21,10,0,31,"2018","014"
"24056","CASTELLO DI ANNONE",114,0,0,114,"2018","028"
"24057","CASTELLO DI BRIANZA",13,0,0,13,"2018","019"
"24058","CASTELLO DI GODEGO",6554,126,0,6680,"2018","013"
"24059","CASTELLUCCHIO",833,1640,1857,4330,"2018","016"
"24060","CASTELMAGNO",71,4,7,82,"2018","053"
"24061","CASTELMARTE",7,0,1,8,"2018","058"
"24062","CASTELMASSA",0,122,0,122,"2018","012"
"24063","CASTELNOVO BARIANO",2201,45,0,2246,"2018","013"
"24064","CASTELNOVO DI SOTTO",9,1202,0,1211,"2018","015"
"24065","CASTELNOVO NE' MONTI",75,1380,0,1455,"2018","016"
"24066","CASTELNUOVO BOCCA D'ADDA",2909,325,0,3234,"2018","013"
"24067","CASTELNUOVO BORMIDA",20,0,0,20,"2018","052"
"24068","CASTELNUOVO BOZZENTE",8,23,0,31,"2018","059"
"24069","CASTELNUOVO CALCEA",17,0,0,17,"2018","030"
"24070","CASTELNUOVO DEL GARDA",3580,227,2,3809,"2018","022"
"24071","CASTELNUOVO DON BOSCO",157,0,0,157,"2018","031"
"24072","CASTELNUOVO NIGRA",53,0,0,53,"2018","067"
"24073","CASTELNUOVO RANGONE",8,868,0,876,"2018","007"
"24074","CASTELNUOVO SCRIVIA",109,0,19,128,"2018","053"
"24075","CASTELSEPRIO",3,0,3,6,"2018","044"
"24076","CASTELSPINA",9,0,0,9,"2018","054"
"24077","CASTELVECCANA",6,0,0,6,"2018","045"
"24078","CASTELVERDE",346,3493,94,3933,"2018","026"
"24079","CASTELVETRO DI MODENA",27,1045,0,1072,"2018","008"
"24080","CASTELVETRO PIACENTINO",1042,1004,0,2046,"2018","014"
"24081","CASTELVISCONTI",13,1748,48,1809,"2018","027"
"24082","CASTENASO",141,119,0,260,"2018","021"
"24083","CASTENEDOLO",1056,1358,6,2420,"2018","043"
"24084","CASTIGLIONE D'ADDA",3,315,0,318,"2018","014"
"24085","CASTIGLIONE DEI PEPOLI",113,74,0,187,"2018","022"
"24086","CASTIGLIONE DELLE STIVIERE",4379,1930,1335,7644,"2018","017"
"24087","CASTIGLIONE FALLETTO",35,0,0,35,"2018","055"
"24088","CASTIGLIONE OLONA",4,0,10,14,"2018","046"
"24089","CASTIGLIONE TINELLA",37,0,0,37,"2018","056"
"24090","CASTIGLIONE TORINESE",17,0,0,17,"2018","068"
"24091","CASTINO",130,0,0,130,"2018","057"
"24092","CASTIONE ANDEVENNO",13,45,0,58,"2018","015"
"24093","CASTIONE DELLA PRESOLANA",17,15,2,34,"2018","064"
"24094","CASTIRAGA VIDARDO",7,272,0,279,"2018","015"
"24095","CASTO",22,28,2,52,"2018","044"
"24096","CASTREZZATO",422,1093,47,1562,"2018","045"
"24097","CASTROCARO TERME E TERRA DEL SOLE",14,1,0,15,"2018","005"
"24098","CASTRONNO",3,0,0,3,"2018","047"
"24099","CAVAGLIA'",1252,175,0,1427,"2018","016"
"24100","CAVAGLIETTO",3,189,0,192,"2018","044"
"24101","CAVAGNOLO",32,0,0,32,"2018","069"
"24102","CAVAION VERONESE",5,0,0,5,"2018","023"
"24103","CAVALLERLEONE",458,1176,82,1716,"2018","058"
"24104","CAVALLERMAGGIORE",2083,2250,41,4374,"2018","059"
"24105","CAVALLINO-TREPORTI",9,0,0,9,"2018","044"
"24106","CAVALLIRIO",4,0,0,4,"2018","047"
"24107","CAVARGNA",0,0,9,9,"2018","062"
"24108","CAVARIA CON PREMEZZO",5,0,2,7,"2018","048"
"24109","CAVARZERE",6082,0,4,6086,"2018","006"
"24110","CAVASO DEL TOMBA",78,74,0,152,"2018","014"
"24111","CAVATORE",3,0,0,3,"2018","055"
"24112","CAVENAGO D'ADDA",11,640,139,790,"2018","017"
"24113","CAVERNAGO",1,0,0,1,"2018","066"
"24114","CAVEZZO",0,377,0,377,"2018","009"
"24115","CAVOUR",3541,244,1117,4902,"2018","070"
"24116","CAVRIAGO",22,661,0,683,"2018","017"
"24117","CAVRIANA",2050,1487,453,3990,"2018","018"
"24118","CAZZAGO SAN MARTINO",3750,213,243,4206,"2018","046"
"24119","CAZZANO DI TRAMIGNA",18,0,0,18,"2018","024"
"24120","CAZZANO SANT'ANDREA",335,0,0,335,"2018","067"
"24121","CECIMA",33,0,0,33,"2018","042"
"24122","CEDEGOLO",0,23,4,27,"2018","047"
"24123","CEDRASCO",0,68,0,68,"2018","016"
"24124","CEGGIA",15,1,0,16,"2018","007"
"24125","CELLA DATI",1482,96,36,1614,"2018","028"
"24126","CELLA MONTE",102,0,0,102,"2018","056"
"24127","CELLARENGO",236,78,160,474,"2018","033"
"24128","CELLATICA",1,56,0,57,"2018","048"
"24129","CELLE DI MACRA",106,0,9,115,"2018","060"
"24130","CELLE ENOMONDO",197,0,0,197,"2018","034"
"24131","CELLIO CON BREIA",13,0,0,13,"2018",NA
"24132","CENATE SOPRA",12,8,0,20,"2018","068"
"24133","CENATE SOTTO",17,0,2,19,"2018","069"
"24134","CENCENIGHE AGORDINO",0,8,0,8,"2018","010"
"24135","CENE",30,48,0,78,"2018","070"
"24136","CENESELLI",0,242,28,270,"2018","014"
"24137","CENTALLO",5544,713,470,6727,"2018","061"
"24138","CENTO",1,0,0,1,"2018","004"
"24139","CENTRO VALLE INTELVI",53,7,14,74,"2018",NA
"24140","CEPPO MORELLI",17,0,5,22,"2018","021"
"24141","CERANO",85,0,0,85,"2018","049"
"24142","CERANO D'INTELVI",9,0,31,40,"2018","063"
"24143","CERANOVA",0,558,0,558,"2018","043"
"24144","CERCENASCO",147,263,0,410,"2018","071"
"24145","CERCINO",11,52,0,63,"2018","017"
"24146","CEREA",1156,219,0,1375,"2018","025"
"24147","CERES",6,0,0,6,"2018","072"
"24148","CERESARA",1728,375,116,2219,"2018","019"
"24149","CERESETO",114,0,0,114,"2018","057"
"24150","CERESOLE ALBA",3382,644,0,4026,"2018","062"
"24151","CERESOLE REALE",0,28,0,28,"2018","073"
"24152","CERETE",24,139,0,163,"2018","071"
"24153","CERETTO LOMELLINA",1,0,0,1,"2018","044"
"24154","CERIANO LAGHETTO",0,49,0,49,"2018",NA
"24155","CERIGNALE",29,0,0,29,"2018","015"
"24156","CERMENATE",2,173,4,179,"2018","064"
"24157","CERNOBBIO",1,0,0,1,"2018",NA
"24158","CERNUSCO LOMBARDONE",12,0,0,12,"2018","020"
"24159","CERNUSCO SUL NAVIGLIO",10,180,0,190,"2018","070"
"24160","CERRETO CASTELLO",120,0,0,120,"2018","017"
"24161","CERRETO D'ASTI",1,0,0,1,"2018","035"
"24162","CERRETO GRUE",22,0,0,22,"2018","058"
"24163","CERRETTO LANGHE",12,0,0,12,"2018","063"
"24164","CERRINA MONFERRATO",35,6,14,55,"2018","059"
"24165","CERRIONE",78,375,0,453,"2018","018"
"24166","CERRO AL LAMBRO",1,609,0,610,"2018","071"
"24167","CERRO MAGGIORE",8,75,0,83,"2018","072"
"24168","CERRO TANARO",24,0,0,24,"2018","036"
"24169","CERRO VERONESE",23,196,0,219,"2018","026"
"24170","CERTOSA DI PAVIA",9,0,0,9,"2018","046"
"24171","CERVARESE SANTA CROCE",18,184,41,243,"2018","030"
"24172","CERVASCA",1261,304,33,1598,"2018","064"
"24173","CERVENO",1,18,4,23,"2018","049"
"24174","CERVERE",1606,157,221,1984,"2018","065"
"24175","CERVIGNANO D'ADDA",0,899,0,899,"2018","018"
"24176","CESANA BRIANZA",5,17,0,22,"2018","021"
"24177","CESANA TORINESE",39,0,34,73,"2018","074"
"24178","CESANO BOSCONE",0,100,0,100,"2018","074"
"24179","CESARA",1,0,0,1,"2018","022"
"24180","CESENA",91,25,0,116,"2018","007"
"24181","CESIOMAGGIORE",219,124,0,343,"2018","011"
"24182","CESSALTO",25,125,0,150,"2018","015"
"24183","CESSOLE",166,0,0,166,"2018","037"
"24184","CETO",6,24,53,83,"2018","050"
"24185","CEVA",409,0,0,409,"2018","066"
"24186","CEVO",32,5,1,38,"2018","051"
"24187","CHERASCO",5224,985,126,6335,"2018","067"
"24188","CHIALAMBERTO",10,0,45,55,"2018","075"
"24189","CHIAMPO",24,67,0,91,"2018","029"
"24190","CHIANOCCO",23,0,0,23,"2018","076"
"24191","CHIARANO",8,359,2,369,"2018","016"
"24192","CHIARI",1233,5336,345,6914,"2018","052"
"24193","CHIAVENNA",4,0,4,8,"2018","018"
"24194","CHIAVERANO",21,0,0,21,"2018","077"
"24195","CHIERI",2808,530,62,3400,"2018","078"
"24196","CHIES D'ALPAGO",15,9,0,24,"2018","012"
"24197","CHIESA IN VALMALENCO",24,48,0,72,"2018","019"
"24198","CHIESANUOVA",101,12,0,113,"2018","079"
"24199","CHIEVE",137,906,0,1043,"2018","029"
"24200","CHIGNOLO D'ISOLA",87,397,0,484,"2018","072"
"24201","CHIGNOLO PO",18,85,0,103,"2018","048"
"24202","CHIOGGIA",3067,0,0,3067,"2018","008"
"24203","CHIOMONTE",0,23,0,23,"2018","080"
"24204","CHIUDUNO",30,1,0,31,"2018","073"
"24205","CHIUPPANO",0,26,0,26,"2018","030"
"24206","CHIURO",20,78,0,98,"2018","020"
"24207","CHIUSA DI PESIO",1629,320,17,1966,"2018","068"
"24208","CHIUSA DI SAN MICHELE",0,0,55,55,"2018","081"
"24209","CHIUSANO D'ASTI",7,0,0,7,"2018","038"
"24210","CHIVASSO",1335,266,0,1601,"2018","082"
"24211","CICOGNOLO",0,1038,0,1038,"2018","030"
"24212","CICONIO",60,86,0,146,"2018","083"
"24213","CIGLIANO",263,75,37,375,"2018","042"
"24214","CIGLIE'",416,0,0,416,"2018","069"
"24215","CIGOGNOLA",2,0,0,2,"2018","049"
"24216","CIGOLE",1779,1513,0,3292,"2018","053"
"24217","CILAVEGNA",6,15,0,21,"2018","050"
"24218","CIMADOLMO",348,61,0,409,"2018","017"
"24219","CIMBERGO",1,2,0,3,"2018","054"
"24220","CINAGLIO",699,0,0,699,"2018","039"
"24221","CINGIA DE' BOTTI",1,942,0,943,"2018","031"
"24222","CINO",7,11,0,18,"2018","021"
"24223","CINTANO",31,0,0,31,"2018","084"
"24224","CINTO CAOMAGGIORE",459,3,31,493,"2018","009"
"24225","CINTO EUGANEO",75,28,0,103,"2018","031"
"24226","CINZANO",12,0,0,12,"2018","085"
"24227","CIRIE'",413,206,43,662,"2018","086"
"24228","CIRIMIDO",6,39,0,45,"2018","068"
"24229","CISANO BERGAMASCO",20,0,0,20,"2018","074"
"24230","CISERANO",18,42,0,60,"2018","075"
"24231","CISLAGO",6,0,0,6,"2018","050"
"24232","CISLIANO",167,516,0,683,"2018","078"
"24233","CISMON DEL GRAPPA",2,30,2,34,"2018","031"
"24234","CISON DI VALMARINO",93,6,0,99,"2018","018"
"24235","CISSONE",8,0,0,8,"2018","070"
"24236","CISTERNA D'ASTI",90,0,0,90,"2018","040"
"24237","CITTADELLA",2072,1033,101,3206,"2018","032"
"24238","CITTIGLIO",5,10,0,15,"2018","051"
"24239","CIVATE",7,0,0,7,"2018","022"
"24240","CIVIASCO",1,3,0,4,"2018","043"
"24241","CIVIDATE AL PIANO",984,533,0,1517,"2018","076"
"24242","CIVIDATE CAMUNO",2,0,0,2,"2018","055"
"24243","CIVITELLA DI ROMAGNA",448,16,28,492,"2018","009"
"24244","CIVO",6,17,0,23,"2018","022"
"24245","CLAINO CON OSTENO",1,0,2,3,"2018","071"
"24246","CLAVESANA",426,0,0,426,"2018","071"
"24247","CLIVIO",13,65,0,78,"2018","052"
"24248","CLUSONE",66,175,4,245,"2018","077"
"24249","COASSOLO TORINESE",33,31,1,65,"2018","088"
"24250","COAZZE",12,0,10,22,"2018","089"
"24251","COAZZOLO",25,0,0,25,"2018","041"
"24252","COCCAGLIO",163,876,107,1146,"2018","056"
"24253","COCCONATO",60,0,0,60,"2018","042"
"24254","COCQUIO-TREVISAGO",20,0,0,20,"2018","053"
"24255","CODEVIGO",251,105,2,358,"2018","033"
"24256","CODIGORO",3717,180,0,3897,"2018","005"
"24257","CODOGNE'",41,229,7,277,"2018","019"
"24258","CODOGNO",1,955,0,956,"2018","019"
"24259","COGGIOLA",5,0,0,5,"2018","019"
"24260","COGLIATE",77,0,0,77,"2018",NA
"24261","COGOLLO DEL CENGIO",373,104,0,477,"2018","032"
"24262","COLERE",4,0,0,4,"2018","078"
"24263","COLI",68,0,0,68,"2018","016"
"24264","COLICO",66,98,41,205,"2018","023"
"24265","COLLE BRIANZA",3,0,1,4,"2018","024"
"24266","COLLE SANTA LUCIA",0,8,0,8,"2018","014"
"24267","COLLE UMBERTO",25,111,17,153,"2018","020"
"24268","COLLECCHIO",6,2489,0,2495,"2018","009"
"24269","COLLEGNO",122,310,5,437,"2018","090"
"24270","COLLERETTO CASTELNUOVO",6,26,0,32,"2018","091"
"24271","COLLERETTO GIACOSA",14,0,0,14,"2018","092"
"24272","COLLIO",40,73,10,123,"2018","058"
"24273","COLOGNA VENETA",9770,204,0,9974,"2018","027"
"24274","COLOGNE",465,643,1,1109,"2018","059"
"24275","COLOGNO AL SERIO",34,929,10,973,"2018","079"
"24276","COLORINA",42,374,0,416,"2018","023"
"24277","COLORNO",0,1272,0,1272,"2018","010"
"24278","COLTURANO",0,11,0,11,"2018","082"
"24279","COLVERDE",17,111,9,137,"2018",NA
"24280","COLZATE",23,24,0,47,"2018","080"
"24281","COMACCHIO",484,180,0,664,"2018","006"
"24282","COMAZZO",35,911,2,948,"2018","020"
"24283","COMELICO SUPERIORE",14,144,0,158,"2018","015"
"24284","COMERIO",4,0,0,4,"2018","055"
"24285","COMEZZANO-CIZZAGO",134,1896,11,2041,"2018","060"
"24286","COMMESSAGGIO",0,8,18,26,"2018","020"
"24287","COMO",6,57,18,81,"2018","075"
"24288","COMPIANO",14,33,0,47,"2018","011"
"24289","COMUN NUOVO",35,20,0,55,"2018","081"
"24290","CONA",14757,0,0,14757,"2018","010"
"24291","CONCAMARISE",0,245,0,245,"2018","029"
"24292","CONCESIO",20,8,0,28,"2018","061"
"24293","CONCO",27,185,0,212,"2018","033"
"24294","CONCORDIA SAGITTARIA",1084,0,0,1084,"2018","011"
"24295","CONCORDIA SULLA SECCHIA",6,364,0,370,"2018","010"
"24296","CONCOREZZO",4,23,0,27,"2018",NA
"24297","CONDOVE",129,15,47,191,"2018","093"
"24298","CONEGLIANO",23,41,7,71,"2018","021"
"24299","CONFIENZA",26,22,101,149,"2018","052"
"24300","CONIOLO",152,0,0,152,"2018","060"
"24301","CONSELICE",519,221,0,740,"2018","008"
"24302","CONSELVE",1102,26,0,1128,"2018","034"
"24303","CONZANO",113,0,0,113,"2018","061"
"24304","COPPARO",163,0,0,163,"2018","007"
"24305","CORBETTA",949,59,5,1013,"2018","085"
"24306","CORBOLA",50,127,0,177,"2018","017"
"24307","CORDIGNANO",65,154,0,219,"2018","022"
"24308","CORIANO",33,123,0,156,"2018","003"
"24309","CORIO",134,38,0,172,"2018","094"
"24310","CORNA IMAGNA",17,46,0,63,"2018","082"
"24311","CORNALBA",3,13,0,16,"2018","249"
"24312","CORNAREDO",1,202,12,215,"2018","087"
"24313","CORNATE D'ADDA",17,93,0,110,"2018",NA
"24314","CORNEDO VICENTINO",5,157,0,162,"2018","034"
"24315","CORNEGLIANO LAUDENSE",0,187,0,187,"2018","021"
"24316","CORNELIANO D'ALBA",155,0,0,155,"2018","072"
"24317","CORNIGLIO",39,454,0,493,"2018","012"
"24318","CORNO GIOVINE",208,59,0,267,"2018","022"
"24319","CORNOVECCHIO",125,0,0,125,"2018","023"
"24320","CORNUDA",939,433,0,1372,"2018","023"
"24321","CORREGGIO",1,2079,0,2080,"2018","020"
"24322","CORREZZANA",1,34,2,37,"2018",NA
"24323","CORREZZOLA",4964,24,0,4988,"2018","035"
"24324","CORRIDO",41,22,3,66,"2018","077"
"24325","CORSIONE",8,0,0,8,"2018","044"
"24326","CORTANZE",84,0,0,84,"2018","046"
"24327","CORTAZZONE",9,0,0,9,"2018","047"
"24328","CORTE BRUGNATELLA",113,13,0,126,"2018","017"
"24329","CORTE DE' CORTESI CON CIGNONE",1,1,195,197,"2018","032"
"24330","CORTE DE' FRATI",0,781,275,1056,"2018","033"
"24331","CORTE FRANCA",101,45,15,161,"2018","062"
"24332","CORTE PALASIO",6,1826,20,1852,"2018","024"
"24333","CORTEMAGGIORE",167,1834,0,2001,"2018","018"
"24334","CORTEMILIA",235,0,0,235,"2018","073"
"24335","CORTENO GOLGI",12,101,21,134,"2018","063"
"24336","CORTENOVA",3,41,3,47,"2018","025"
"24337","CORTENUOVA",173,1336,0,1509,"2018","083"
"24338","CORTEOLONA E GENZONE",187,91,0,278,"2018",NA
"24339","CORTIGLIONE",1,0,0,1,"2018","048"
"24340","CORTINA D'AMPEZZO",8,37,0,45,"2018","016"
"24341","CORVINO SAN QUIRICO",2,0,0,2,"2018","057"
"24342","CORZANO",124,225,0,349,"2018","064"
"24343","COSIO VALTELLINO",34,578,0,612,"2018","024"
"24344","COSSANO BELBO",392,0,0,392,"2018","074"
"24345","COSSATO",242,165,6,413,"2018","020"
"24346","COSTA DE' NOBILI",35,22,3,60,"2018","058"
"24347","COSTA DI MEZZATE",28,0,0,28,"2018","084"
"24348","COSTA DI ROVIGO",2,283,0,285,"2018","018"
"24349","COSTA MASNAGA",20,0,0,20,"2018","026"
"24350","COSTA SERINA",11,4,0,15,"2018","247"
"24351","COSTA VALLE IMAGNA",5,0,0,5,"2018","085"
"24352","COSTA VESCOVATO",36,0,0,36,"2018","062"
"24353","COSTA VOLPINO",22,19,0,41,"2018","086"
"24354","COSTABISSARA",21,34,0,55,"2018","035"
"24355","COSTERMANO",19,53,0,72,"2018","030"
"24356","COSTIGLIOLE D'ASTI",457,2,0,459,"2018","050"
"24357","COSTIGLIOLE SALUZZO",480,44,21,545,"2018","075"
"24358","COTIGNOLA",103,0,0,103,"2018","009"
"24359","COVO",506,1118,0,1624,"2018","087"
"24360","COZZO",2,0,0,2,"2018",NA
"24361","CRANDOLA VALSASSINA",1,6,4,11,"2018","027"
"24362","CRAVAGLIANA",0,25,0,25,"2018","048"
"24363","CRAVANZANA",2,0,0,2,"2018","076"
"24364","CRAVEGGIA",13,0,0,13,"2018","024"
"24365","CREAZZO",15,23,0,38,"2018","036"
"24366","CREDARO",7,138,0,145,"2018","088"
"24367","CREDERA RUBBIANO",0,1154,328,1482,"2018","034"
"24368","CREMA",342,1763,475,2580,"2018","035"
"24369","CREMELLA",6,0,0,6,"2018","028"
"24370","CREMENO",0,31,42,73,"2018","029"
"24371","CREMIA",2,0,5,7,"2018","083"
"24372","CREMOLINO",71,0,0,71,"2018","063"
"24373","CREMONA",84,1366,0,1450,"2018","036"
"24374","CREMOSANO",39,497,0,536,"2018","037"
"24375","CRESCENTINO",90,0,44,134,"2018","049"
"24376","CRESPADORO",29,77,0,106,"2018","037"
"24377","CRESPANO DEL GRAPPA",1104,758,0,1862,"2018","024"
"24378","CRESPIATICA",0,391,0,391,"2018","025"
"24379","CRESPINO",2084,0,0,2084,"2018","019"
"24380","CRESSA",45,241,0,286,"2018","055"
"24381","CREVACUORE",1,0,0,1,"2018","021"
"24382","CREVALCORE",257,27,0,284,"2018","024"
"24383","CREVOLADOSSOLA",92,42,0,134,"2018","025"
"24384","CROCETTA DEL MONTELLO",82,47,0,129,"2018","025"
"24385","CRODO",8,97,24,129,"2018","026"
"24386","CROSIO DELLA VALLE",2,0,0,2,"2018","057"
"24387","CROTTA D'ADDA",4,571,0,575,"2018","038"
"24388","CUASSO AL MONTE",21,0,0,21,"2018","058"
"24389","CUCCARO MONFERRATO",3,0,0,3,"2018","064"
"24390","CUCCIAGO",2,0,0,2,"2018","084"
"24391","CUCEGLIO",56,0,0,56,"2018","096"
"24392","CUGGIONO",506,67,0,573,"2018","096"
"24393","CUMIANA",1316,586,14,1916,"2018","097"
"24394","CUMIGNANO SUL NAVIGLIO",0,1361,0,1361,"2018","039"
"24395","CUNARDO",3,0,0,3,"2018","060"
"24396","CUNEO",7878,955,986,9819,"2018","078"
"24397","CUNICO",1526,0,0,1526,"2018","051"
"24398","CUORGNE'",175,61,0,236,"2018","098"
"24399","CURA CARPIGNANO",16,138,1,155,"2018","060"
"24400","CUREGGIO",23,29,0,52,"2018","058"
"24401","CURIGLIA CON MONTEVIASCO",3,0,2,5,"2018","061"
"24402","CURINO",6,0,0,6,"2018","023"
"24403","CURNO",56,29,6,91,"2018","089"
"24404","CURTAROLO",82,241,0,323,"2018","036"
"24405","CURTATONE",2564,1316,1159,5039,"2018","021"
"24406","CUSAGO",20,503,0,523,"2018","097"
"24407","CUSINO",5,0,0,5,"2018","085"
"24408","CUSIO",1,0,0,1,"2018","090"
"24409","CUVEGLIO",6,4,0,10,"2018","062"
"24410","CUVIO",3,79,2,84,"2018","063"
"24411","DAIRAGO",6,39,0,45,"2018","099"
"24412","DALMINE",107,108,0,215,"2018","091"
"24413","DARFO BOARIO TERME",3,218,38,259,"2018","065"
"24414","DAVERIO",12,0,0,12,"2018","064"
"24415","DAZIO",0,16,0,16,"2018","025"
"24416","DELEBIO",47,125,2,174,"2018","026"
"24417","DELLO",715,2000,20,2735,"2018","066"
"24418","DEMONTE",813,98,0,911,"2018","079"
"24419","DENICE",3,0,0,3,"2018","065"
"24420","DERNICE",14,0,0,14,"2018","066"
"24421","DEROVERE",27,286,0,313,"2018","040"
"24422","DESANA",52,0,0,52,"2018","054"
"24423","DESENZANO DEL GARDA",42,1510,521,2073,"2018","067"
"24424","DESIO",24,0,0,24,"2018",NA
"24425","DIANO D'ALBA",78,0,0,78,"2018","080"
"24426","DIVIGNANO",51,0,0,51,"2018","060"
"24427","DIZZASCO",0,0,7,7,"2018","087"
"24428","DOGLIANI",1709,0,0,1709,"2018","081"
"24429","DOLO",569,237,0,806,"2018","012"
"24430","DOMASO",0,4,2,6,"2018","089"
"24431","DOMEGGE DI CADORE",0,2,0,2,"2018","018"
"24432","DOMODOSSOLA",20,12,8,40,"2018","028"
"24433","DONATO",133,0,23,156,"2018","024"
"24434","DONGO",3,5,4,12,"2018","090"
"24435","DORIO",2,0,0,2,"2018","032"
"24436","DORMELLETTO",4,0,0,4,"2018","062"
"24437","DORNO",11,27,0,38,"2018","061"
"24438","DORZANO",3,0,0,3,"2018","025"
"24439","DOSOLO",19,322,156,497,"2018","022"
"24440","DOSSENA",26,81,5,112,"2018","092"
"24441","DOSSO DEL LIRO",0,0,18,18,"2018","092"
"24442","DOVADOLA",143,0,0,143,"2018","011"
"24443","DOVERA",23,1263,27,1313,"2018","041"
"24444","DOZZA",0,20,0,20,"2018","025"
"24445","DRESANO",7,0,0,7,"2018","101"
"24446","DRIZZONA",0,475,0,475,"2018","042"
"24447","DRONERO",2223,278,40,2541,"2018","082"
"24448","DRUENTO",737,42,0,779,"2018","099"
"24449","DRUOGNO",9,0,1,10,"2018","029"
"24450","DUBINO",11,656,12,679,"2018","027"
"24451","DUE CARRARE",154,0,0,154,"2018","106"
"24452","DUEVILLE",453,583,0,1036,"2018","038"
"24453","DUMENZA",3,0,8,11,"2018","065"
"24454","DUSINO SAN MICHELE",357,41,0,398,"2018","052"
"24455","EDOLO",11,49,10,70,"2018","068"
"24456","ELLO",2,0,0,2,"2018","033"
"24457","ELVA",34,0,14,48,"2018","083"
"24458","ENDINE GAIANO",57,103,2,162,"2018","093"
"24459","ENEGO",17,200,0,217,"2018","039"
"24460","ENTRACQUE",96,0,0,96,"2018","084"
"24461","ENTRATICO",21,4,20,45,"2018","094"
"24462","ENVIE",1697,364,300,2361,"2018","085"
"24463","ERACLEA",4203,327,0,4530,"2018","013"
"24464","ERBA",19,433,0,452,"2018","095"
"24465","ERBE'",238,32,0,270,"2018","032"
"24466","ERBEZZO",39,682,0,721,"2018","033"
"24467","ERBUSCO",250,43,0,293,"2018","069"
"24468","ERVE",1,0,0,1,"2018","034"
"24469","ESINE",3,161,5,169,"2018","070"
"24470","ESINO LARIO",18,0,0,18,"2018","035"
"24471","ESTE",978,39,0,1017,"2018","037"
"24472","EUPILIO",13,6,53,72,"2018","097"
"24473","EXILLES",1,0,0,1,"2018",NA
"24474","FABBRICA CURONE",8,27,0,35,"2018","067"
"24475","FABBRICO",0,269,0,269,"2018","021"
"24476","FAEDO VALTELLINO",4,20,0,24,"2018","028"
"24477","FAENZA",175,79,0,254,"2018","010"
"24478","FAGGETO LARIO",1,0,4,5,"2018","098"
"24479","FAGNANO OLONA",34,6,0,40,"2018","067"
"24480","FALCADE",7,27,0,34,"2018","019"
"24481","FALOPPIO",3,0,2,5,"2018","099"
"24482","FANANO",35,437,0,472,"2018","011"
"24483","FARA GERA D'ADDA",22,592,87,701,"2018","096"
"24484","FARA NOVARESE",5,0,0,5,"2018","065"
"24485","FARA OLIVANA CON SOLA",110,266,0,376,"2018","097"
"24486","FARA VICENTINO",604,386,146,1136,"2018","040"
"24487","FARIGLIANO",569,0,0,569,"2018","086"
"24488","FARINI",96,91,0,187,"2018","019"
"24489","FARRA DI SOLIGO",80,29,0,109,"2018","026"
"24490","FAULE",42,0,149,191,"2018","087"
"24491","FAVRIA",286,556,50,892,"2018","101"
"24492","FEISOGLIO",80,0,0,80,"2018","088"
"24493","FELETTO",8,6,0,14,"2018","102"
"24494","FELINO",16,1053,0,1069,"2018","013"
"24495","FELIZZANO",19,0,0,19,"2018","068"
"24496","FELTRE",186,1200,0,1386,"2018","021"
"24497","FENEGRO'",29,0,38,67,"2018","100"
"24498","FENESTRELLE",29,0,0,29,"2018","103"
"24499","FERNO",1,23,0,24,"2018","068"
"24500","FERRARA",332,154,0,486,"2018","008"
"24501","FERRARA DI MONTE BALDO",4,36,0,40,"2018","034"
"24502","FERRERA DI VARESE",20,0,0,20,"2018","069"
"24503","FERRERA ERBOGNONE",26,0,0,26,"2018","062"
"24504","FERRERE",826,0,0,826,"2018","053"
"24505","FERRIERE",114,1,0,115,"2018","020"
"24506","FIANO",11,0,0,11,"2018","104"
"24507","FICAROLO",15,0,0,15,"2018","021"
"24508","FIDENZA",156,3771,0,3927,"2018","014"
"24509","FIESCO",12,585,141,738,"2018","043"
"24510","FIESSE",754,383,386,1523,"2018","071"
"24511","FIESSO D'ARTICO",3,40,0,43,"2018","014"
"24512","FIESSO UMBERTIANO",123,0,0,123,"2018","022"
"24513","FIGINO SERENZA",35,97,0,132,"2018","101"
"24514","FILAGO",132,0,0,132,"2018","098"
"24515","FINALE EMILIA",33,55,0,88,"2018","012"
"24516","FINO DEL MONTE",3,33,0,36,"2018","099"
"24517","FINO MORNASCO",8,0,0,8,"2018","102"
"24518","FIORANO AL SERIO",4,17,0,21,"2018","100"
"24519","FIORANO CANAVESE",4,0,0,4,"2018","105"
"24520","FIORANO MODENESE",5,52,0,57,"2018","013"
"24521","FIORENZUOLA D'ARDA",20,2070,0,2090,"2018","021"
"24522","FISCAGLIA",1498,79,0,1577,"2018",NA
"24523","FIUMALBO",102,50,0,152,"2018","014"
"24524","FLERO",387,206,182,775,"2018","072"
"24525","FOBELLO",11,0,5,16,"2018","057"
"24526","FOGLIZZO",180,0,0,180,"2018","106"
"24527","FOLLINA",408,107,0,515,"2018","027"
"24528","FOMBIO",265,199,0,464,"2018","026"
"24529","FONTANELICE",168,105,0,273,"2018","026"
"24530","FONTANELLA",3427,2282,0,5709,"2018","101"
"24531","FONTANELLATO",41,2214,0,2255,"2018","015"
"24532","FONTANELLE",41,561,9,611,"2018","028"
"24533","FONTANETO D'AGOGNA",15,91,0,106,"2018","066"
"24534","FONTANETTO PO",2,0,0,2,"2018","058"
"24535","FONTANILE",1,0,0,1,"2018","054"
"24536","FONTANIVA",271,382,0,653,"2018","038"
"24537","FONTE",920,521,1,1442,"2018","029"
"24538","FONTENO",9,0,0,9,"2018","102"
"24539","FONTEVIVO",0,1746,0,1746,"2018","016"
"24540","FONZASO",46,55,0,101,"2018","022"
"24541","FOPPOLO",2,18,0,20,"2018","103"
"24542","FORCOLA",11,121,0,132,"2018","029"
"24543","FORESTO SPARSO",18,80,2,100,"2018","104"
"24544","FORLI'",426,91,0,517,"2018","012"
"24545","FORLIMPOPOLI",6,9,0,15,"2018","013"
"24546","FORMAZZA",4,21,5,30,"2018","031"
"24547","FORMIGARA",5,990,239,1234,"2018","044"
"24548","FORMIGINE",4,1893,0,1897,"2018","015"
"24549","FORMIGLIANA",17,0,0,17,"2018","059"
"24550","FORMIGNANA",1,0,0,1,"2018","009"
"24551","FORNO CANAVESE",36,0,0,36,"2018","107"
"24552","FORNOVO DI TARO",34,646,0,680,"2018","017"
"24553","FORNOVO SAN GIOVANNI",11,712,26,749,"2018","105"
"24554","FORTUNAGO",39,0,0,39,"2018","064"
"24555","FOSSALTA DI PIAVE",3,0,0,3,"2018","015"
"24556","FOSSALTA DI PORTOGRUARO",0,825,0,825,"2018","016"
"24557","FOSSANO",17685,4449,1225,23359,"2018","089"
"24558","FOSSO'",132,24,0,156,"2018","017"
"24559","FOZA",30,32,15,77,"2018","041"
"24560","FRABOSA SOPRANA",316,4,162,482,"2018","090"
"24561","FRABOSA SOTTANA",49,22,31,102,"2018","091"
"24562","FRACONALTO",29,0,0,29,"2018","069"
"24563","FRASCARO",0,11,0,11,"2018","071"
"24564","FRASCAROLO",296,9,0,305,"2018","065"
"24565","FRASSINELLE POLESINE",253,0,0,253,"2018","023"
"24566","FRASSINELLO MONFERRATO",51,0,0,51,"2018","072"
"24567","FRASSINETO PO",43,0,0,43,"2018","073"
"24568","FRASSINETTO",128,3,0,131,"2018","108"
"24569","FRASSINO",37,0,0,37,"2018","092"
"24570","FRASSINORO",63,130,0,193,"2018","016"
"24571","FRATTA POLESINE",325,151,0,476,"2018","024"
"24572","FREGONA",10,27,0,37,"2018","030"
"24573","FRESONARA",11,0,0,11,"2018","074"
"24574","FRINCO",276,0,0,276,"2018","055"
"24575","FRONT",56,0,10,66,"2018","109"
"24576","FROSSASCO",2073,0,110,2183,"2018","110"
"24577","FRUGAROLO",135,142,0,277,"2018","075"
"24578","FUBINE",216,0,0,216,"2018","076"
"24579","FUIPIANO VALLE IMAGNA",10,44,0,54,"2018","106"
"24580","FUMANE",22,28,2,52,"2018","035"
"24581","FUSIGNANO",5,0,0,5,"2018","011"
"24582","FUSINE",1,24,0,25,"2018","030"
"24583","GABBIONETA-BINANUOVA",8,683,0,691,"2018","045"
"24584","GABIANO",43,0,0,43,"2018","077"
"24585","GADESCO-PIEVE DELMONA",37,477,81,595,"2018","046"
"24586","GAGGIANO",46,423,7,476,"2018","103"
"24587","GAGGIO MONTANO",262,359,0,621,"2018","027"
"24588","GAGLIANICO",1,0,0,1,"2018","026"
"24589","GAIARINE",616,0,0,616,"2018","031"
"24590","GAIBA",21,0,0,21,"2018","025"
"24591","GAIOLA",35,0,1,36,"2018","093"
"24592","GALBIATE",36,17,0,53,"2018","036"
"24593","GALEATA",226,0,22,248,"2018","014"
"24594","GALGAGNANO",0,727,0,727,"2018","027"
"24595","GALLARATE",1,14,7,22,"2018","070"
"24596","GALLIATE",9,47,0,56,"2018","068"
"24597","GALLIATE LOMBARDO",11,0,0,11,"2018","071"
"24598","GALLIERA",0,47,0,47,"2018","028"
"24599","GALLIERA VENETA",3726,120,0,3846,"2018","039"
"24600","GALLIO",15,223,0,238,"2018","042"
"24601","GALZIGNANO TERME",7,0,0,7,"2018","040"
"24602","GAMALERO",14,0,0,14,"2018","078"
"24603","GAMBARA",4266,2374,462,7102,"2018","073"
"24604","GAMBASCA",3,0,0,3,"2018","094"
"24605","GAMBOLO'",78,125,0,203,"2018","068"
"24606","GAMBUGLIANO",1,40,0,41,"2018","044"
"24607","GANDELLINO",14,0,0,14,"2018","107"
"24608","GANDINO",50,138,0,188,"2018","108"
"24609","GANDOSSO",8,2,8,18,"2018","109"
"24610","GARBAGNA",64,0,0,64,"2018","079"
"24611","GARBAGNATE MILANESE",5,0,0,5,"2018",NA
"24612","GARBAGNATE MONASTERO",6,0,0,6,"2018","037"
"24613","GARDA",2,0,0,2,"2018","036"
"24614","GARDONE RIVIERA",10,0,0,10,"2018","074"
"24615","GARDONE VAL TROMPIA",26,0,0,26,"2018","075"
"24616","GARESSIO",186,0,19,205,"2018","095"
"24617","GARGNANO",34,0,9,43,"2018","076"
"24618","GARLASCO",10,5,2,17,"2018","069"
"24619","GARZENO",11,4,25,40,"2018","106"
"24620","GARZIGLIANA",262,0,0,262,"2018","111"
"24621","GASSINO TORINESE",29,0,0,29,"2018","112"
"24622","GATTATICO",13,2507,0,2520,"2018","022"
"24623","GATTEO",3,0,0,3,"2018","016"
"24624","GATTICO",36,240,68,344,"2018","071"
"24625","GATTINARA",61,0,0,61,"2018","061"
"24626","GAVARDO",80,478,13,571,"2018","077"
"24627","GAVELLO",88,0,0,88,"2018",NA
"24628","GAVERINA TERME",13,48,0,61,"2018","110"
"24629","GAVI",17,0,0,17,"2018","081"
"24630","GAVIRATE",37,0,0,37,"2018","072"
"24631","GAZOLDO DEGLI IPPOLITI",525,85,3,613,"2018","024"
"24632","GAZZADA SCHIANNO",8,0,7,15,"2018","073"
"24633","GAZZANIGA",18,35,0,53,"2018","111"
"24634","GAZZO",56,2666,0,2722,"2018","041"
"24635","GAZZO VERONESE",647,247,0,894,"2018","037"
"24636","GAZZOLA",152,1540,0,1692,"2018","022"
"24637","GAZZUOLO",663,48,8,719,"2018","025"
"24638","GEMMANO",19,60,0,79,"2018","004"
"24639","GEMONIO",1,0,2,3,"2018","074"
"24640","GENIVOLTA",144,1908,0,2052,"2018","047"
"24641","GENOLA",2163,1960,201,4324,"2018","096"
"24642","GERA LARIO",18,226,8,252,"2018","107"
"24643","GERENZAGO",13,0,0,13,"2018","071"
"24644","GERENZANO",104,104,0,208,"2018","075"
"24645","GERMAGNANO",15,0,1,16,"2018","113"
"24646","GERMAGNO",3,0,0,3,"2018","032"
"24647","GERMIGNAGA",11,87,0,98,"2018","076"
"24648","GERRE DE' CAPRIOLI",0,482,0,482,"2018","048"
"24649","GESSATE",0,463,0,463,"2018","106"
"24650","GHEDI",3464,6393,132,9989,"2018","078"
"24651","GHEMME",16,0,21,37,"2018","073"
"24652","GHIFFA",2,0,0,2,"2018","033"
"24653","GHISALBA",1,796,0,797,"2018","113"
"24654","GHISLARENGO",17,0,0,17,"2018","062"
"24655","GIAGLIONE",18,0,0,18,"2018","114"
"24656","GIANICO",103,156,175,434,"2018","079"
"24657","GIAVENO",175,377,144,696,"2018","115"
"24658","GIAVERA DEL MONTELLO",787,140,0,927,"2018","032"
"24659","GIFFLENGA",1,0,0,1,"2018","027"
"24660","GIGNESE",5,0,5,10,"2018","034"
"24661","GIUSSAGO",6,185,0,191,"2018","072"
"24662","GIUSSANO",4,0,0,4,"2018",NA
"24663","GIVOLETTO",24,0,0,24,"2018","116"
"24664","GODEGA DI SANT'URBANO",36,101,0,137,"2018","033"
"24665","GODIASCO",10,0,0,10,"2018","073"
"24666","GOITO",4130,4668,1607,10405,"2018","026"
"24667","GOLASECCA",17,30,0,47,"2018","077"
"24668","GOLFERENZO",0,0,13,13,"2018","074"
"24669","GOMBITO",3,912,0,915,"2018","049"
"24670","GONZAGA",17720,2609,4173,24502,"2018","027"
"24671","GORDONA",70,114,21,205,"2018","032"
"24672","GORGO AL MONTICANO",51,251,36,338,"2018","034"
"24673","GORGONZOLA",31,281,0,312,"2018","108"
"24674","GORLA MAGGIORE",3,0,189,192,"2018","078"
"24675","GORLA MINORE",97,0,0,97,"2018","079"
"24676","GORLAGO",77,270,4,351,"2018","114"
"24677","GORLE",3,0,0,3,"2018","115"
"24678","GORNATE-OLONA",16,0,2,18,"2018","080"
"24679","GORNO",21,69,0,90,"2018","116"
"24680","GORZEGNO",33,0,0,33,"2018","097"
"24681","GOSALDO",1,0,0,1,"2018",NA
"24682","GOSSOLENGO",5,648,0,653,"2018","023"
"24683","GOTTASECCA",40,0,0,40,"2018","098"
"24684","GOTTOLENGO",14987,1234,165,16386,"2018","080"
"24685","GOVONE",308,0,0,308,"2018","099"
"24686","GOZZANO",2,0,0,2,"2018","076"
"24687","GRAFFIGNANA",46,228,63,337,"2018","028"
"24688","GRAGLIA",62,16,68,146,"2018","028"
"24689","GRAGNANO TREBBIENSE",5,2884,0,2889,"2018","024"
"24690","GRANA",52,0,0,52,"2018","056"
"24691","GRANAROLO DELL'EMILIA",247,274,0,521,"2018","030"
"24692","GRANDOLA ED UNITI",3,14,34,51,"2018","111"
"24693","GRANOZZO CON MONTICELLO",1,58,0,59,"2018","077"
"24694","GRANTOLA",63,0,0,63,"2018","081"
"24695","GRANTORTO",72,844,2,918,"2018","042"
"24696","GRANZE",795,0,0,795,"2018","043"
"24697","GRASSOBBIO",11,126,0,137,"2018","117"
"24698","GRAVEDONA ED UNITI",7,14,57,78,"2018","249"
"24699","GRAVELLONA LOMELLINA",13,0,0,13,"2018","075"
"24700","GRAVELLONA TOCE",22,0,0,22,"2018","035"
"24701","GRAVERE",5,0,0,5,"2018","117"
"24702","GRAZZANO BADOGLIO",436,0,0,436,"2018","057"
"24703","GREMIASCO",41,0,0,41,"2018","083"
"24704","GREZZAGO",5,0,0,5,"2018","110"
"24705","GREZZANA",129,510,0,639,"2018","038"
"24706","GRIANTE",6,0,5,11,"2018","113"
"24707","GRIGNASCO",12,9,0,21,"2018","079"
"24708","GRINZANE CAVOUR",12,0,0,12,"2018","100"
"24709","GRISIGNANO DI ZOCCO",26,436,10,472,"2018","046"
"24710","GRIZZANA MORANDI",58,0,0,58,"2018","031"
"24711","GROMO",33,66,9,108,"2018","118"
"24712","GRONDONA",8,0,0,8,"2018","085"
"24713","GRONE",22,21,9,52,"2018","119"
"24714","GRONTARDO",0,2023,35,2058,"2018","050"
"24715","GROPELLO CAIROLI",27,0,0,27,"2018","076"
"24716","GROPPARELLO",107,28,0,135,"2018","025"
"24717","GROSCAVALLO",20,15,25,60,"2018","118"
"24718","GROSIO",30,199,5,234,"2018","033"
"24719","GROSOTTO",7,32,29,68,"2018","034"
"24720","GROSSO",69,0,0,69,"2018","119"
"24721","GRUARO",16,193,0,209,"2018","018"
"24722","GRUGLIASCO",69,12,29,110,"2018","120"
"24723","GRUMELLO CREMONESE ED UNITI",55,1408,340,1803,"2018","051"
"24724","GRUMELLO DEL MONTE",73,111,0,184,"2018","120"
"24725","GRUMOLO DELLE ABBADESSE",48,183,0,231,"2018","047"
"24726","GUALTIERI",1227,561,0,1788,"2018","023"
"24727","GUANZATE",23,0,2,25,"2018","114"
"24728","GUARDA VENETA",660,0,0,660,"2018","028"
"24729","GUARDABOSONE",52,9,0,61,"2018","066"
"24730","GUARDAMIGLIO",7,85,339,431,"2018","029"
"24731","GUARENE",282,0,0,282,"2018","101"
"24732","GUASTALLA",65,1028,0,1093,"2018","024"
"24733","GUDO VISCONTI",12,0,0,12,"2018","112"
"24734","GUIDIZZOLO",1477,822,326,2625,"2018","028"
"24735","GUIGLIA",7,493,0,500,"2018","017"
"24736","GUSSAGO",67,916,114,1097,"2018","081"
"24737","GUSSOLA",0,54,5,59,"2018","052"
"24738","IDRO",5,0,5,10,"2018","082"
"24739","IESOLO",6,64,5,75,"2018","019"
"24740","IGLIANO",48,0,24,72,"2018","102"
"24741","ILLASI",1,58,0,59,"2018","039"
"24742","IMBERSAGO",1,0,0,1,"2018","039"
"24743","IMOLA",84,0,0,84,"2018","032"
"24744","INARZO",12,0,0,12,"2018","082"
"24745","INCISA SCAPACCINO",45,0,0,45,"2018","058"
"24746","INCUDINE",1,0,0,1,"2018","083"
"24747","INDUNO OLONA",26,83,0,109,"2018","083"
"24748","INTROBIO",63,14,0,77,"2018","040"
"24749","INVERIGO",134,0,0,134,"2018","118"
"24750","INVERNO E MONTELEONE",87,138,22,247,"2018","077"
"24751","INVERSO PINASCA",31,0,0,31,"2018","122"
"24752","INVERUNO",4,71,0,75,"2018","113"
"24753","INVORIO",21,55,0,76,"2018","082"
"24754","INZAGO",319,697,0,1016,"2018","114"
"24755","IRMA",7,0,0,7,"2018","084"
"24756","ISASCA",10,0,0,10,"2018","103"
"24757","ISEO",27,30,0,57,"2018","085"
"24758","ISOLA D'ASTI",430,0,0,430,"2018","059"
"24759","ISOLA DELLA SCALA",7685,370,0,8055,"2018","040"
"24760","ISOLA DI FONDRA",6,23,0,29,"2018","121"
"24761","ISOLA DOVARESE",0,802,0,802,"2018","053"
"24762","ISOLA RIZZA",2054,381,0,2435,"2018","041"
"24763","ISOLA VICENTINA",2175,720,25,2920,"2018","048"
"24764","ISOLABELLA",29,0,482,511,"2018","123"
"24765","ISORELLA",10928,429,35,11392,"2018","086"
"24766","ISPRA",51,142,0,193,"2018","084"
"24767","ISSIGLIO",73,18,0,91,"2018","124"
"24768","ISSO",10,1209,0,1219,"2018","122"
"24769","ISTRANA",2677,348,49,3074,"2018","035"
"24770","IVREA",140,211,12,363,"2018","125"
"24771","IZANO",4,1007,0,1011,"2018","054"
"24772","JERAGO CON ORAGO",2,0,0,2,"2018","085"
"24773","JOLANDA DI SAVOIA",4230,0,0,4230,"2018","010"
"24774","LA CASSA",13,298,0,311,"2018","126"
"24775","LA LOGGIA",134,0,96,230,"2018","127"
"24776","LA MORRA",50,0,0,50,"2018","105"
"24777","LA VALLE AGORDINA",7,36,1,44,"2018","027"
"24778","LA VALLETTA BRIANZA",10,8,10,28,"2018",NA
"24779","LACCHIARELLA",189,19,0,208,"2018","115"
"24780","LAGNASCO",71,0,0,71,"2018","104"
"24781","LAGOSANTO",41,0,0,41,"2018","011"
"24782","LAINATE",11,0,3,14,"2018","116"
"24783","LAINO",2,1,0,3,"2018","120"
"24784","LALLIO",1,0,0,1,"2018",NA
"24785","LAMA MOCOGNO",70,408,0,478,"2018","018"
"24786","LAMBRUGO",0,133,0,133,"2018","121"
"24787","LAMON",11,32,0,43,"2018","026"
"24788","LAMPORO",25,0,0,25,"2018","067"
"24789","LANDRIANO",25,211,0,236,"2018","078"
"24790","LANGHIRANO",2,823,0,825,"2018","018"
"24791","LANGOSCO",10,0,0,10,"2018","079"
"24792","LANZADA",23,70,0,93,"2018","036"
"24793","LANZO TORINESE",115,0,12,127,"2018","128"
"24794","LARDIRAGO",0,0,3,3,"2018",NA
"24795","LASNIGO",0,21,0,21,"2018","123"
"24796","LAURIANO",17,0,0,17,"2018","129"
"24797","LAVENA PONTE TRESA",5,0,0,5,"2018","086"
"24798","LAVENONE",26,0,1,27,"2018","087"
"24799","LAZISE",43,73,0,116,"2018","043"
"24800","LAZZATE",33,0,0,33,"2018",NA
"24801","LECCO",10,37,2,49,"2018","042"
"24802","LEFFE",19,74,0,93,"2018","124"
"24803","LEGGIUNO",2,0,0,2,"2018","088"
"24804","LEGNAGO",102,50,0,152,"2018","044"
"24805","LEGNANO",0,88,0,88,"2018","118"
"24806","LEGNARO",109,20,48,177,"2018","044"
"24807","LEINI'",665,618,87,1370,"2018","130"
"24808","LEMIE",17,0,31,48,"2018","131"
"24809","LENDINARA",576,128,0,704,"2018","029"
"24810","LENNA",4,7,0,11,"2018","125"
"24811","LENO",5212,7092,1098,13402,"2018","088"
"24812","LENTA",0,16,0,16,"2018","068"
"24813","LENTATE SUL SEVESO",0,106,101,207,"2018",NA
"24814","LENTIAI",29,128,0,157,"2018","028"
"24815","LEQUIO BERRIA",30,0,0,30,"2018","106"
"24816","LEQUIO TANARO",1942,0,0,1942,"2018","107"
"24817","LERMA",8,0,0,8,"2018","088"
"24818","LESA",4,0,0,4,"2018","084"
"24819","LESEGNO",877,0,0,877,"2018","108"
"24820","LESIGNANO DE' BAGNI",54,1238,0,1292,"2018","019"
"24821","LESMO",0,133,0,133,"2018",NA
"24822","LESSOLO",142,7,0,149,"2018","132"
"24823","LESSONA",3,15,0,18,"2018","029"
"24824","LEVATE",2,0,0,2,"2018","126"
"24825","LEVICE",75,0,0,75,"2018","109"
"24826","LEZZENO",0,0,4,4,"2018","126"
"24827","LIERNA",4,3,0,7,"2018","043"
"24828","LIMANA",46,132,0,178,"2018","029"
"24829","LIMENA",788,614,85,1487,"2018","045"
"24830","LIMIDO COMASCO",2,31,1,34,"2018","128"
"24831","LIMONE PIEMONTE",80,0,0,80,"2018","110"
"24832","LINAROLO",13,330,0,343,"2018","081"
"24833","LIPOMO",1,0,0,1,"2018",NA
"24834","LIRIO",38,0,0,38,"2018","082"
"24835","LISCATE",14,0,0,14,"2018","122"
"24836","LISIO",56,0,0,56,"2018","111"
"24837","LISSONE",303,0,0,303,"2018",NA
"24838","LIVIGNO",65,328,4,397,"2018","037"
"24839","LIVINALLONGO DEL COL DI LANA",2,55,0,57,"2018","030"
"24840","LIVO",1,4,0,5,"2018","130"
"24841","LIVORNO FERRARIS",1,65,0,66,"2018","071"
"24842","LIVRAGA",48,965,0,1013,"2018","030"
"24843","LIZZANO IN BELVEDERE",19,43,27,89,"2018","033"
"24844","LOAZZOLO",3,0,1,4,"2018","060"
"24845","LOCANA",130,90,0,220,"2018","134"
"24846","LOCATE DI TRIULZI",33,1004,0,1037,"2018","125"
"24847","LOCATE VARESINO",13,0,0,13,"2018","131"
"24848","LOCATELLO",43,18,0,61,"2018","127"
"24849","LODI",580,1198,48,1826,"2018","031"
"24850","LODI VECCHIO",0,1225,0,1225,"2018","032"
"24851","LODRINO",13,11,0,24,"2018","090"
"24852","LOGRATO",864,784,0,1648,"2018","091"
"24853","LOIANO",53,268,0,321,"2018","034"
"24854","LOMAZZO",1,0,0,1,"2018","133"
"24855","LOMBARDORE",15,0,0,15,"2018","135"
"24856","LOMBRIASCO",86,134,0,220,"2018","136"
"24857","LOMELLO",2,145,0,147,"2018","083"
"24858","LONATE CEPPINO",2,281,0,283,"2018","089"
"24859","LONATE POZZOLO",12,0,6,18,"2018","090"
"24860","LONATO DEL GARDA",3031,4827,524,8382,"2018",NA
"24861","LONGARE",56,200,0,256,"2018","051"
"24862","LONGARONE",8,0,0,8,"2018","031"
"24863","LONGHENA",0,390,0,390,"2018","093"
"24864","LONGIANO",16,0,0,16,"2018","018"
"24865","LONIGO",5617,476,7,6100,"2018","052"
"24866","LORANZE'",29,0,0,29,"2018","137"
"24867","LOREGGIA",244,414,4,662,"2018","046"
"24868","LOREGLIA",8,0,0,8,"2018","038"
"24869","LORENZAGO DI CADORE",0,2,0,2,"2018","032"
"24870","LOREO",980,62,0,1042,"2018","030"
"24871","LORIA",5868,27,4,5899,"2018","036"
"24872","LOSINE",0,37,0,37,"2018","094"
"24873","LOVERE",4,31,0,35,"2018","128"
"24874","LOVERO",4,10,0,14,"2018","038"
"24875","LOZIO",0,4,0,4,"2018","095"
"24876","LOZZA",0,127,0,127,"2018","091"
"24877","LOZZO ATESTINO",1393,4,0,1397,"2018","047"
"24878","LU",83,0,0,83,"2018","089"
"24879","LUGAGNANO VAL D'ARDA",55,154,0,209,"2018","026"
"24880","LUGNACCO",12,0,0,12,"2018","138"
"24881","LUGO",460,87,0,547,"2018","012"
"24882","LUGO DI VICENZA",17,123,0,140,"2018","053"
"24883","LUINO",6,20,0,26,"2018","092"
"24884","LUISAGO",12,0,0,12,"2018","135"
"24885","LUMEZZANE",16,0,0,16,"2018","096"
"24886","LURAGO D'ERBA",12,0,0,12,"2018","136"
"24887","LURAGO MARINONE",0,144,0,144,"2018","137"
"24888","LURANO",41,0,0,41,"2018","129"
"24889","LURATE CACCIVIO",28,0,96,124,"2018","138"
"24890","LUSERNA SAN GIOVANNI",415,71,62,548,"2018","139"
"24891","LUSERNETTA",86,0,0,86,"2018","140"
"24892","LUSIA",15,0,0,15,"2018","031"
"24893","LUSIANA",9,85,9,103,"2018","054"
"24894","LUSIGLIE'",77,0,0,77,"2018","141"
"24895","LUZZANA",17,0,0,17,"2018","130"
"24896","LUZZARA",1800,1274,23,3097,"2018","026"
"24897","MACCAGNO CON PINO E VEDDASCA",2,0,13,15,"2018",NA
"24898","MACCASTORNA",577,2,0,579,"2018","033"
"24899","MACELLO",1428,190,405,2023,"2018","142"
"24900","MACLODIO",10,409,0,419,"2018","097"
"24901","MACRA",4,0,0,4,"2018",NA
"24902","MACUGNAGA",0,9,0,9,"2018","039"
"24903","MADIGNANO",43,674,0,717,"2018","055"
"24904","MADONE",15,0,0,15,"2018","131"
"24905","MADONNA DEL SASSO",18,0,0,18,"2018","040"
"24906","MAGASA",7,16,0,23,"2018","098"
"24907","MAGENTA",25,782,0,807,"2018","130"
"24908","MAGGIORA",110,59,0,169,"2018","088"
"24909","MAGHERNO",0,86,0,86,"2018","085"
"24910","MAGLIANO ALFIERI",450,0,0,450,"2018","113"
"24911","MAGLIANO ALPI",568,90,0,658,"2018","114"
"24912","MAGNACAVALLO",78,244,498,820,"2018","029"
"24913","MAGNAGO",51,0,0,51,"2018","131"
"24914","MAGNANO",20,15,0,35,"2018","030"
"24915","MAIOLO",112,0,0,112,"2018","022"
"24916","MAIRAGO",1,333,0,334,"2018","034"
"24917","MAIRANO",328,611,0,939,"2018","099"
"24918","MALAGNINO",156,555,0,711,"2018","056"
"24919","MALCESINE",9,70,0,79,"2018","045"
"24920","MALEGNO",9,33,5,47,"2018","100"
"24921","MALEO",111,1397,0,1508,"2018","035"
"24922","MALESCO",16,0,4,20,"2018","041"
"24923","MALGESSO",64,0,0,64,"2018","095"
"24924","MALNATE",47,51,0,98,"2018","096"
"24925","MALO",2217,266,0,2483,"2018","055"
"24926","MALONNO",14,240,26,280,"2018","101"
"24927","MALVICINO",6,3,0,9,"2018","090"
"24928","MANDELLO DEL LARIO",11,0,1,12,"2018","046"
"24929","MANDELLO VITTA",2,0,0,2,"2018","090"
"24930","MANERBA DEL GARDA",13,0,9,22,"2018","102"
"24931","MANERBIO",1124,1408,0,2532,"2018","103"
"24932","MANGO",25,0,0,25,"2018","115"
"24933","MANSUE'",37,338,16,391,"2018","037"
"24934","MANTA",1,0,0,1,"2018","116"
"24935","MANTELLO",1,104,0,105,"2018","039"
"24936","MANTOVA",671,914,86,1671,"2018","030"
"24937","MAPELLO",6,0,31,37,"2018","132"
"24938","MARANELLO",38,555,0,593,"2018","019"
"24939","MARANO DI VALPOLICELLA",43,56,12,111,"2018","046"
"24940","MARANO SUL PANARO",31,626,0,657,"2018","020"
"24941","MARANO TICINO",2,229,0,231,"2018","091"
"24942","MARANO VICENTINO",155,255,44,454,"2018","056"
"24943","MARCALLO CON CASONE",1,309,0,310,"2018","134"
"24944","MARCARIA",2607,3170,915,6692,"2018","031"
"24945","MARCHENO",13,6,11,30,"2018","104"
"24946","MARCHIROLO",1,0,0,1,"2018","097"
"24947","MARCON",398,9,0,407,"2018","020"
"24948","MARENE",3265,2232,110,5607,"2018","117"
"24949","MARENO DI PIAVE",1470,177,4,1651,"2018","038"
"24950","MARENTINO",131,0,0,131,"2018","144"
"24951","MARETTO",191,0,0,191,"2018","062"
"24952","MARGARITA",809,0,0,809,"2018","118"
"24953","MARGNO",4,7,0,11,"2018","047"
"24954","MARIANA MANTOVANA",45,330,40,415,"2018","032"
"24955","MARIANO COMENSE",896,64,2,962,"2018","143"
"24956","MARMENTINO",19,12,11,42,"2018","105"
"24957","MARMIROLO",3969,2195,3017,9181,"2018","033"
"24958","MARMORA",29,0,86,115,"2018","119"
"24959","MARNATE",1,0,0,1,"2018",NA
"24960","MARONE",37,2,20,59,"2018","106"
"24961","MAROSTICA",150,659,0,809,"2018","057"
"24962","MARSAGLIA",148,0,15,163,"2018","120"
"24963","MARTELLAGO",31,10,0,41,"2018","021"
"24964","MARTINENGO",270,2523,1,2794,"2018","133"
"24965","MARTINIANA PO",95,52,37,184,"2018","121"
"24966","MARUDO",0,287,0,287,"2018","036"
"24967","MARZABOTTO",16,97,0,113,"2018","036"
"24968","MARZANO",128,347,6,481,"2018","087"
"24969","MARZIO",6,0,4,10,"2018","099"
"24970","MASATE",0,0,163,163,"2018","136"
"24971","MASCIAGO PRIMO",46,0,0,46,"2018","100"
"24972","MASER",4439,27,0,4466,"2018","039"
"24973","MASERA",14,34,1,49,"2018","042"
"24974","MASERA' DI PADOVA",279,143,89,511,"2018","048"
"24975","MASERADA SUL PIAVE",2515,122,0,2637,"2018","040"
"24976","MASI",38,0,0,38,"2018","049"
"24977","MASI TORELLO",6,49,0,55,"2018","012"
"24978","MASIO",648,0,0,648,"2018","091"
"24979","MASON VICENTINO",12,452,0,464,"2018","058"
"24980","MASSA LOMBARDA",23,0,0,23,"2018","013"
"24981","MASSALENGO",0,102,0,102,"2018","037"
"24982","MASSANZAGO",645,173,0,818,"2018","050"
"24983","MASSAZZA",35,0,0,35,"2018","031"
"24984","MASSELLO",10,0,0,10,"2018","145"
"24985","MASSERANO",56,0,0,56,"2018","032"
"24986","MASSINO VISCONTI",7,0,6,13,"2018","093"
"24987","MASSIOLA",2,0,0,2,"2018","043"
"24988","MATHI",100,0,0,100,"2018","146"
"24989","MATTIE",14,0,0,14,"2018","147"
"24990","MAZZANO",61,570,132,763,"2018","107"
"24991","MAZZE'",1017,0,0,1017,"2018","148"
"24992","MAZZO DI VALTELLINA",5,20,7,32,"2018","040"
"24993","MEANA DI SUSA",1,0,0,1,"2018","149"
"24994","MEDA",2,0,0,2,"2018",NA
"24995","MEDE",19,63,0,82,"2018","088"
"24996","MEDESANO",87,1445,0,1532,"2018","020"
"24997","MEDICINA",52,124,0,176,"2018","037"
"24998","MEDIGLIA",7,1473,38,1518,"2018","139"
"24999","MEDOLAGO",7,0,0,7,"2018","250"
"25000","MEDOLE",552,448,610,1610,"2018","034"
"25001","MEDOLLA",0,522,0,522,"2018","021"
"25002","MEDUNA DI LIVENZA",12,16,0,28,"2018","041"
"25003","MEGLIADINO SAN VITALE",2307,0,0,2307,"2018","052"
"25004","MEL",63,159,0,222,"2018","034"
"25005","MELARA",242,0,0,242,"2018","032"
"25006","MELAZZO",158,0,0,158,"2018","092"
"25007","MELDOLA",156,13,0,169,"2018","019"
"25008","MELEGNANO",0,243,0,243,"2018","140"
"25009","MELETI",17,330,0,347,"2018","038"
"25010","MELLE",245,0,39,284,"2018","122"
"25011","MELLO",23,43,0,66,"2018","041"
"25012","MELZO",157,283,0,440,"2018","142"
"25013","MENAGGIO",1,0,0,1,"2018","145"
"25014","MENCONICO",10,0,0,10,"2018","089"
"25015","MEOLO",349,185,0,534,"2018","022"
"25016","MERANA",33,0,0,33,"2018","093"
"25017","MERATE",75,273,22,370,"2018","048"
"25018","MERCATO SARACENO",192,12,0,204,"2018","020"
"25019","MERCENASCO",315,0,0,315,"2018","150"
"25020","MERGOZZO",25,0,0,25,"2018","044"
"25021","MERLARA",569,8,0,577,"2018","053"
"25022","MERLINO",43,1097,0,1140,"2018","039"
"25023","MERONE",29,59,0,88,"2018","147"
"25024","MESE",22,29,10,61,"2018","043"
"25025","MESENZANA",1,40,0,41,"2018","102"
"25026","MESERO",2,53,0,55,"2018","144"
"25027","MESOLA",1206,259,0,1465,"2018","014"
"25028","MESTRINO",31,87,92,210,"2018","054"
"25029","MEUGLIANO",4,0,0,4,"2018","151"
"25030","MEZZANA BIGLI",120,0,0,120,"2018","090"
"25031","MEZZANE DI SOTTO",0,19,0,19,"2018","047"
"25032","MEZZANI",8,279,0,287,"2018","021"
"25033","MEZZENILE",14,0,0,14,"2018","152"
"25034","MEZZOLDO",2,35,0,37,"2018","134"
"25035","MEZZOMERICO",6,0,0,6,"2018","097"
"25036","MIAGLIANO",6,0,0,6,"2018","034"
"25037","MIANE",4,8,0,12,"2018","042"
"25038","MIASINO",0,0,31,31,"2018","098"
"25039","MIAZZINA",1,0,0,1,"2018","045"
"25040","MILANO",477,72,0,549,"2018","146"
"25041","MILZANO",2,955,0,957,"2018","108"
"25042","MINERBE",2337,253,1,2591,"2018","048"
"25043","MINERBIO",45,0,0,45,"2018","038"
"25044","MIRA",2318,403,23,2744,"2018","023"
"25045","MIRABELLO MONFERRATO",82,0,0,82,"2018","094"
"25046","MIRADOLO TERME",19,9,47,75,"2018","093"
"25047","MIRANDOLA",378,1448,0,1826,"2018","022"
"25048","MIRANO",932,643,5,1580,"2018","024"
"25049","MISANO ADRIATICO",20,0,0,20,"2018","005"
"25050","MISANO DI GERA D'ADDA",8,189,10,207,"2018","135"
"25051","MISSAGLIA",19,261,277,557,"2018","049"
"25052","MODENA",77,2127,0,2204,"2018","023"
"25053","MODIGLIANA",80,0,0,80,"2018","022"
"25054","MOGLIA",3996,816,1243,6055,"2018","035"
"25055","MOGLIANO VENETO",1137,282,299,1718,"2018","043"
"25056","MOIO DE' CALVI",1,8,0,9,"2018","136"
"25057","MOIOLA",12,0,15,27,"2018","123"
"25058","MOLARE",6,0,0,6,"2018","095"
"25059","MOLINELLA",2279,133,0,2412,"2018","039"
"25060","MOLLIA",1,0,0,1,"2018","078"
"25061","MOLTENO",16,34,0,50,"2018","051"
"25062","MOLVENA",10,2,0,12,"2018","059"
"25063","MOMBALDONE",40,0,1,41,"2018","064"
"25064","MOMBARCARO",107,0,0,107,"2018","124"
"25065","MOMBARUZZO",5,0,0,5,"2018","065"
"25066","MOMBASIGLIO",73,0,0,73,"2018","125"
"25067","MOMBELLO DI TORINO",40,0,0,40,"2018","153"
"25068","MOMBELLO MONFERRATO",6,0,0,6,"2018","097"
"25069","MOMBERCELLI",22,0,0,22,"2018","066"
"25070","MOMO",159,476,0,635,"2018","100"
"25071","MOMPERONE",1,0,0,1,"2018","098"
"25072","MONALE",28,0,0,28,"2018","067"
"25073","MONASTERO BORMIDA",398,0,0,398,"2018","068"
"25074","MONASTERO DI LANZO",13,53,0,66,"2018","155"
"25075","MONASTERO DI VASCO",417,0,50,467,"2018","126"
"25076","MONASTEROLO CASOTTO",38,0,0,38,"2018","127"
"25077","MONASTEROLO DEL CASTELLO",10,18,1,29,"2018","137"
"25078","MONASTEROLO DI SAVIGLIANO",493,309,107,909,"2018","128"
"25079","MONASTIER DI TREVISO",2045,228,71,2344,"2018","044"
"25080","MONCALIERI",185,416,0,601,"2018","156"
"25081","MONCALVO",114,0,0,114,"2018","069"
"25082","MONCENISIO",5,0,0,5,"2018","157"
"25083","MONCESTINO",2,0,0,2,"2018","099"
"25084","MONCHIERO",251,0,0,251,"2018","129"
"25085","MONCHIO DELLE CORTI",35,135,0,170,"2018","022"
"25086","MONCRIVELLO",93,234,0,327,"2018","079"
"25087","MONCUCCO TORINESE",33,0,0,33,"2018","070"
"25088","MONDAINO",6,0,0,6,"2018","006"
"25089","MONDOVI'",5484,16,394,5894,"2018","130"
"25090","MONESIGLIO",73,0,0,73,"2018","131"
"25091","MONFORTE D'ALBA",263,0,0,263,"2018","132"
"25092","MONFUMO",37,198,0,235,"2018","045"
"25093","MONGARDINO",32,0,0,32,"2018","071"
"25094","MONGHIDORO",31,72,0,103,"2018","040"
"25095","MONGIARDINO LIGURE",0,0,28,28,"2018","100"
"25096","MONGRANDO",116,110,11,237,"2018","035"
"25097","MONGUZZO",11,0,0,11,"2018","153"
"25098","MONIGA DEL GARDA",0,3,0,3,"2018","109"
"25099","MONNO",4,40,5,49,"2018","110"
"25100","MONSELICE",413,48,0,461,"2018","055"
"25101","MONTA'",130,0,0,130,"2018","133"
"25102","MONTABONE",80,0,0,80,"2018","072"
"25103","MONTACUTO",28,0,0,28,"2018","102"
"25104","MONTAFIA",39,0,0,39,"2018","073"
"25105","MONTAGNA IN VALTELLINA",5,64,0,69,"2018","044"
"25106","MONTAGNANA",1707,26,0,1733,"2018","056"
"25107","MONTALDEO",24,0,0,24,"2018",NA
"25108","MONTALDO DI MONDOVI'",106,0,18,124,"2018","134"
"25109","MONTALDO SCARAMPI",25,0,0,25,"2018","074"
"25110","MONTALDO TORINESE",572,0,0,572,"2018","158"
"25111","MONTALENGHE",3,0,0,3,"2018","159"
"25112","MONTALTO DORA",42,0,0,42,"2018","160"
"25113","MONTALTO PAVESE",70,0,0,70,"2018","094"
"25114","MONTANARO",205,125,0,330,"2018","161"
"25115","MONTANASO LOMBARDO",90,480,0,570,"2018","040"
"25116","MONTANERA",1826,1105,125,3056,"2018","136"
"25117","MONTANO LUCINO",8,0,11,19,"2018","154"
"25118","MONTE CREMASCO",286,104,30,420,"2018","058"
"25119","MONTE DI MALO",612,150,0,762,"2018","063"
"25120","MONTE ISOLA",18,0,0,18,"2018","111"
"25121","MONTE MARENZO",9,0,0,9,"2018","052"
"25122","MONTE SAN PIETRO",96,182,0,278,"2018","042"
"25123","MONTEBELLO DELLA BATTAGLIA",1,22,0,23,"2018","095"
"25124","MONTEBELLO VICENTINO",78,0,268,346,"2018","060"
"25125","MONTEBELLUNA",4311,553,41,4905,"2018","046"
"25126","MONTECALVO VERSIGGIA",3,0,0,3,"2018",NA
"25127","MONTECASTELLO",47,0,0,47,"2018","105"
"25128","MONTECCHIA DI CROSARA",781,2,0,783,"2018","049"
"25129","MONTECCHIO EMILIA",20,1515,0,1535,"2018","027"
"25130","MONTECCHIO MAGGIORE",205,37,0,242,"2018","061"
"25131","MONTECCHIO PRECALCINO",154,193,91,438,"2018","062"
"25132","MONTECHIARO D'ACQUI",50,0,0,50,"2018","106"
"25133","MONTECHIARO D'ASTI",291,0,0,291,"2018","075"
"25134","MONTECHIARUGOLO",14,3451,0,3465,"2018","023"
"25135","MONTECRESTESE",37,38,0,75,"2018","046"
"25136","MONTECRETO",8,486,0,494,"2018","024"
"25137","MONTEFIORE CONCA",24,4,0,28,"2018","008"
"25138","MONTEFIORINO",49,403,0,452,"2018","025"
"25139","MONTEFORTE D'ALPONE",813,5,0,818,"2018","050"
"25140","MONTEGALDA",36,307,0,343,"2018","064"
"25141","MONTEGALDELLA",50,292,0,342,"2018","065"
"25142","MONTEGIOCO",43,0,0,43,"2018","107"
"25143","MONTEGRINO VALTRAVAGLIA",14,0,0,14,"2018","103"
"25144","MONTEGROSSO D'ASTI",20,0,0,20,"2018","076"
"25145","MONTEGROTTO TERME",16,0,37,53,"2018","057"
"25146","MONTELLO",2,0,0,2,"2018","139"
"25147","MONTELUPO ALBESE",91,0,0,91,"2018","137"
"25148","MONTEMAGNO",109,0,0,109,"2018","077"
"25149","MONTEMALE DI CUNEO",135,0,0,135,"2018","138"
"25150","MONTEMEZZO",1,0,0,1,"2018","155"
"25151","MONTERENZIO",325,171,0,496,"2018","041"
"25152","MONTEROSSO GRANA",2,177,0,179,"2018","139"
"25153","MONTESCUDO-MONTE COLOMBO",204,0,0,204,"2018",NA
"25154","MONTESE",56,1390,0,1446,"2018","026"
"25155","MONTESEGALE",11,0,0,11,"2018","098"
"25156","MONTEU DA PO",118,0,0,118,"2018","162"
"25157","MONTEU ROERO",549,0,0,549,"2018","140"
"25158","MONTEVECCHIA",8,0,1,9,"2018","053"
"25159","MONTEVIALE",57,1,0,58,"2018","066"
"25160","MONTEZEMOLO",48,0,0,48,"2018","141"
"25161","MONTICELLI BRUSATI",7,216,2,225,"2018","112"
"25162","MONTICELLI D'ONGINA",288,768,0,1056,"2018","027"
"25163","MONTICELLI PAVESE",1466,386,0,1852,"2018","099"
"25164","MONTICELLO BRIANZA",16,0,295,311,"2018","054"
"25165","MONTICELLO CONTE OTTO",67,839,0,906,"2018","067"
"25166","MONTICELLO D'ALBA",83,0,0,83,"2018","142"
"25167","MONTICHIARI",10062,7167,347,17576,"2018","113"
"25168","MONTIGLIO MONFERRATO",192,0,0,192,"2018","121"
"25169","MONTIRONE",3785,430,0,4215,"2018","114"
"25170","MONTODINE",31,1198,0,1229,"2018","059"
"25171","MONTORSO VICENTINO",700,97,0,797,"2018","068"
"25172","MONTU' BECCARIA",2,0,0,2,"2018","100"
"25173","MONVALLE",4,16,0,20,"2018","104"
"25174","MONZA",27,62,0,89,"2018",NA
"25175","MONZAMBANO",1341,585,750,2676,"2018","036"
"25176","MONZUNO",61,46,0,107,"2018","044"
"25177","MORANO SUL PO",1,0,0,1,"2018","109"
"25178","MORANSENGO",127,0,0,127,"2018","079"
"25179","MORAZZONE",9,84,18,111,"2018","105"
"25180","MORBEGNO",10,83,2,95,"2018","045"
"25181","MORDANO",1,0,0,1,"2018","045"
"25182","MORENGO",54,55,0,109,"2018","140"
"25183","MORETTA",1425,508,195,2128,"2018","143"
"25184","MORFASSO",116,12,0,128,"2018","028"
"25185","MORGANO",1962,9,0,1971,"2018","047"
"25186","MORIAGO DELLA BATTAGLIA",2247,62,0,2309,"2018","048"
"25187","MORIMONDO",42,1520,0,1562,"2018","150"
"25188","MORIONDO TORINESE",283,0,0,283,"2018","163"
"25189","MORNAGO",40,0,0,40,"2018","106"
"25190","MORNESE",35,0,0,35,"2018","111"
"25191","MORNICO AL SERIO",427,573,4,1004,"2018","141"
"25192","MORNICO LOSANA",29,0,0,29,"2018","101"
"25193","MOROZZO",2377,612,434,3423,"2018","144"
"25194","MORSASCO",126,0,0,126,"2018","112"
"25195","MORTARA",57,0,0,57,"2018","102"
"25196","MORTERONE",10,10,36,56,"2018","055"
"25197","MOSCAZZANO",6,1251,160,1417,"2018","060"
"25198","MOSSO",48,10,12,70,"2018","084"
"25199","MOTTA BALUFFI",5,85,0,90,"2018","061"
"25200","MOTTA DI LIVENZA",29,24,0,53,"2018","049"
"25201","MOTTA VISCONTI",5,0,0,5,"2018","151"
"25202","MOTTALCIATA",71,92,0,163,"2018","037"
"25203","MOTTEGGIANA",701,824,1027,2552,"2018","037"
"25204","MOZZANICA",168,745,65,978,"2018","142"
"25205","MOZZATE",24,118,0,142,"2018","159"
"25206","MOZZECANE",3660,1028,0,4688,"2018","051"
"25207","MUGGIÒ",9,0,0,9,"2018",NA
"25208","MULAZZANO",7,1135,0,1142,"2018","041"
"25209","MURA",14,3,9,26,"2018","115"
"25210","MURAZZANO",284,0,15,299,"2018","145"
"25211","MURELLO",434,1304,213,1951,"2018","146"
"25212","MURISENGO",341,0,0,341,"2018","113"
"25213","MUSCOLINE",73,546,0,619,"2018","116"
"25214","MUSILE DI PIAVE",22,10,0,32,"2018","025"
"25215","MUSSO",2,2,6,10,"2018","160"
"25216","MUSSOLENTE",89,252,120,461,"2018","070"
"25217","MUZZANO",23,0,0,23,"2018","038"
"25218","NANTO",236,230,0,466,"2018","071"
"25219","NARZOLE",1757,178,0,1935,"2018","147"
"25220","NAVE",65,175,0,240,"2018","117"
"25221","NEBBIUNO",52,0,24,76,"2018","103"
"25222","NEGRAR",7,75,0,82,"2018","052"
"25223","NEIVE",20,0,0,20,"2018","148"
"25224","NEMBRO",31,0,0,31,"2018","144"
"25225","NERVESA DELLA BATTAGLIA",474,181,0,655,"2018","050"
"25226","NERVIANO",38,116,0,154,"2018","154"
"25227","NESSO",0,8,0,8,"2018","161"
"25228","NETRO",105,58,0,163,"2018","039"
"25229","NEVIANO DEGLI ARDUINI",27,1839,0,1866,"2018","024"
"25230","NEVIGLIE",3,0,0,3,"2018","149"
"25231","NIARDO",0,156,21,177,"2018","118"
"25232","NIBIONNO",2,0,0,2,"2018","056"
"25233","NICHELINO",26,0,12,38,"2018","164"
"25234","NICORVO",1,0,0,1,"2018","103"
"25235","NIELLA BELBO",123,0,0,123,"2018","150"
"25236","NIELLA TANARO",490,0,0,490,"2018","151"
"25237","NIZZA MONFERRATO",49,2,0,51,"2018","080"
"25238","NOALE",439,54,9,502,"2018","026"
"25239","NOASCA",10,0,31,41,"2018","165"
"25240","NOCETO",30,3402,0,3432,"2018","025"
"25241","NOGARA",2176,417,0,2593,"2018","053"
"25242","NOGAROLE ROCCA",340,320,0,660,"2018","054"
"25243","NOGAROLE VICENTINO",11,16,0,27,"2018","072"
"25244","NOLE",166,44,103,313,"2018","166"
"25245","NONANTOLA",13,123,0,136,"2018","027"
"25246","NONE",721,971,405,2097,"2018","168"
"25247","NONIO",2,0,0,2,"2018",NA
"25248","NOSATE",21,0,0,21,"2018","155"
"25249","NOVA MILANESE",0,64,0,64,"2018",NA
"25250","NOVAFELTRIA",1042,141,0,1183,"2018","023"
"25251","NOVALESA",41,20,0,61,"2018","169"
"25252","NOVARA",43,317,0,360,"2018","106"
"25253","NOVATE MEZZOLA",0,0,22,22,"2018","046"
"25254","NOVE",23,273,0,296,"2018","073"
"25255","NOVEDRATE",1542,0,0,1542,"2018","163"
"25256","NOVELLARA",3470,2100,0,5570,"2018","028"
"25257","NOVELLO",924,0,0,924,"2018","152"
"25258","NOVENTA DI PIAVE",4,10,0,14,"2018","027"
"25259","NOVENTA PADOVANA",12,0,0,12,"2018","058"
"25260","NOVENTA VICENTINA",4052,0,0,4052,"2018","074"
"25261","NOVI DI MODENA",1250,691,0,1941,"2018","028"
"25262","NOVI LIGURE",556,0,0,556,"2018","114"
"25263","NOVIGLIO",15,480,0,495,"2018","158"
"25264","NUVOLENTO",13,961,7,981,"2018","119"
"25265","NUVOLERA",1416,354,0,1770,"2018","120"
"25266","OCCHIEPPO INFERIORE",30,122,0,152,"2018","040"
"25267","OCCHIEPPO SUPERIORE",50,37,33,120,"2018","041"
"25268","OCCHIOBELLO",6,107,0,113,"2018","033"
"25269","OCCIMIANO",30,0,0,30,"2018","115"
"25270","ODALENGO GRANDE",67,0,0,67,"2018","116"
"25271","ODERZO",55,342,5,402,"2018","051"
"25272","ODOLO",7,0,0,7,"2018","121"
"25273","OFFANENGO",241,535,0,776,"2018","062"
"25274","OFFLAGA",616,3551,105,4272,"2018","122"
"25275","OGGEBBIO",2,0,0,2,"2018","049"
"25276","OGGIONA CON SANTO STEFANO",0,25,0,25,"2018","107"
"25277","OGGIONO",57,24,3,84,"2018","057"
"25278","OGLIANICO",169,300,0,469,"2018","170"
"25279","OLDENICO",1,0,0,1,"2018","089"
"25280","OLEGGIO",238,988,0,1226,"2018","108"
"25281","OLEGGIO CASTELLO",1,0,0,1,"2018","109"
"25282","OLGIATE COMASCO",37,31,26,94,"2018","165"
"25283","OLGIATE MOLGORA",14,85,0,99,"2018","058"
"25284","OLGIATE OLONA",4,0,0,4,"2018","108"
"25285","OLGINATE",15,0,0,15,"2018","059"
"25286","OLIVA GESSI",6,0,0,6,"2018",NA
"25287","OLIVETO LARIO",12,0,0,12,"2018","060"
"25288","OLMENETA",15,446,135,596,"2018","063"
"25289","OLMO AL BREMBO",0,3,0,3,"2018","145"
"25290","OLMO GENTILE",43,0,8,51,"2018","081"
"25291","OLTRE IL COLLE",23,89,4,116,"2018","146"
"25292","OLTRESSENDA ALTA",6,35,0,41,"2018","147"
"25293","OLTRONA DI SAN MAMETTE",17,0,0,17,"2018","169"
"25294","OME",15,16,0,31,"2018","123"
"25295","OMEGNA",36,0,0,36,"2018","050"
"25296","ONCINO",0,0,97,97,"2018","154"
"25297","ONETA",9,38,0,47,"2018","148"
"25298","ONO SAN PIETRO",1,16,0,17,"2018","124"
"25299","ONORE",21,19,0,40,"2018","149"
"25300","OPERA",0,59,0,59,"2018","159"
"25301","OPPEANO",6387,791,0,7178,"2018","055"
"25302","ORBASSANO",549,0,7,556,"2018","171"
"25303","ORGIANO",485,17,0,502,"2018","075"
"25304","ORIGGIO",64,0,6,70,"2018","109"
"25305","ORINO",3,0,0,3,"2018","110"
"25306","ORIO CANAVESE",0,69,0,69,"2018","172"
"25307","ORIO LITTA",2,63,16,81,"2018","042"
"25308","ORMEA",164,0,11,175,"2018","155"
"25309","ORMELLE",14,121,0,135,"2018","052"
"25310","ORNAGO",8,61,0,69,"2018",NA
"25311","ORNAVASSO",5,0,8,13,"2018","051"
"25312","ORNICA",3,0,0,3,"2018","151"
"25313","ORSAGO",2,88,0,90,"2018","053"
"25314","ORSARA BORMIDA",17,0,0,17,"2018","119"
"25315","ORSENIGO",4,52,8,64,"2018","170"
"25316","ORTA SAN GIULIO",1,0,0,1,"2018","112"
"25317","ORZINUOVI",339,4825,22,5186,"2018","125"
"25318","ORZIVECCHI",10,791,0,801,"2018","126"
"25319","OSASCO",362,0,94,456,"2018","173"
"25320","OSASIO",239,136,113,488,"2018","174"
"25321","OSIO SOPRA",5,584,0,589,"2018","152"
"25322","OSIO SOTTO",13,0,0,13,"2018","153"
"25323","OSMATE",14,0,0,14,"2018","111"
"25324","OSNAGO",0,77,176,253,"2018","061"
"25325","OSPEDALETTO EUGANEO",417,1,0,418,"2018","059"
"25326","OSPEDALETTO LODIGIANO",0,832,0,832,"2018","043"
"25327","OSPITALETTO",151,175,0,326,"2018","127"
"25328","OSSAGO LODIGIANO",42,1528,11,1581,"2018","044"
"25329","OSSIMO",5,7,6,18,"2018","128"
"25330","OSSONA",27,0,0,27,"2018","164"
"25331","OSTELLATO",3428,0,0,3428,"2018","017"
"25332","OSTIANO",442,1324,2,1768,"2018","064"
"25333","OSTIGLIA",21,40,60,121,"2018","038"
"25334","OTTIGLIO",111,0,0,111,"2018","120"
"25335","OTTOBIANO",0,24,0,24,"2018","106"
"25336","OTTONE",79,0,0,79,"2018","030"
"25337","OULX",45,0,0,45,"2018","175"
"25338","OVADA",51,0,0,51,"2018","121"
"25339","OVIGLIO",14,17,0,31,"2018","122"
"25340","OZEGNA",170,5,0,175,"2018","176"
"25341","OZZANO DELL'EMILIA",160,283,0,443,"2018","046"
"25342","OZZANO MONFERRATO",68,0,0,68,"2018","123"
"25343","OZZERO",24,319,0,343,"2018","165"
"25344","PADENGHE SUL GARDA",52,0,5,57,"2018","129"
"25345","PADERNO D'ADDA",1,18,0,19,"2018","062"
"25346","PADERNO DEL GRAPPA",51,123,0,174,"2018","054"
"25347","PADERNO DUGNANO",18,0,0,18,"2018","166"
"25348","PADERNO FRANCIACORTA",2,122,154,278,"2018","130"
"25349","PADERNO PONCHIELLI",139,2313,125,2577,"2018","065"
"25350","PADOVA",559,341,59,959,"2018","060"
"25351","PAESANA",758,5,0,763,"2018","157"
"25352","PAESE",2295,662,0,2957,"2018","055"
"25353","PAGNO",54,0,0,54,"2018","158"
"25354","PAGNONA",0,2,1,3,"2018","063"
"25355","PAISCO LOVENO",0,7,5,12,"2018","131"
"25356","PAITONE",42,19,2,63,"2018","132"
"25357","PALADINA",0,3,0,3,"2018","155"
"25358","PALAGANO",38,638,0,676,"2018","029"
"25359","PALANZANO",9,477,0,486,"2018","026"
"25360","PALAZZAGO",80,111,0,191,"2018","156"
"25361","PALAZZO CANAVESE",8,0,0,8,"2018","177"
"25362","PALAZZO PIGNANO",2,867,0,869,"2018","066"
"25363","PALAZZOLO SULL'OGLIO",1321,1507,127,2955,"2018","133"
"25364","PALAZZOLO VERCELLESE",10,0,0,10,"2018","090"
"25365","PALESTRO",2,0,23,25,"2018","107"
"25366","PALLANZENO",35,0,0,35,"2018","052"
"25367","PALOSCO",439,420,1,860,"2018","157"
"25368","PALU'",104,0,0,104,"2018","056"
"25369","PAMPARATO",43,0,0,43,"2018","159"
"25370","PANCALIERI",151,149,0,300,"2018","178"
"25371","PANDINO",106,3555,10,3671,"2018","067"
"25372","PAPOZZE",155,62,0,217,"2018","034"
"25373","PARABIAGO",40,45,0,85,"2018","168"
"25374","PARATICO",14,41,0,55,"2018","134"
"25375","PARETO",47,2,0,49,"2018","125"
"25376","PARMA",306,9895,0,10201,"2018","027"
"25377","PARODI LIGURE",35,0,45,80,"2018","126"
"25378","PAROLDO",23,0,0,23,"2018","160"
"25379","PARONA",7,0,0,7,"2018","109"
"25380","PARRE",19,76,0,95,"2018","158"
"25381","PARUZZARO",52,33,0,85,"2018","114"
"25382","PARZANICA",2,0,9,11,"2018","159"
"25383","PASPARDO",1,5,3,9,"2018","135"
"25384","PASSERANO MARMORITO",120,0,0,120,"2018","082"
"25385","PASSIRANO",176,149,62,387,"2018","136"
"25386","PASTRENGO",0,158,0,158,"2018","057"
"25387","PASTURO",65,115,46,226,"2018","065"
"25388","PAULLO",0,548,0,548,"2018","169"
"25389","PAVAROLO",90,0,0,90,"2018","180"
"25390","PAVIA",92,253,11,356,"2018","110"
"25391","PAVONE CANAVESE",159,0,0,159,"2018","181"
"25392","PAVONE DEL MELLA",1868,313,12,2193,"2018","137"
"25393","PAVULLO NEL FRIGNANO",146,3746,0,3892,"2018","030"
"25394","PECETTO DI VALENZA",3,0,0,3,"2018","128"
"25395","PECETTO TORINESE",97,0,0,97,"2018","183"
"25396","PEDAVENA",4,122,0,126,"2018","036"
"25397","PEDEMONTE",0,4,8,12,"2018","076"
"25398","PEDEROBBA",41,156,9,206,"2018","056"
"25399","PEDRENGO",11,197,26,234,"2018","160"
"25400","PEGLIO",2,0,12,14,"2018","178"
"25401","PEGOGNAGA",1982,1901,2074,5957,"2018","039"
"25402","PEIA",2,6,0,8,"2018","161"
"25403","PELLEGRINO PARMENSE",24,753,0,777,"2018","028"
"25404","PENANGO",57,0,0,57,"2018","083"
"25405","PENNABILLI",293,12,0,305,"2018","024"
"25406","PERLEDO",1,0,0,1,"2018","067"
"25407","PERLETTO",227,0,0,227,"2018","161"
"25408","PERLO",39,0,0,39,"2018","162"
"25409","PERNUMIA",413,140,0,553,"2018","061"
"25410","PERO",10,0,0,10,"2018",NA
"25411","PEROSA ARGENTINA",55,8,0,63,"2018","184"
"25412","PEROSA CANAVESE",85,177,0,262,"2018","185"
"25413","PERRERO",27,0,0,27,"2018","186"
"25414","PERSICO DOSIMO",3,1915,0,1918,"2018","068"
"25415","PERTENGO",1,0,0,1,"2018","091"
"25416","PERTICA ALTA",11,4,2,17,"2018","139"
"25417","PERTICA BASSA",28,38,27,93,"2018","140"
"25418","PERTUSIO",50,0,0,50,"2018","187"
"25419","PESCANTINA",57,63,4,124,"2018","058"
"25420","PESCAROLO ED UNITI",59,942,0,1001,"2018","069"
"25421","PESCHIERA BORROMEO",22,309,0,331,"2018","171"
"25422","PESSANO CON BORNAGO",57,139,0,196,"2018","172"
"25423","PESSINA CREMONESE",538,2793,0,3331,"2018","070"
"25424","PETTENASCO",9,0,0,9,"2018","116"
"25425","PETTINENGO",2,0,26,28,"2018","042"
"25426","PETTORAZZA GRIMANI",256,215,0,471,"2018","035"
"25427","PEVERAGNO",1153,519,32,1704,"2018","163"
"25428","PEZZAZE",28,16,0,44,"2018","141"
"25429","PEZZOLO VALLE UZZONE",57,0,0,57,"2018","164"
"25430","PIACENZA",62,1301,0,1363,"2018","032"
"25431","PIACENZA D'ADIGE",715,0,0,715,"2018","062"
"25432","PIADENA",0,459,5,464,"2018","071"
"25433","PIAN CAMUNO",0,325,0,325,"2018","142"
"25434","PIANCOGNO",5,40,1,46,"2018","206"
"25435","PIANELLO DEL LARIO",6,0,8,14,"2018","183"
"25436","PIANELLO VAL TIDONE",411,104,0,515,"2018","033"
"25437","PIANENGO",2,286,0,288,"2018","072"
"25438","PIANEZZA",300,383,129,812,"2018","189"
"25439","PIANEZZE",181,114,0,295,"2018","077"
"25440","PIANFEI",662,58,17,737,"2018","165"
"25441","PIANICO",8,87,0,95,"2018","162"
"25442","PIANIGA",34,44,7,85,"2018","028"
"25443","PIANORO",158,179,0,337,"2018","047"
"25444","PIANTEDO",8,240,3,251,"2018","048"
"25445","PIARIO",6,0,0,6,"2018","163"
"25446","PIASCO",272,265,56,593,"2018","166"
"25447","PIATEDA",24,47,0,71,"2018","049"
"25448","PIATTO",34,0,0,34,"2018","043"
"25449","PIAZZA BREMBANA",4,0,0,4,"2018","164"
"25450","PIAZZATORRE",0,2,0,2,"2018","165"
"25451","PIAZZOLA SUL BRENTA",2638,1089,0,3727,"2018","063"
"25452","PIAZZOLO",10,0,3,13,"2018","166"
"25453","PIEA",55,0,0,55,"2018","084"
"25454","PIEDIMULERA",0,25,0,25,"2018","053"
"25455","PIERANICA",73,0,0,73,"2018","073"
"25456","PIETRA DE' GIORGI",28,0,0,28,"2018","111"
"25457","PIEVE D'OLMI",0,1492,612,2104,"2018","074"
"25458","PIEVE DEL CAIRO",6,72,0,78,"2018","113"
"25459","PIEVE DI CADORE",1,15,0,16,"2018","039"
"25460","PIEVE DI SOLIGO",42,129,3,174,"2018","057"
"25461","PIEVE EMANUELE",0,410,82,492,"2018","173"
"25462","PIEVE FISSIRAGA",62,1342,1,1405,"2018","045"
"25463","PIEVE PORTO MORONE",136,0,0,136,"2018","114"
"25464","PIEVE SAN GIACOMO",0,1924,0,1924,"2018","075"
"25465","PIEVE VERGONTE",31,2,64,97,"2018","054"
"25466","PIEVEPELAGO",41,84,0,125,"2018","031"
"25467","PINAROLO PO",2376,0,0,2376,"2018","115"
"25468","PINASCA",85,0,36,121,"2018","190"
"25469","PINCARA",494,0,0,494,"2018","036"
"25470","PINEROLO",1831,175,88,2094,"2018","191"
"25471","PINO TORINESE",509,0,61,570,"2018","192"
"25472","PIOBESI TORINESE",386,915,257,1558,"2018","193"
"25473","PIODE",0,7,11,18,"2018","097"
"25474","PIOLTELLO",1,0,0,1,"2018","175"
"25475","PIOMBINO DESE",5889,421,0,6310,"2018","064"
"25476","PIOSSASCO",484,724,99,1307,"2018","194"
"25477","PIOVA' MASSAIA",267,0,0,267,"2018","086"
"25478","PIOVE DI SACCO",3118,132,0,3250,"2018","065"
"25479","PIOVENE ROCCHETTE",1169,118,0,1287,"2018","078"
"25480","PIOZZANO",150,4,0,154,"2018","034"
"25481","PIOZZO",305,0,0,305,"2018","169"
"25482","PISCINA",1609,0,0,1609,"2018","195"
"25483","PISOGNE",6,215,17,238,"2018","143"
"25484","PIUBEGA",3535,987,53,4575,"2018","041"
"25485","PIURO",10,184,9,203,"2018","050"
"25486","PIVERONE",98,82,0,180,"2018","196"
"25487","PIZZIGHETTONE",57,2954,155,3166,"2018","076"
"25488","PLESIO",1,0,0,1,"2018","185"
"25489","POCAPAGLIA",209,30,0,239,"2018","170"
"25490","PODENZANO",70,667,0,737,"2018","035"
"25491","POGGIO RENATICO",10,414,0,424,"2018","018"
"25492","POGGIO RUSCO",476,425,510,1411,"2018","042"
"25493","POGGIO TORRIANA",509,0,0,509,"2018",NA
"25494","POGGIRIDENTI",8,1,0,9,"2018","051"
"25495","POGNANO",7,359,49,415,"2018","167"
"25496","POGNO",1,0,0,1,"2018",NA
"25497","POIRINO",3629,640,0,4269,"2018","197"
"25498","POJANA MAGGIORE",1393,18,0,1411,"2018","079"
"25499","POLAVENO",34,7,0,41,"2018","144"
"25500","POLESINE ZIBELLO",11,1513,0,1524,"2018",NA
"25501","POLINAGO",71,769,0,840,"2018","032"
"25502","POLLONE",148,64,0,212,"2018","046"
"25503","POLONGHERA",171,115,36,322,"2018","171"
"25504","POLPENAZZE DEL GARDA",19,129,0,148,"2018","145"
"25505","POLVERARA",11,69,0,80,"2018","066"
"25506","POMARETTO",37,0,9,46,"2018","198"
"25507","POMARO MONFERRATO",7,0,275,282,"2018","131"
"25508","POMBIA",2,85,0,87,"2018","121"
"25509","POMPIANO",14,1412,0,1426,"2018","146"
"25510","POMPONESCO",0,451,2,453,"2018","043"
"25511","PONCARALE",408,744,186,1338,"2018","147"
"25512","PONDERANO",32,48,46,126,"2018","047"
"25513","PONNA",2,0,8,10,"2018","187"
"25514","PONSO",49,0,0,49,"2018","067"
"25515","PONT-CANAVESE",39,39,0,78,"2018","199"
"25516","PONTE DELL'OLIO",115,122,0,237,"2018","036"
"25517","PONTE DI LEGNO",3,4,0,7,"2018","148"
"25518","PONTE DI PIAVE",47,35,3,85,"2018","058"
"25519","PONTE IN VALTELLINA",8,8,0,16,"2018","052"
"25520","PONTE LAMBRO",3,18,0,21,"2018","188"
"25521","PONTE NELLE ALPI",32,156,0,188,"2018","040"
"25522","PONTE NIZZA",117,34,0,151,"2018","117"
"25523","PONTE NOSSA",0,23,0,23,"2018","168"
"25524","PONTE SAN NICOLO'",256,45,0,301,"2018","069"
"25525","PONTE SAN PIETRO",6,0,0,6,"2018","170"
"25526","PONTECCHIO POLESINE",1092,0,0,1092,"2018","038"
"25527","PONTECHIANALE",246,0,0,246,"2018","172"
"25528","PONTECURONE",4,0,0,4,"2018","132"
"25529","PONTELONGO",326,0,0,326,"2018","068"
"25530","PONTENURE",61,143,0,204,"2018","037"
"25531","PONTERANICA",2,0,0,2,"2018","169"
"25532","PONTESTURA",7,0,0,7,"2018","133"
"25533","PONTEVICO",232,3558,507,4297,"2018","149"
"25534","PONTI",81,0,7,88,"2018","134"
"25535","PONTI SUL MINCIO",148,412,26,586,"2018","044"
"25536","PONTIDA",23,0,0,23,"2018","171"
"25537","PONTIROLO NUOVO",291,501,0,792,"2018","172"
"25538","PONTOGLIO",781,1397,144,2322,"2018","150"
"25539","PONZANO MONFERRATO",45,0,0,45,"2018","135"
"25540","PONZANO VENETO",308,150,0,458,"2018","059"
"25541","PONZONE",31,15,0,46,"2018","136"
"25542","PORLEZZA",2,35,17,54,"2018","189"
"25543","PORTACOMARO",47,0,0,47,"2018","087"
"25544","PORTE",15,0,0,15,"2018","200"
"25545","PORTICO E SAN BENEDETTO",51,0,0,51,"2018","031"
"25546","PORTO CERESIO",2,0,0,2,"2018","113"
"25547","PORTO MANTOVANO",1329,436,2292,4057,"2018","045"
"25548","PORTO TOLLE",16,0,0,16,"2018","039"
"25549","PORTO VALTRAVAGLIA",14,0,8,22,"2018","114"
"25550","PORTO VIRO",4469,0,0,4469,"2018","052"
"25551","PORTOBUFFOLE'",2,0,1,3,"2018","060"
"25552","PORTOGRUARO",1322,79,1,1402,"2018","029"
"25553","PORTOMAGGIORE",790,424,0,1214,"2018","019"
"25554","PORTULA",6,0,0,6,"2018","048"
"25555","POSINA",1,14,0,15,"2018","080"
"25556","POSSAGNO",7,14,0,21,"2018","061"
"25557","POSTALESIO",1,0,0,1,"2018","053"
"25558","POSTUA",1,3,0,4,"2018","102"
"25559","POVE DEL GRAPPA",7,0,0,7,"2018","081"
"25560","POVEGLIANO",136,152,5,293,"2018","062"
"25561","POVEGLIANO VERONESE",2599,481,0,3080,"2018","060"
"25562","POVIGLIO",10,1262,0,1272,"2018","029"
"25563","POZZAGLIO ED UNITI",25,2375,284,2684,"2018","077"
"25564","POZZO D'ADDA",221,0,0,221,"2018","177"
"25565","POZZOL GROPPO",49,0,0,49,"2018","137"
"25566","POZZOLENGO",594,366,37,997,"2018","151"
"25567","POZZOLEONE",87,2183,0,2270,"2018","082"
"25568","POZZOLO FORMIGARO",32,0,271,303,"2018","138"
"25569","POZZONOVO",2009,0,0,2009,"2018","070"
"25570","POZZUOLO MARTESANA",14,211,0,225,"2018","178"
"25571","PRADALUNGA",29,0,0,29,"2018","173"
"25572","PRADLEVES",3,3,1,7,"2018","173"
"25573","PRAGELATO",11,0,4,15,"2018","201"
"25574","PRALBOINO",1461,867,19,2347,"2018","152"
"25575","PRALI",50,0,0,50,"2018","202"
"25576","PRALORMO",1238,373,0,1611,"2018","203"
"25577","PRALUNGO",96,0,32,128,"2018","049"
"25578","PRAMAGGIORE",7,16,0,23,"2018","030"
"25579","PRAMOLLO",4,0,0,4,"2018","204"
"25580","PRAROSTINO",26,8,0,34,"2018","205"
"25581","PRASCO",16,0,0,16,"2018","139"
"25582","PRASCORSANO",2,0,0,2,"2018","206"
"25583","PRATA CAMPORTACCIO",14,121,40,175,"2018","054"
"25584","PRATIGLIONE",4,0,0,4,"2018","207"
"25585","PRATO SESIA",0,11,0,11,"2018","122"
"25586","PRAY",59,0,0,59,"2018","050"
"25587","PRAZZO",227,20,28,275,"2018","174"
"25588","PREDAPPIO",139,25,0,164,"2018","032"
"25589","PREDORE",23,0,0,23,"2018","174"
"25590","PREDOSA",153,94,0,247,"2018","140"
"25591","PREGANZIOL",21,177,0,198,"2018","063"
"25592","PREGNANA MILANESE",5,146,0,151,"2018","179"
"25593","PREMANA",6,10,1,17,"2018","069"
"25594","PREMENO",5,0,0,5,"2018","055"
"25595","PREMIA",29,214,5,248,"2018","056"
"25596","PREMILCUORE",327,0,36,363,"2018","033"
"25597","PREMOLO",12,13,0,25,"2018","175"
"25598","PREMOSELLO-CHIOVENDA",16,0,0,16,"2018","057"
"25599","PRESEGLIE",48,0,2,50,"2018","153"
"25600","PRESEZZO",3,0,0,3,"2018",NA
"25601","PRESSANA",4936,48,0,4984,"2018","061"
"25602","PREVALLE",75,578,37,690,"2018","155"
"25603","PRIERO",25,0,0,25,"2018","175"
"25604","PRIGNANO SULLA SECCHIA",132,1180,0,1312,"2018","033"
"25605","PRIMALUNA",17,58,3,78,"2018","070"
"25606","PRIOCCA",587,0,0,587,"2018","176"
"25607","PRIOLA",67,0,0,67,"2018","177"
"25608","PROSERPIO",2,5,0,7,"2018","192"
"25609","PROVAGLIO D'ISEO",122,195,6,323,"2018","156"
"25610","PROVAGLIO VAL SABBIA",22,0,4,26,"2018","157"
"25611","PRUNETTO",57,0,0,57,"2018","178"
"25612","PUEGNAGO SUL GARDA",11,131,0,142,"2018","158"
"25613","PUMENENGO",1556,740,211,2507,"2018","177"
"25614","PUSIANO",0,0,1,1,"2018","193"
"25615","QUAGLIUZZO",13,0,0,13,"2018","208"
"25616","QUARGNENTO",1030,0,0,1030,"2018","141"
"25617","QUARNA SOPRA",1,0,0,1,"2018","058"
"25618","QUARNA SOTTO",6,0,0,6,"2018","059"
"25619","QUARONA",12,9,0,21,"2018","107"
"25620","QUARTO D'ALTINO",8,51,0,59,"2018","031"
"25621","QUASSOLO",54,29,0,83,"2018","209"
"25622","QUATTORDIO",587,0,0,587,"2018","142"
"25623","QUATTRO CASTELLA",7,1369,0,1376,"2018","030"
"25624","QUERO VAS",24,70,3,97,"2018",NA
"25625","QUINCINETTO",34,41,0,75,"2018","210"
"25626","QUINGENTOLE",694,72,104,870,"2018","046"
"25627","QUINTANO",0,353,1,354,"2018","078"
"25628","QUINTO DI TREVISO",144,162,20,326,"2018","064"
"25629","QUINTO VERCELLESE",49,0,0,49,"2018","108"
"25630","QUINTO VICENTINO",55,766,0,821,"2018","083"
"25631","QUINZANO D'OGLIO",327,3044,0,3371,"2018","159"
"25632","QUISTELLO",177,1418,734,2329,"2018","047"
"25633","RACCONIGI",2381,1916,134,4431,"2018","179"
"25634","RANCIO VALCUVIA",5,0,0,5,"2018","115"
"25635","RANCO",0,0,28,28,"2018","116"
"25636","RANICA",31,15,0,46,"2018","178"
"25637","RANZANICO",3,26,0,29,"2018","179"
"25638","RAVENNA",1075,1302,0,2377,"2018","014"
"25639","RE",20,0,0,20,"2018","060"
"25640","REANO",20,0,3,23,"2018","211"
"25641","RECOARO TERME",69,94,0,163,"2018","084"
"25642","REDAVALLE",50,0,0,50,"2018","120"
"25643","REDONDESCO",163,516,717,1396,"2018","048"
"25644","REFRANCORE",36,0,0,36,"2018","089"
"25645","REFRONTOLO",14,23,2,39,"2018","065"
"25646","REGGIO NELL'EMILIA",51,10773,7,10831,"2018","033"
"25647","REGGIOLO",1142,2329,0,3471,"2018","032"
"25648","REMEDELLO",6008,2318,158,8484,"2018","160"
"25649","RENATE",3,0,2,5,"2018",NA
"25650","RESANA",2420,51,5,2476,"2018","066"
"25651","RETORBIDO",1,0,0,1,"2018",NA
"25652","REVELLO",7047,1794,293,9134,"2018","180"
"25653","REVIGLIASCO D'ASTI",306,0,0,306,"2018","090"
"25654","REVINE LAGO",21,0,0,21,"2018","067"
"25655","REZZATO",460,551,0,1011,"2018","161"
"25656","RHO",1,422,0,423,"2018","182"
"25657","RIBORDONE",4,0,0,4,"2018","212"
"25658","RICCIONE",2,0,0,2,"2018","013"
"25659","RICENGO",21,2141,123,2285,"2018","079"
"25660","RIESE PIO X",8804,415,32,9251,"2018","068"
"25661","RIFREDDO",1107,10,46,1163,"2018","181"
"25662","RIMELLA",4,9,11,24,"2018","113"
"25663","RIMINI",110,127,0,237,"2018","014"
"25664","RIO SALICETO",1044,388,0,1432,"2018","034"
"25665","RIOLO TERME",353,0,0,353,"2018","015"
"25666","RIOLUNATO",48,20,0,68,"2018","035"
"25667","RIPALTA ARPINA",0,327,59,386,"2018","080"
"25668","RIPALTA CREMASCA",1,144,0,145,"2018","081"
"25669","RIPALTA GUERINA",0,539,63,602,"2018","082"
"25670","RIVA DI SOLTO",6,0,0,6,"2018","180"
"25671","RIVA PRESSO CHIERI",3404,113,0,3517,"2018","215"
"25672","RIVA VALDOBBIA",3,23,0,26,"2018","114"
"25673","RIVALBA",76,0,0,76,"2018","213"
"25674","RIVALTA DI TORINO",107,0,0,107,"2018","214"
"25675","RIVAMONTE AGORDINO",0,20,0,20,"2018","043"
"25676","RIVANAZZANO",81,0,0,81,"2018","122"
"25677","RIVARA",131,123,0,254,"2018","216"
"25678","RIVAROLO CANAVESE",1025,506,549,2080,"2018","217"
"25679","RIVAROLO DEL RE ED UNITI",3342,332,0,3674,"2018","083"
"25680","RIVAROLO MANTOVANO",72,1155,279,1506,"2018","050"
"25681","RIVAROSSA",7,123,0,130,"2018","218"
"25682","RIVERGARO",75,1030,0,1105,"2018","038"
"25683","RIVOLI",1576,0,121,1697,"2018","219"
"25684","RIVOLI VERONESE",162,0,9,171,"2018","062"
"25685","RIVOLTA D'ADDA",1902,2572,94,4568,"2018","084"
"25686","RO",10,45,0,55,"2018","020"
"25687","ROANA",40,403,0,443,"2018","085"
"25688","ROASCIO",11,0,0,11,"2018","184"
"25689","ROASIO",17,0,0,17,"2018","116"
"25690","ROATTO",99,0,0,99,"2018","091"
"25691","ROBASSOMERO",57,68,0,125,"2018","220"
"25692","ROBBIO",4,181,0,185,"2018","123"
"25693","ROBECCHETTO CON INDUNO",249,195,22,466,"2018","183"
"25694","ROBECCO D'OGLIO",1,2865,0,2866,"2018","085"
"25695","ROBECCO SUL NAVIGLIO",85,637,0,722,"2018","184"
"25696","ROBELLA",343,0,0,343,"2018","092"
"25697","ROBILANTE",244,0,0,244,"2018","185"
"25698","ROBURENT",20,0,0,20,"2018","186"
"25699","ROCCA CANAVESE",100,0,0,100,"2018","221"
"25700","ROCCA CIGLIE'",2,0,0,2,"2018","188"
"25701","ROCCA D'ARAZZO",381,0,0,381,"2018","093"
"25702","ROCCA DE' BALDI",2584,875,748,4207,"2018","189"
"25703","ROCCA GRIMALDA",10,0,0,10,"2018","147"
"25704","ROCCA PIETORE",0,8,0,8,"2018","044"
"25705","ROCCA SAN CASCIANO",99,0,0,99,"2018","036"
"25706","ROCCA SUSELLA",3,0,0,3,"2018",NA
"25707","ROCCABIANCA",0,989,0,989,"2018","030"
"25708","ROCCABRUNA",81,56,31,168,"2018","187"
"25709","ROCCAFORTE LIGURE",47,0,0,47,"2018","146"
"25710","ROCCAFORTE MONDOVI'",1184,0,7,1191,"2018","190"
"25711","ROCCAFRANCA",1926,1545,24,3495,"2018","162"
"25712","ROCCASPARVERA",523,0,0,523,"2018","191"
"25713","ROCCAVERANO",141,0,0,141,"2018","094"
"25714","ROCCAVIONE",37,0,0,37,"2018","192"
"25715","ROCCHETTA LIGURE",48,0,0,48,"2018","148"
"25716","ROCCHETTA PALAFEA",18,0,0,18,"2018","095"
"25717","ROCCHETTA TANARO",344,0,0,344,"2018","096"
"25718","RODANO",62,108,0,170,"2018","185"
"25719","RODDI",76,17,0,93,"2018","194"
"25720","RODDINO",92,0,0,92,"2018","195"
"25721","RODELLO",108,0,0,108,"2018","196"
"25722","RODENGO-SAIANO",18,268,98,384,"2018","163"
"25723","RODERO",2,7,0,9,"2018",NA
"25724","RODIGO",943,767,1771,3481,"2018","051"
"25725","ROE' VOLCIANO",8,0,0,8,"2018","164"
"25726","ROGENO",17,248,55,320,"2018","072"
"25727","ROGNANO",17,0,0,17,"2018","127"
"25728","ROGNO",12,84,0,96,"2018","182"
"25729","ROGOLO",4,16,0,20,"2018","056"
"25730","ROLETTO",219,81,0,300,"2018","222"
"25731","ROLO",14,292,0,306,"2018","035"
"25732","ROMAGNANO SESIA",31,0,0,31,"2018","130"
"25733","ROMAGNESE",86,0,0,86,"2018","128"
"25734","ROMANENGO",0,1848,222,2070,"2018","086"
"25735","ROMANO CANAVESE",45,0,0,45,"2018","223"
"25736","ROMANO D'EZZELINO",281,444,0,725,"2018","086"
"25737","ROMANO DI LOMBARDIA",159,3395,0,3554,"2018","183"
"25738","ROMENTINO",12,0,0,12,"2018","131"
"25739","RONAGO",6,0,30,36,"2018","199"
"25740","RONCA'",6,1,0,7,"2018","063"
"25741","RONCADE",1910,124,0,2034,"2018","069"
"25742","RONCADELLE",277,684,0,961,"2018","165"
"25743","RONCO ALL'ADIGE",6066,0,0,6066,"2018","064"
"25744","RONCO BIELLESE",5,57,0,62,"2018","053"
"25745","RONCO BRIANTINO",0,165,0,165,"2018",NA
"25746","RONCO CANAVESE",93,0,0,93,"2018","224"
"25747","RONCOFERRARO",3126,431,630,4187,"2018","052"
"25748","RONCOFREDDO",15,34,0,49,"2018","037"
"25749","RONCOLA",24,34,0,58,"2018","185"
"25750","RONSECCO",5,0,0,5,"2018",NA
"25751","ROPPOLO",7,0,0,7,"2018","054"
"25752","RORA'",16,0,0,16,"2018","226"
"25753","ROSA'",134,828,0,962,"2018","087"
"25754","ROSATE",3316,470,0,3786,"2018","188"
"25755","ROSIGNANO MONFERRATO",117,0,0,117,"2018","149"
"25756","ROSOLINA",6,0,0,6,"2018","040"
"25757","ROSSA",7,18,0,25,"2018","121"
"25758","ROSSANA",77,101,0,178,"2018","197"
"25759","ROSSANO VENETO",306,172,11,489,"2018","088"
"25760","ROSTA",29,0,82,111,"2018","228"
"25761","ROTA D'IMAGNA",8,42,0,50,"2018","186"
"25762","ROTTOFRENO",607,904,0,1511,"2018","039"
"25763","ROTZO",102,0,0,102,"2018","089"
"25764","ROURE",9,0,0,9,"2018","227"
"25765","ROVASENDA",17,0,0,17,"2018","122"
"25766","ROVATO",1775,2112,163,4050,"2018","166"
"25767","ROVELLASCA",3,64,0,67,"2018","201"
"25768","ROVELLO PORRO",2,0,0,2,"2018",NA
"25769","ROVERBELLA",13559,486,282,14327,"2018","053"
"25770","ROVERCHIARA",4224,10,112,4346,"2018","065"
"25771","ROVERE' VERONESE",352,1220,0,1572,"2018","067"
"25772","ROVEREDO DI GUA'",1503,72,27,1602,"2018","066"
"25773","ROVESCALA",20,0,0,20,"2018","131"
"25774","ROVETTA",33,142,0,175,"2018","187"
"25775","ROVIGO",1549,0,0,1549,"2018","041"
"25776","ROVOLON",221,10,77,308,"2018","071"
"25777","RUBANO",28,31,36,95,"2018","072"
"25778","RUBIANA",3,0,0,3,"2018","229"
"25779","RUBIERA",12,392,0,404,"2018","036"
"25780","RUDIANO",371,1055,55,1481,"2018","167"
"25781","RUEGLIO",133,65,0,198,"2018","230"
"25782","RUFFIA",270,219,54,543,"2018","198"
"25783","RUINO",86,0,0,86,"2018","132"
"25784","RUSSI",10,0,0,10,"2018","016"
"25785","SABBIO CHIESE",25,40,12,77,"2018","168"
"25786","SABBIONETA",7,67,19,93,"2018","054"
"25787","SACCOLONGO",73,398,60,531,"2018","073"
"25788","SAGLIANO MICCA",37,0,0,37,"2018","056"
"25789","SALA BAGANZA",8,101,16,125,"2018","031"
"25790","SALA BIELLESE",1,0,0,1,"2018","057"
"25791","SALA BOLOGNESE",334,0,0,334,"2018","050"
"25792","SALA COMACINA",0,0,1,1,"2018","203"
"25793","SALA MONFERRATO",87,0,0,87,"2018","150"
"25794","SALARA",2,0,0,2,"2018","042"
"25795","SALASSA",10,0,0,10,"2018","231"
"25796","SALBERTRAND",35,0,0,35,"2018","232"
"25797","SALCEDO",873,65,0,938,"2018","090"
"25798","SALE DELLE LANGHE",155,0,0,155,"2018","199"
"25799","SALE MARASINO",40,37,2,79,"2018","169"
"25800","SALE SAN GIOVANNI",59,0,0,59,"2018","200"
"25801","SALERANO CANAVESE",1,0,0,1,"2018",NA
"25802","SALERANO SUL LAMBRO",4,325,0,329,"2018","046"
"25803","SALGAREDA",2129,190,0,2319,"2018","070"
"25804","SALICETO",74,0,0,74,"2018","201"
"25805","SALIZZOLE",2557,484,30,3071,"2018","068"
"25806","SALMOUR",249,0,0,249,"2018","202"
"25807","SALO'",0,26,2,28,"2018","170"
"25808","SALSOMAGGIORE TERME",16,996,0,1012,"2018","032"
"25809","SALTRIO",39,0,0,39,"2018","117"
"25810","SALUDECIO",54,0,0,54,"2018","015"
"25811","SALUGGIA",484,147,0,631,"2018","128"
"25812","SALUSSOLA",453,116,0,569,"2018","058"
"25813","SALUZZO",3538,3359,565,7462,"2018","203"
"25814","SALVIROLA",677,73,0,750,"2018","087"
"25815","SALZANO",278,25,2,305,"2018","032"
"25816","SAMARATE",33,0,0,33,"2018","118"
"25817","SAMBUCO",29,0,0,29,"2018","204"
"25818","SAMOLACO",180,641,49,870,"2018","057"
"25819","SAMONE",2,0,0,2,"2018","235"
"25820","SAMPEYRE",255,76,0,331,"2018","205"
"25821","SAN BARTOLOMEO VAL CAVARGNA",4,0,3,7,"2018","204"
"25822","SAN BASSANO",8,1568,0,1576,"2018","088"
"25823","SAN BELLINO",1112,0,0,1112,"2018","043"
"25824","SAN BENEDETTO BELBO",34,0,0,34,"2018","206"
"25825","SAN BENEDETTO PO",534,1664,1021,3219,"2018","055"
"25826","SAN BENEDETTO VAL DI SAMBRO",256,76,0,332,"2018","051"
"25827","SAN BENIGNO CANAVESE",238,0,17,255,"2018","236"
"25828","SAN BERNARDINO VERBANO",4,0,0,4,"2018","061"
"25829","SAN BIAGIO DI CALLALTA",362,41,0,403,"2018","071"
"25830","SAN BONIFACIO",2088,0,0,2088,"2018","069"
"25831","SAN CARLO CANAVESE",218,155,126,499,"2018","237"
"25832","SAN CESARIO SUL PANARO",28,789,0,817,"2018","036"
"25833","SAN CIPRIANO PO",12,271,0,283,"2018","133"
"25834","SAN CLEMENTE",13,0,0,13,"2018","016"
"25835","SAN COLOMBANO AL LAMBRO",28,243,0,271,"2018","191"
"25836","SAN COLOMBANO BELMONTE",5,17,0,22,"2018","238"
"25837","SAN CRISTOFORO",9,0,0,9,"2018","152"
"25838","SAN DAMIANO D'ASTI",4149,0,0,4149,"2018","097"
"25839","SAN DAMIANO MACRA",42,0,0,42,"2018","207"
"25840","SAN DANIELE PO",10,1706,0,1716,"2018","089"
"25841","SAN DIDERO",0,6,0,6,"2018","239"
"25842","SAN DONA' DI PIAVE",286,364,8,658,"2018","033"
"25843","SAN DONATO MILANESE",1,0,0,1,"2018","192"
"25844","SAN FELICE DEL BENACO",3,0,2,5,"2018","171"
"25845","SAN FELICE SUL PANARO",0,674,0,674,"2018","037"
"25846","SAN FERMO DELLA BATTAGLIA",19,0,21,40,"2018","206"
"25847","SAN FIOR",15,21,5,41,"2018","072"
"25848","SAN FIORANO",0,191,0,191,"2018","047"
"25849","SAN FRANCESCO AL CAMPO",623,309,0,932,"2018","240"
"25850","SAN GENESIO ED UNITI",5,548,5,558,"2018","135"
"25851","SAN GERMANO CHISONE",62,21,0,83,"2018","242"
"25852","SAN GERMANO VERCELLESE",10,0,0,10,"2018","131"
"25853","SAN GERVASIO BRESCIANO",1,268,0,269,"2018","172"
"25854","SAN GIACOMO DELLE SEGNATE",372,155,159,686,"2018","056"
"25855","SAN GIACOMO FILIPPO",2,0,0,2,"2018","058"
"25856","SAN GIACOMO VERCELLESE",1298,0,0,1298,"2018","035"
"25857","SAN GILLIO",161,63,0,224,"2018","243"
"25858","SAN GIORGIO CANAVESE",311,24,0,335,"2018","244"
"25859","SAN GIORGIO DELLE PERTICHE",269,84,0,353,"2018","075"
"25860","SAN GIORGIO DI LOMELLINA",5,0,0,5,"2018","136"
"25861","SAN GIORGIO DI MANTOVA",428,75,0,503,"2018","057"
"25862","SAN GIORGIO DI PIANO",24,0,0,24,"2018","052"
"25863","SAN GIORGIO IN BOSCO",243,803,0,1046,"2018","076"
"25864","SAN GIORGIO MONFERRATO",16,0,0,16,"2018","153"
"25865","SAN GIORGIO PIACENTINO",162,780,0,942,"2018","040"
"25866","SAN GIORGIO SCARAMPI",70,0,0,70,"2018","098"
"25867","SAN GIORIO DI SUSA",2,10,0,12,"2018","245"
"25868","SAN GIOVANNI BIANCO",42,19,0,61,"2018","188"
"25869","SAN GIOVANNI DEL DOSSO",0,293,77,370,"2018","058"
"25870","SAN GIOVANNI ILARIONE",802,4,0,806,"2018","070"
"25871","SAN GIOVANNI IN CROCE",0,496,2,498,"2018","090"
"25872","SAN GIOVANNI IN MARIGNANO",6,0,0,6,"2018","017"
"25873","SAN GIOVANNI IN PERSICETO",20,769,0,789,"2018","053"
"25874","SAN GIOVANNI LUPATOTO",668,102,0,770,"2018","071"
"25875","SAN GIULIANO MILANESE",20,522,42,584,"2018","195"
"25876","SAN GIUSTO CANAVESE",107,23,0,130,"2018","246"
"25877","SAN GREGORIO NELLE ALPI",13,48,0,61,"2018","045"
"25878","SAN LAZZARO DI SAVENA",2,0,0,2,"2018","054"
"25879","SAN LEO",278,371,0,649,"2018","025"
"25880","SAN MARTINO ALFIERI",13,0,0,13,"2018","099"
"25881","SAN MARTINO BUON ALBERGO",258,1106,0,1364,"2018","073"
"25882","SAN MARTINO CANAVESE",53,0,0,53,"2018","247"
"25883","SAN MARTINO DALL'ARGINE",440,946,96,1482,"2018","059"
"25884","SAN MARTINO DEL LAGO",10,0,0,10,"2018","091"
"25885","SAN MARTINO DI LUPARI",2352,415,0,2767,"2018","077"
"25886","SAN MARTINO IN RIO",1,884,0,885,"2018","037"
"25887","SAN MARTINO IN STRADA",0,934,0,934,"2018","048"
"25888","SAN MARTINO SICCOMARIO",0,1,0,1,"2018","137"
"25889","SAN MARZANO OLIVETO",35,0,0,35,"2018","100"
"25890","SAN MAURIZIO CANAVESE",121,283,245,649,"2018","248"
"25891","SAN MAURIZIO D'OPAGLIO",12,0,0,12,"2018","133"
"25892","SAN MAURO DI SALINE",46,335,32,413,"2018","074"
"25893","SAN MAURO TORINESE",5,0,0,5,"2018","249"
"25894","SAN MICHELE AL TAGLIAMENTO",2224,42,0,2266,"2018","034"
"25895","SAN MICHELE MONDOVI'",168,0,0,168,"2018","210"
"25896","SAN NAZARIO",26,0,0,26,"2018","093"
"25897","SAN NAZZARO SESIA",115,0,0,115,"2018","134"
"25898","SAN NAZZARO VAL CAVARGNA",6,0,5,11,"2018","207"
"25899","SAN NICOLO' DI COMELICO",1,14,0,15,"2018","046"
"25900","SAN PAOLO",304,2491,32,2827,"2018","138"
"25901","SAN PAOLO D'ARGON",22,32,13,67,"2018","189"
"25902","SAN PAOLO SOLBRITO",23,0,0,23,"2018","101"
"25903","SAN PELLEGRINO TERME",58,39,0,97,"2018","190"
"25904","SAN PIETRO DI CADORE",0,71,0,71,"2018","047"
"25905","SAN PIETRO DI FELETTO",20,13,0,33,"2018","073"
"25906","SAN PIETRO DI MORUBIO",2,0,0,2,"2018","075"
"25907","SAN PIETRO IN CASALE",25,165,0,190,"2018","055"
"25908","SAN PIETRO IN CERRO",95,978,0,1073,"2018","041"
"25909","SAN PIETRO IN GU",737,3127,0,3864,"2018","078"
"25910","SAN PIETRO MOSEZZO",10,0,0,10,"2018","135"
"25911","SAN PIETRO MUSSOLINO",9,0,0,9,"2018","094"
"25912","SAN PIETRO VAL LEMINA",5,0,0,5,"2018","250"
"25913","SAN PIETRO VIMINARIO",403,35,0,438,"2018","079"
"25914","SAN POLO D'ENZA",0,621,0,621,"2018","038"
"25915","SAN POLO DI PIAVE",858,62,0,920,"2018","074"
"25916","SAN PONSO",2,58,0,60,"2018","251"
"25917","SAN POSSIDONIO",486,402,0,888,"2018","038"
"25918","SAN PROSPERO",0,321,0,321,"2018","039"
"25919","SAN RAFFAELE CIMENA",35,0,0,35,"2018","252"
"25920","SAN ROCCO AL PORTO",197,726,0,923,"2018","049"
"25921","SAN SALVATORE MONFERRATO",174,0,0,174,"2018","154"
"25922","SAN SEBASTIANO CURONE",18,0,0,18,"2018","155"
"25923","SAN SEBASTIANO DA PO",298,0,0,298,"2018","253"
"25924","SAN SECONDO DI PINEROLO",608,29,70,707,"2018","254"
"25925","SAN SECONDO PARMENSE",2,1459,0,1461,"2018","033"
"25926","SAN SIRO",3,0,5,8,"2018","248"
"25927","SAN VENDEMIANO",73,138,8,219,"2018","076"
"25928","SAN VITO DI LEGUZZANO",426,137,0,563,"2018","096"
"25929","SAN VITTORE OLONA",23,35,0,58,"2018","201"
"25930","SAN ZENO DI MONTAGNA",188,161,44,393,"2018","079"
"25931","SAN ZENO NAVIGLIO",0,511,0,511,"2018","173"
"25932","SAN ZENONE AL LAMBRO",0,830,0,830,"2018","202"
"25933","SAN ZENONE DEGLI EZZELINI",2472,432,3,2907,"2018","077"
"25934","SANDIGLIANO",55,93,0,148,"2018","059"
"25935","SANDRIGO",1441,1685,0,3126,"2018","091"
"25936","SANFRE'",670,0,18,688,"2018","208"
"25937","SANFRONT",1889,138,62,2089,"2018","209"
"25938","SANGANO",58,0,35,93,"2018","241"
"25939","SANGIANO",1,32,0,33,"2018","141"
"25940","SANGUINETTO",6,190,0,196,"2018","072"
"25941","SANNAZZARO DE' BURGONDI",36,57,0,93,"2018","138"
"25942","SANT'AGATA BOLOGNESE",4,684,0,688,"2018","056"
"25943","SANT'AGATA FELTRIA",186,45,0,231,"2018","026"
"25944","SANT'AGATA FOSSILI",65,0,0,65,"2018","156"
"25945","SANT'AGATA SUL SANTERNO",21,0,0,21,"2018","017"
"25946","SANT'ALBANO STURA",4386,767,12,5165,"2018","211"
"25947","SANT'ALESSIO CON VIALONE",0,1,0,1,"2018","141"
"25948","SANT'AMBROGIO DI TORINO",50,17,21,88,"2018","255"
"25949","SANT'AMBROGIO DI VALPOLICELLA",5,54,0,59,"2018","077"
"25950","SANT'ANGELO DI PIOVE DI SACCO",295,61,0,356,"2018","082"
"25951","SANT'ANGELO LODIGIANO",35,333,0,368,"2018","050"
"25952","SANT'ANGELO LOMELLINA",0,422,0,422,"2018","144"
"25953","SANT'ANNA D'ALFAEDO",183,1339,140,1662,"2018","078"
"25954","SANT'ANTONINO DI SUSA",4,42,34,80,"2018","256"
"25955","SANT'ELENA",56,0,0,56,"2018","083"
"25956","SANT'ILARIO D'ENZA",1,806,0,807,"2018","039"
"25957","SANT'OMOBONO TERME",78,42,0,120,"2018","192"
"25958","SANT'URBANO",680,0,1,681,"2018","084"
"25959","SANTA BRIGIDA",9,24,0,33,"2018","191"
"25960","SANTA CRISTINA E BISSONE",18,106,0,124,"2018","139"
"25961","SANTA GIULETTA",15,0,0,15,"2018","140"
"25962","SANTA GIUSTINA",1791,109,0,1900,"2018","048"
"25963","SANTA GIUSTINA IN COLLE",1301,340,2,1643,"2018","080"
"25964","SANTA LUCIA DI PIAVE",28,67,9,104,"2018","075"
"25965","SANTA MARGHERITA DI STAFFORA",23,0,28,51,"2018","142"
"25966","SANTA MARIA DELLA VERSA",4,0,0,4,"2018","143"
"25967","SANTA MARIA DI SALA",67,185,14,266,"2018","035"
"25968","SANTA MARIA HOE'",6,0,0,6,"2018","074"
"25969","SANTA MARIA MAGGIORE",26,0,18,44,"2018","062"
"25970","SANTA SOFIA",238,1,0,239,"2018","043"
"25971","SANTA VITTORIA D'ALBA",55,0,0,55,"2018","212"
"25972","SANTARCANGELO DI ROMAGNA",35,0,0,35,"2018","018"
"25973","SANTENA",499,0,0,499,"2018","257"
"25974","SANTHIA'",325,37,0,362,"2018","133"
"25975","SANTO STEFANO BELBO",10,0,0,10,"2018","213"
"25976","SANTO STEFANO DI CADORE",4,20,0,24,"2018","050"
"25977","SANTO STEFANO LODIGIANO",62,393,1,456,"2018","051"
"25978","SANTO STEFANO ROERO",79,0,0,79,"2018","214"
"25979","SANTO STEFANO TICINO",0,40,0,40,"2018","200"
"25980","SANTO STINO DI LIVENZA",3756,103,3,3862,"2018","036"
"25981","SANTORSO",436,183,0,619,"2018","095"
"25982","SAONARA",275,2,2,279,"2018","085"
"25983","SARCEDO",1581,344,0,1925,"2018","097"
"25984","SARDIGLIANO",2,0,0,2,"2018","157"
"25985","SAREGO",340,28,0,368,"2018","098"
"25986","SAREZZO",10,20,0,30,"2018","174"
"25987","SARMATO",0,263,0,263,"2018","042"
"25988","SARMEDE",34,52,1,87,"2018","078"
"25989","SARNICO",6,0,0,6,"2018","193"
"25990","SARONNO",0,0,6,6,"2018","119"
"25991","SARSINA",173,0,0,173,"2018","044"
"25992","SASSO MARCONI",72,0,0,72,"2018","057"
"25993","SASSUOLO",32,359,0,391,"2018","040"
"25994","SAUZE D'OULX",75,0,0,75,"2018","259"
"25995","SAUZE DI CESANA",52,0,0,52,"2018","258"
"25996","SAVIGLIANO",11364,5157,200,16721,"2018","215"
"25997","SAVIGNANO SUL PANARO",56,75,0,131,"2018","041"
"25998","SAVIGNANO SUL RUBICONE",36,0,0,36,"2018","045"
"25999","SAVIORE DELL'ADAMELLO",3,24,4,31,"2018","175"
"26000","SCAGNELLO",171,0,0,171,"2018","216"
"26001","SCALDASOLE",0,17,0,17,"2018","147"
"26002","SCALENGHE",1645,2004,303,3952,"2018","260"
"26003","SCANDIANO",32,1175,0,1207,"2018","040"
"26004","SCANDOLARA RAVARA",0,733,0,733,"2018","092"
"26005","SCANDOLARA RIPA D'OGLIO",28,739,66,833,"2018","093"
"26006","SCANZOROSCIATE",36,0,0,36,"2018","194"
"26007","SCARMAGNO",3,0,0,3,"2018","261"
"26008","SCARNAFIGI",1248,1640,31,2919,"2018","217"
"26009","SCHIAVON",2255,1804,6,4065,"2018","099"
"26010","SCHIGNANO",4,2,16,22,"2018","211"
"26011","SCHILPARIO",0,61,0,61,"2018","195"
"26012","SCHIO",365,263,1,629,"2018","100"
"26013","SCIOLZE",147,0,0,147,"2018","262"
"26014","SCOPA",1,0,0,1,"2018","134"
"26015","SCOPELLO",24,9,0,33,"2018","135"
"26016","SCORZE'",4704,37,0,4741,"2018","037"
"26017","SECUGNAGO",0,1142,0,1142,"2018","052"
"26018","SEDICO",1693,107,4,1804,"2018","053"
"26019","SEDRIANO",18,783,0,801,"2018","204"
"26020","SEDRINA",23,13,0,36,"2018","196"
"26021","SEGRATE",10,0,0,10,"2018","205"
"26022","SEGUSINO",8,82,0,90,"2018","079"
"26023","SELLERO",2,24,5,31,"2018","176"
"26024","SELVA DI CADORE",0,7,0,7,"2018","054"
"26025","SELVA DI PROGNO",45,639,74,758,"2018","080"
"26026","SELVAZZANO DENTRO",20,0,59,79,"2018","086"
"26027","SELVINO",2,0,0,2,"2018","197"
"26028","SENIGA",1427,1856,0,3283,"2018","177"
"26029","SENNA COMASCO",3,0,30,33,"2018","212"
"26030","SENNA LODIGIANA",11,921,0,932,"2018","053"
"26031","SEREGNO",2,0,0,2,"2018",NA
"26032","SEREN DEL GRAPPA",95,47,179,321,"2018","055"
"26033","SERGNANO",1,1674,12,1687,"2018","094"
"26034","SERIATE",94,89,3,186,"2018","198"
"26035","SERINA",21,89,0,110,"2018","199"
"26036","SERLE",17,25,21,63,"2018","178"
"26037","SERMIDE E FELONICA",1,184,171,356,"2018",NA
"26038","SERNAGLIA DELLA BATTAGLIA",946,14,7,967,"2018","080"
"26039","SERNIO",3,0,0,3,"2018","059"
"26040","SEROLE",78,0,2,80,"2018","104"
"26041","SERRALUNGA D'ALBA",23,0,0,23,"2018","218"
"26042","SERRALUNGA DI CREA",24,0,0,24,"2018","159"
"26043","SERRAMAZZONI",27,1545,0,1572,"2018","042"
"26044","SERRAVALLE A PO",77,0,190,267,"2018","062"
"26045","SERRAVALLE LANGHE",101,0,0,101,"2018","219"
"26046","SERRAVALLE SCRIVIA",8,0,0,8,"2018","160"
"26047","SERRAVALLE SESIA",3,0,0,3,"2018","137"
"26048","SESTO CALENDE",36,0,0,36,"2018","120"
"26049","SESTO ED UNITI",6,1653,396,2055,"2018","095"
"26050","SESTOLA",74,312,0,386,"2018","043"
"26051","SETTALA",32,192,66,290,"2018","210"
"26052","SETTIME",179,0,0,179,"2018","106"
"26053","SETTIMO MILANESE",1,301,7,309,"2018","211"
"26054","SETTIMO ROTTARO",6,38,0,44,"2018","264"
"26055","SETTIMO TORINESE",382,271,135,788,"2018","265"
"26056","SETTIMO VITTONE",169,150,0,319,"2018","266"
"26057","SEVESO",1,0,0,1,"2018",NA
"26058","SEZZADIO",58,0,0,58,"2018","161"
"26059","SILEA",7,104,0,111,"2018","081"
"26060","SILLAVENGO",17,111,0,128,"2018","138"
"26061","SILVANO D'ORBA",6,0,0,6,"2018","162"
"26062","SINIO",13,5,0,18,"2018","220"
"26063","SIRONE",8,85,1,94,"2018","075"
"26064","SIRTORI",3,0,0,3,"2018","076"
"26065","SISSA TRECASALI",16,896,0,912,"2018",NA
"26066","SIZIANO",63,71,0,134,"2018","150"
"26067","SIZZANO",213,17,99,329,"2018","139"
"26068","SOAVE",51,0,0,51,"2018","081"
"26069","SOGLIANO AL RUBICONE",178,44,0,222,"2018","046"
"26070","SOGLIO",1,0,0,1,"2018","107"
"26071","SOIANO DEL LAGO",0,0,7,7,"2018","180"
"26072","SOLAGNA",0,12,0,12,"2018","101"
"26073","SOLARO",0,24,0,24,"2018","213"
"26074","SOLAROLO RAINERIO",13,276,0,289,"2018","096"
"26075","SOLBIATE",3,135,0,138,"2018","215"
"26076","SOLERO",294,0,0,294,"2018","163"
"26077","SOLESINO",6,0,0,6,"2018","087"
"26078","SOLFERINO",658,197,235,1090,"2018","063"
"26079","SOLIERA",32,905,0,937,"2018","044"
"26080","SOLIGNANO",12,209,0,221,"2018","035"
"26081","SOLONGHELLO",100,0,0,100,"2018","164"
"26082","SOLTO COLLINA",10,0,3,13,"2018","200"
"26083","SOMAGLIA",0,1204,0,1204,"2018","054"
"26084","SOMANO",38,0,0,38,"2018","221"
"26085","SOMMA LOMBARDO",60,8,0,68,"2018","123"
"26086","SOMMACAMPAGNA",1610,380,71,2061,"2018","082"
"26087","SOMMARIVA DEL BOSCO",1248,565,149,1962,"2018","222"
"26088","SOMMARIVA PERNO",17,0,0,17,"2018","223"
"26089","SOMMO",27,0,0,27,"2018","151"
"26090","SONA",2351,627,11,2989,"2018","083"
"26091","SONCINO",587,4681,528,5796,"2018","097"
"26092","SONDALO",19,75,12,106,"2018","060"
"26093","SONDRIO",8,36,0,44,"2018","061"
"26094","SONGAVAZZO",1,0,0,1,"2018","201"
"26095","SONICO",2,62,15,79,"2018","181"
"26096","SORAGNA",11,1465,0,1476,"2018","036"
"26097","SORBOLO",0,1451,0,1451,"2018","037"
"26098","SORDEVOLO",86,28,0,114,"2018","063"
"26099","SORDIO",0,281,0,281,"2018","055"
"26100","SORESINA",30,1170,0,1200,"2018","098"
"26101","SORGA'",1641,48,0,1689,"2018","084"
"26102","SORICO",6,21,77,104,"2018","216"
"26103","SORISO",6,0,0,6,"2018","140"
"26104","SORISOLE",49,58,0,107,"2018","202"
"26105","SORMANO",18,0,5,23,"2018","217"
"26106","SOSPIRO",81,374,1,456,"2018","099"
"26107","SOSPIROLO",5,101,0,106,"2018","056"
"26108","SOSSANO",38,358,0,396,"2018","102"
"26109","SOSTEGNO",4,18,0,22,"2018","064"
"26110","SOTTO IL MONTE GIOVANNI XXIII",47,64,0,111,"2018","203"
"26111","SOVERE",47,31,0,78,"2018","204"
"26112","SOVERZENE",4,0,0,4,"2018","057"
"26113","SOVICO",1,0,0,1,"2018",NA
"26114","SOVIZZO",485,105,0,590,"2018","103"
"26115","SOVRAMONTE",14,76,0,90,"2018","058"
"26116","SOZZAGO",1,0,0,1,"2018","141"
"26117","SPARONE",46,52,0,98,"2018","267"
"26118","SPESSA",5,0,0,5,"2018","152"
"26119","SPIGNO MONFERRATO",119,8,52,179,"2018","165"
"26120","SPILAMBERTO",2020,1368,0,3388,"2018","045"
"26121","SPINEA",43,112,0,155,"2018","038"
"26122","SPINEDA",2,691,0,693,"2018","101"
"26123","SPINETO SCRIVIA",114,0,0,114,"2018","166"
"26124","SPINO D'ADDA",558,2175,0,2733,"2018","102"
"26125","SPINONE AL LAGO",3,1,0,4,"2018","205"
"26126","SPIRANO",12,1046,0,1058,"2018","206"
"26127","SPRESIANO",57,221,0,278,"2018","082"
"26128","STAGNO LOMBARDO",3,6676,22,6701,"2018","103"
"26129","STANGHELLA",383,0,0,383,"2018","088"
"26130","STAZZANO",9,0,0,9,"2018","167"
"26131","STAZZONA",11,4,7,22,"2018","218"
"26132","STEZZANO",182,328,207,717,"2018","207"
"26133","STIENTA",48,0,2,50,"2018","045"
"26134","STRA",1,0,0,1,"2018","039"
"26135","STRADELLA",3,34,0,37,"2018","153"
"26136","STRAMBINELLO",15,0,0,15,"2018",NA
"26137","STRAMBINO",185,0,1,186,"2018","269"
"26138","STRESA",69,0,0,69,"2018","064"
"26139","STREVI",26,0,0,26,"2018","168"
"26140","STROPPO",7,0,0,7,"2018","224"
"26141","STROZZA",4,0,0,4,"2018","208"
"26142","SUARDI",3,0,0,3,"2018","154"
"26143","SUEGLIO",2,0,0,2,"2018","077"
"26144","SUELLO",4,0,2,6,"2018","078"
"26145","SUISIO",1,91,0,92,"2018","209"
"26146","SULBIATE",31,0,0,31,"2018",NA
"26147","SULZANO",25,226,7,258,"2018","182"
"26148","SUMIRAGO",64,76,0,140,"2018","124"
"26149","SUNO",42,464,0,506,"2018","143"
"26150","SUSA",149,24,0,173,"2018","270"
"26151","SUSEGANA",812,43,0,855,"2018","083"
"26152","SUSTINENTE",536,566,243,1345,"2018","064"
"26153","SUZZARA",1354,1213,2164,4731,"2018","065"
"26154","TACENO",16,0,7,23,"2018","079"
"26155","TAGLIO DI PO",7762,0,0,7762,"2018","046"
"26156","TAGLIOLO MONFERRATO",65,0,0,65,"2018","169"
"26157","TAIBON AGORDINO",0,20,0,20,"2018","059"
"26158","TAINO",41,113,0,154,"2018","125"
"26159","TALAMELLO",1,0,0,1,"2018","027"
"26160","TALAMONA",16,150,0,166,"2018","063"
"26161","TALEGGIO",78,22,0,100,"2018","210"
"26162","TAMBRE",16,140,0,156,"2018","060"
"26163","TARANTASCA",2147,640,0,2787,"2018","225"
"26164","TARTANO",17,12,0,29,"2018","064"
"26165","TARZO",13,22,0,35,"2018","084"
"26166","TAVAGNASCO",117,8,0,125,"2018","271"
"26167","TAVAZZANO CON VILLAVESCO",0,1162,85,1247,"2018","056"
"26168","TAVERNOLA BERGAMASCA",5,5,0,10,"2018","211"
"26169","TAVERNOLE SUL MELLA",16,52,5,73,"2018","183"
"26170","TAVIGLIANO",53,0,0,53,"2018","066"
"26171","TEGLIO",51,205,37,293,"2018","065"
"26172","TELGATE",1707,167,0,1874,"2018","212"
"26173","TEMU'",11,6,7,24,"2018","184"
"26174","TEOLO",37,25,9,71,"2018","089"
"26175","TERDOBBIATE",4,130,0,134,"2018","144"
"26176","TERENZO",62,664,0,726,"2018","038"
"26177","TERNATE",1,0,0,1,"2018",NA
"26178","TERNO D'ISOLA",16,21,0,37,"2018","213"
"26179","TERRANOVA DEI PASSERINI",34,293,242,569,"2018","057"
"26180","TERRASSA PADOVANA",1725,0,0,1725,"2018","090"
"26181","TERRAZZO",0,20,0,20,"2018","085"
"26182","TERRUGGIA",31,0,0,31,"2018","171"
"26183","TERZO",17,0,0,17,"2018","172"
"26184","TEZZE SUL BRENTA",82,284,0,366,"2018","104"
"26185","THIENE",492,375,0,867,"2018","105"
"26186","TICENGO",0,401,0,401,"2018","104"
"26187","TIGLIOLE",1002,0,0,1002,"2018","108"
"26188","TIGNALE",7,0,1,8,"2018","185"
"26189","TIRANO",8,0,11,19,"2018","066"
"26190","TIZZANO VAL PARMA",2,574,0,576,"2018","039"
"26191","TOANO",43,1804,0,1847,"2018","041"
"26192","TOCENO",20,7,31,58,"2018","065"
"26193","TOLLEGNO",18,0,0,18,"2018","068"
"26194","TOMBOLO",1084,36,0,1120,"2018","091"
"26195","TONCO",782,0,0,782,"2018","109"
"26196","TONENGO",100,0,0,100,"2018","110"
"26197","TONEZZA DEL CIMONE",3,0,0,3,"2018","106"
"26198","TORBOLE CASAGLIA",12,861,25,898,"2018","186"
"26199","TORINO",148,0,16,164,"2018","272"
"26200","TORLINO VIMERCATI",0,292,65,357,"2018","105"
"26201","TORNACO",0,90,0,90,"2018",NA
"26202","TORNATA",7,165,0,172,"2018","106"
"26203","TORNOLO",80,5,0,85,"2018","040"
"26204","TORRAZZA COSTE",14,0,0,14,"2018","155"
"26205","TORRAZZA PIEMONTE",151,0,15,166,"2018","273"
"26206","TORRAZZO",7,0,0,7,"2018","069"
"26207","TORRE BERETTI E CASTELLARO",26,404,0,430,"2018","156"
"26208","TORRE BOLDONE",4,0,0,4,"2018","214"
"26209","TORRE BORMIDA",7,0,3,10,"2018","226"
"26210","TORRE D'ISOLA",0,603,0,603,"2018","159"
"26211","TORRE DE' BUSI",7,0,1,8,"2018","080"
"26212","TORRE DE' NEGRI",13,69,258,340,"2018","158"
"26213","TORRE DE' PICENARDI",0,1323,78,1401,"2018","107"
"26214","TORRE DE' ROVERI",19,0,0,19,"2018","216"
"26215","TORRE DI MOSTO",14,527,0,541,"2018","041"
"26216","TORRE DI SANTA MARIA",23,6,0,29,"2018","067"
"26217","TORRE PALLAVICINA",368,337,0,705,"2018","217"
"26218","TORRE PELLICE",76,0,0,76,"2018","275"
"26219","TORRE SAN GIORGIO",68,44,18,130,"2018","228"
"26220","TORREBELVICINO",982,15,0,997,"2018","107"
"26221","TORREGLIA",1,0,0,1,"2018","092"
"26222","TORRESINA",2,0,0,2,"2018","229"
"26223","TORREVECCHIA PIA",56,11,19,86,"2018","160"
"26224","TORRI DEL BENACO",4,0,0,4,"2018",NA
"26225","TORRI DI QUARTESOLO",37,153,7,197,"2018","108"
"26226","TORRICELLA VERZATE",2,0,0,2,"2018",NA
"26227","TORRILE",0,2478,0,2478,"2018","041"
"26228","TORTONA",3058,290,0,3348,"2018","174"
"26229","TOSCOLANO-MADERNO",12,0,0,12,"2018","187"
"26230","TOVO DI SANT'AGATA",3,55,0,58,"2018","068"
"26231","TRADATE",49,0,8,57,"2018","127"
"26232","TRANA",50,0,30,80,"2018","276"
"26233","TRAONA",43,82,94,219,"2018","069"
"26234","TRAREGO VIGGIONA",5,0,0,5,"2018","066"
"26235","TRASQUERA",17,0,4,21,"2018","067"
"26236","TRAUSELLA",15,29,0,44,"2018","277"
"26237","TRAVAGLIATO",606,468,0,1074,"2018","188"
"26238","TRAVEDONA-MONATE",9,0,3,12,"2018","128"
"26239","TRAVERSELLA",55,24,5,84,"2018","278"
"26240","TRAVERSETOLO",44,1007,0,1051,"2018","042"
"26241","TRAVES",10,0,0,10,"2018","279"
"26242","TRAVO",40,30,0,70,"2018","043"
"26243","TREBASELEGHE",7788,91,0,7879,"2018","093"
"26244","TRECATE",0,222,0,222,"2018","149"
"26245","TRECENTA",16,158,0,174,"2018","047"
"26246","TREDOZIO",110,0,0,110,"2018","049"
"26247","TREGNAGO",586,148,0,734,"2018","087"
"26248","TREMEZZINA",16,14,58,88,"2018",NA
"26249","TREMOSINE",26,349,76,451,"2018","189"
"26250","TRENZANO",934,1406,130,2470,"2018","190"
"26251","TRESCORE BALNEARIO",24,72,11,107,"2018","218"
"26252","TRESCORE CREMASCO",87,401,122,610,"2018","109"
"26253","TRESIVIO",11,15,0,26,"2018","070"
"26254","TREVENZUOLO",235,954,0,1189,"2018","088"
"26255","TREVIGLIO",1041,1590,6,2637,"2018","219"
"26256","TREVIGNANO",2109,175,0,2284,"2018","085"
"26257","TREVILLE",8,0,0,8,"2018","175"
"26258","TREVIOLO",104,136,0,240,"2018","220"
"26259","TREVISO",524,131,8,663,"2018","086"
"26260","TREVISO BRESCIANO",14,41,2,57,"2018","191"
"26261","TREZZO SULL'ADDA",0,404,0,404,"2018","221"
"26262","TREZZO TINELLA",14,0,0,14,"2018","231"
"26263","TREZZONE",1,0,3,4,"2018","226"
"26264","TRIBANO",2,0,0,2,"2018","094"
"26265","TRIBIANO",0,39,0,39,"2018","222"
"26266","TRICHIANA",66,488,0,554,"2018","061"
"26267","TRIGOLO",0,1605,0,1605,"2018","110"
"26268","TRINITA'",2600,427,404,3431,"2018","232"
"26269","TRINO",4,164,0,168,"2018","148"
"26270","TRISOBBIO",92,0,0,92,"2018","176"
"26271","TRISSINO",73,251,17,341,"2018","110"
"26272","TRIUGGIO",37,312,0,349,"2018",NA
"26273","TRIVERO",9,20,0,29,"2018","070"
"26274","TROFARELLO",595,73,0,668,"2018","280"
"26275","TROMELLO",18,186,277,481,"2018","164"
"26276","TRONTANO",8,15,3,26,"2018","068"
"26277","TRONZANO VERCELLESE",151,0,0,151,"2018","150"
"26278","TROVO",5,52,0,57,"2018","165"
"26279","TRUCCAZZANO",76,1917,0,1993,"2018","224"
"26280","TURANO LODIGIANO",54,1976,195,2225,"2018","058"
"26281","TURBIGO",1,56,0,57,"2018","226"
"26282","UBIALE CLANEZZO",7,0,0,7,"2018","221"
"26283","UBOLDO",6,0,0,6,"2018","130"
"26284","UGGIATE-TREVANO",17,52,7,76,"2018","228"
"26285","URAGO D'OGLIO",249,1026,0,1275,"2018","192"
"26286","URBANA",802,0,0,802,"2018","095"
"26287","URGNANO",127,232,0,359,"2018","222"
"26288","USMATE VELATE",9,38,6,53,"2018",NA
"26289","USSEAUX",22,60,27,109,"2018","281"
"26290","USSEGLIO",5,39,0,44,"2018","282"
"26291","VAIANO CREMASCO",4,503,155,662,"2018","111"
"26292","VAIE",0,10,64,74,"2018","283"
"26293","VAILATE",3,406,304,713,"2018","112"
"26294","VAL BREMBILLA",72,50,5,127,"2018",NA
"26295","VAL DELLA TORRE",330,0,0,330,"2018","284"
"26296","VAL DI ZOLDO",21,3,0,24,"2018",NA
"26297","VAL LIONA",302,279,0,581,"2018",NA
"26298","VAL MASINO",2,9,0,11,"2018","074"
"26299","VAL REZZO",5,0,5,10,"2018","233"
"26300","VALBONDIONE",1,13,0,14,"2018","223"
"26301","VALBREMBO",76,0,0,76,"2018","224"
"26302","VALBRONA",4,0,3,7,"2018","229"
"26303","VALDAGNO",33,165,0,198,"2018","111"
"26304","VALDASTICO",946,22,0,968,"2018","112"
"26305","VALDENGO",8,35,0,43,"2018","071"
"26306","VALDIDENTRO",32,115,22,169,"2018","071"
"26307","VALDIERI",2,0,0,2,"2018","233"
"26308","VALDISOTTO",36,102,5,143,"2018","072"
"26309","VALDOBBIADENE",89,332,3,424,"2018","087"
"26310","VALDUGGIA",6,0,0,6,"2018","152"
"26311","VALEGGIO",43,0,0,43,"2018","167"
"26312","VALEGGIO SUL MINCIO",2403,2276,38,4717,"2018","089"
"26313","VALENZA",64,0,0,64,"2018","177"
"26314","VALERA FRATTA",196,242,0,438,"2018","059"
"26315","VALFENERA",1099,97,234,1430,"2018","112"
"26316","VALFURVA",11,80,17,108,"2018","073"
"26317","VALGANNA",22,0,1,23,"2018","131"
"26318","VALGOGLIO",17,46,0,63,"2018","225"
"26319","VALGRANA",303,0,0,303,"2018","234"
"26320","VALGREGHENTINO",2,0,0,2,"2018","082"
"26321","VALLADA AGORDINA",2,4,0,6,"2018","062"
"26322","VALLE DI CADORE",8,0,0,8,"2018","063"
"26323","VALLE LOMELLINA",24,765,0,789,"2018","168"
"26324","VALLE MOSSO",2,0,0,2,"2018","073"
"26325","VALLE SALIMBENE",1,72,0,73,"2018","169"
"26326","VALLE SAN NICOLAO",7,0,0,7,"2018","074"
"26327","VALLEVE",0,4,0,4,"2018","226"
"26328","VALLI DEL PASUBIO",0,6,0,6,"2018","113"
"26329","VALLIO TERME",7,0,0,7,"2018","193"
"26330","VALLO TORINESE",20,0,0,20,"2018","286"
"26331","VALMADRERA",15,0,1,16,"2018","083"
"26332","VALMOREA",1,34,0,35,"2018","232"
"26333","VALMOZZOLA",35,30,0,65,"2018","044"
"26334","VALPERGA",183,134,39,356,"2018","287"
"26335","VALPRATO SOANA",67,0,0,67,"2018","288"
"26336","VALSAMOGGIA",216,917,0,1133,"2018",NA
"26337","VALSOLDA",4,5,1,10,"2018","234"
"26338","VALSTAGNA",5,0,0,5,"2018","114"
"26339","VALSTRONA",18,0,0,18,"2018","069"
"26340","VALTORTA",0,35,0,35,"2018","229"
"26341","VALVARRONE",0,0,1,1,"2018",NA
"26342","VALVERDE",6,0,0,6,"2018","170"
"26343","VALVESTINO",1,8,0,9,"2018","194"
"26344","VANZAGO",38,0,0,38,"2018","229"
"26345","VAPRIO D'ADDA",13,377,0,390,"2018","230"
"26346","VARALLO",44,53,0,97,"2018","156"
"26347","VARALLO POMBIA",1,0,0,1,"2018","154"
"26348","VARANO DE' MELEGARI",20,355,0,375,"2018","045"
"26349","VAREDO",1,0,0,1,"2018",NA
"26350","VARESE",73,113,0,186,"2018","133"
"26351","VARISELLA",130,0,0,130,"2018","289"
"26352","VARSI",4,438,0,442,"2018","046"
"26353","VARZI",94,0,0,94,"2018","171"
"26354","VARZO",13,10,6,29,"2018","071"
"26355","VAUDA CANAVESE",41,0,0,41,"2018","290"
"26356","VAZZOLA",1248,96,3,1347,"2018","088"
"26357","VEDANO OLONA",2,233,0,235,"2018","134"
"26358","VEDELAGO",22630,390,104,23124,"2018","089"
"26359","VEDESETA",2,47,70,119,"2018","230"
"26360","VEGGIANO",223,81,40,344,"2018","096"
"26361","VEGLIO",13,6,0,19,"2018","075"
"26362","VELESO",0,0,7,7,"2018","236"
"26363","VELLEZZO BELLINI",20,398,0,418,"2018","173"
"26364","VELO D'ASTICO",1079,18,0,1097,"2018","115"
"26365","VELO VERONESE",438,1532,18,1988,"2018","090"
"26366","VENARIA REALE",56,17,262,335,"2018","292"
"26367","VENASCA",48,0,0,48,"2018","237"
"26368","VENAUS",30,37,9,76,"2018","291"
"26369","VENDROGNO",12,0,1,13,"2018","085"
"26370","VENEGONO INFERIORE",0,84,0,84,"2018","136"
"26371","VENEGONO SUPERIORE",13,9,1,23,"2018","137"
"26372","VENEZIA",1569,192,0,1761,"2018","042"
"26373","VENIANO",60,91,0,151,"2018","238"
"26374","VENTASSO",73,345,0,418,"2018",NA
"26375","VERANO BRIANZA",1,0,0,1,"2018",NA
"26376","VERBANIA",88,0,2,90,"2018","072"
"26377","VERCANA",6,7,0,13,"2018","239"
"26378","VERCEIA",9,0,6,15,"2018","075"
"26379","VERCELLI",81,201,0,282,"2018","158"
"26380","VERDELLINO",0,69,0,69,"2018","232"
"26381","VERDELLO",218,60,0,278,"2018","233"
"26382","VERDERIO",1,0,46,47,"2018",NA
"26383","VERDUNO",97,0,0,97,"2018","238"
"26384","VERGATO",68,0,1,69,"2018","059"
"26385","VERGHERETO",570,0,0,570,"2018","050"
"26386","VERGIATE",18,0,0,18,"2018","138"
"26387","VERMEZZO",0,364,14,378,"2018","235"
"26388","VERNANTE",154,50,0,204,"2018","239"
"26389","VERNASCA",30,81,0,111,"2018","044"
"26390","VERNATE",3,76,0,79,"2018","236"
"26391","VEROLANUOVA",1465,2210,114,3789,"2018","195"
"26392","VEROLAVECCHIA",41,3266,625,3932,"2018","196"
"26393","VEROLENGO",235,122,0,357,"2018","293"
"26394","VERONA",3554,851,0,4405,"2018","091"
"26395","VERONELLA",5474,279,0,5753,"2018","092"
"26396","VERRETTO",3,0,0,3,"2018","174"
"26397","VERRONE",19,0,0,19,"2018","076"
"26398","VERRUA SAVOIA",577,0,0,577,"2018","294"
"26399","VERTEMATE CON MINOPRIO",2,0,0,2,"2018","242"
"26400","VERTOVA",28,31,0,59,"2018","234"
"26401","VERUCCHIO",146,0,0,146,"2018","020"
"26402","VERUNO",2,0,0,2,"2018","157"
"26403","VERVIO",17,0,0,17,"2018","076"
"26404","VERZUOLO",4,0,0,4,"2018","240"
"26405","VESCOVANA",6,0,0,6,"2018","097"
"26406","VESCOVATO",2736,705,611,4052,"2018","113"
"26407","VESIME",591,0,0,591,"2018","113"
"26408","VESPOLATE",44,99,0,143,"2018","158"
"26409","VESTENANOVA",516,143,0,659,"2018","093"
"26410","VESTIGNE'",23,68,0,91,"2018","295"
"26411","VESTONE",6,0,0,6,"2018","197"
"26412","VETTO",18,381,0,399,"2018","042"
"26413","VEZZA D'ALBA",2,0,0,2,"2018","241"
"26414","VEZZA D'OGLIO",7,167,29,203,"2018","198"
"26415","VEZZANO SUL CROSTOLO",14,114,0,128,"2018","043"
"26416","VIADANA",276,1281,29,1586,"2018","066"
"26417","VIADANICA",11,29,0,40,"2018","235"
"26418","VIALE",299,0,0,299,"2018","114"
"26419","VIALFRE'",7,0,0,7,"2018","296"
"26420","VIANO",1,794,0,795,"2018","044"
"26421","VIARIGI",25,0,0,25,"2018","115"
"26422","VICENZA",170,856,0,1026,"2018","116"
"26423","VICO CANAVESE",145,121,3,269,"2018","297"
"26424","VICOFORTE",502,0,0,502,"2018","242"
"26425","VIDIGULFO",3,388,0,391,"2018","176"
"26426","VIDOR",6,360,0,366,"2018","090"
"26427","VIDRACCO",3,0,0,3,"2018","298"
"26428","VIGANO SAN MARTINO",8,0,0,8,"2018","236"
"26429","VIGASIO",996,514,0,1510,"2018","094"
"26430","VIGEVANO",238,44,89,371,"2018","177"
"26431","VIGGIU'",25,59,0,84,"2018","139"
"26432","VIGHIZZOLO D'ESTE",106,17,0,123,"2018","098"
"26433","VIGLIANO BIELLESE",3,2,0,5,"2018","077"
"26434","VIGLIANO D'ASTI",47,0,0,47,"2018","116"
"26435","VIGNALE MONFERRATO",197,0,0,197,"2018","179"
"26436","VIGNATE",5,413,0,418,"2018","237"
"26437","VIGNOLA",2,90,0,92,"2018","046"
"26438","VIGNOLE BORBERA",11,0,0,11,"2018","180"
"26439","VIGNOLO",1205,0,0,1205,"2018","243"
"26440","VIGNONE",2,0,0,2,"2018","074"
"26441","VIGO DI CADORE",1,14,2,17,"2018","065"
"26442","VIGODARZERE",290,77,0,367,"2018","099"
"26443","VIGOLO",8,179,2,189,"2018","237"
"26444","VIGOLZONE",78,460,0,538,"2018","045"
"26445","VIGONE",2852,1174,177,4203,"2018","299"
"26446","VIGONOVO",20,0,1,21,"2018","043"
"26447","VIGONZA",686,191,0,877,"2018","100"
"26448","VILLA BARTOLOMEA",118,0,0,118,"2018","095"
"26449","VILLA CARCINA",3,0,0,3,"2018","199"
"26450","VILLA CORTESE",176,0,0,176,"2018","248"
"26451","VILLA D'ADDA",9,0,0,9,"2018","238"
"26452","VILLA D'ALME'",69,20,0,89,"2018","239"
"26453","VILLA D'OGNA",1,60,0,61,"2018","241"
"26454","VILLA DEL BOSCO",1,0,0,1,"2018","078"
"26455","VILLA DEL CONTE",796,738,2,1536,"2018","101"
"26456","VILLA DI CHIAVENNA",9,5,1,15,"2018","077"
"26457","VILLA DI SERIO",8,0,0,8,"2018","240"
"26458","VILLA DI TIRANO",7,126,66,199,"2018","078"
"26459","VILLA ESTENSE",266,0,0,266,"2018","102"
"26460","VILLA GUARDIA",137,0,0,137,"2018","245"
"26461","VILLA MINOZZO",48,764,0,812,"2018","045"
"26462","VILLA SAN SECONDO",5,0,0,5,"2018","119"
"26463","VILLACHIARA",530,1833,983,3346,"2018","200"
"26464","VILLADEATI",15,0,0,15,"2018","182"
"26465","VILLADOSE",228,2,59,289,"2018","048"
"26466","VILLADOSSOLA",18,0,0,18,"2018","075"
"26467","VILLAFALLETTO",2315,755,258,3328,"2018","244"
"26468","VILLAFRANCA D'ASTI",243,0,0,243,"2018","117"
"26469","VILLAFRANCA DI VERONA",8450,3289,111,11850,"2018","096"
"26470","VILLAFRANCA PADOVANA",745,1795,16,2556,"2018","103"
"26471","VILLAFRANCA PIEMONTE",2393,1916,385,4694,"2018","300"
"26472","VILLAGA",199,202,19,420,"2018","117"
"26473","VILLAMARZANA",832,122,0,954,"2018","049"
"26474","VILLAMIROGLIO",2,0,0,2,"2018","184"
"26475","VILLANOVA BIELLESE",346,0,0,346,"2018","079"
"26476","VILLANOVA CANAVESE",40,11,8,59,"2018","301"
"26477","VILLANOVA D'ARDENGHI",0,0,1,1,"2018","179"
"26478","VILLANOVA D'ASTI",4018,66,0,4084,"2018","118"
"26479","VILLANOVA DEL GHEBBO",30,0,0,30,"2018","050"
"26480","VILLANOVA DEL SILLARO",0,948,4,952,"2018","060"
"26481","VILLANOVA DI CAMPOSAMPIERO",20,10,7,37,"2018","104"
"26482","VILLANOVA MARCHESANA",0,69,0,69,"2018","051"
"26483","VILLANOVA MONDOVI'",1842,484,137,2463,"2018","245"
"26484","VILLANOVA MONFERRATO",0,84,0,84,"2018","185"
"26485","VILLANOVA SOLARO",284,608,5,897,"2018","246"
"26486","VILLANOVA SULL'ARDA",20,1537,0,1557,"2018","046"
"26487","VILLANTERIO",2,0,199,201,"2018","180"
"26488","VILLANUOVA SUL CLISI",3,0,0,3,"2018","201"
"26489","VILLAR DORA",42,0,51,93,"2018","303"
"26490","VILLAR FOCCHIARDO",11,28,72,111,"2018","305"
"26491","VILLAR PELLICE",225,40,10,275,"2018","306"
"26492","VILLAR PEROSA",6,0,17,23,"2018","307"
"26493","VILLAR SAN COSTANZO",374,172,3,549,"2018","247"
"26494","VILLARBASSE",242,11,0,253,"2018","302"
"26495","VILLARBOIT",1,0,0,1,"2018","163"
"26496","VILLAREGGIA",54,20,0,74,"2018","304"
"26497","VILLASTELLONE",783,591,0,1374,"2018","308"
"26498","VILLATA",16,31,0,47,"2018","164"
"26499","VILLAVERLA",111,1311,0,1422,"2018","118"
"26500","VILLETTE",52,0,0,52,"2018","076"
"26501","VILLIMPENTA",664,0,90,754,"2018","068"
"26502","VILLONGO",10,0,0,10,"2018","242"
"26503","VILLORBA",126,3,0,129,"2018","091"
"26504","VILMINORE DI SCALVE",10,159,0,169,"2018","243"
"26505","VIMERCATE",5,40,0,45,"2018",NA
"26506","VINADIO",219,0,0,219,"2018","248"
"26507","VINCHIO",21,0,0,21,"2018","120"
"26508","VINOVO",426,179,30,635,"2018","309"
"26509","VINZAGLIO",11,47,0,58,"2018","164"
"26510","VIOLA",92,0,0,92,"2018","249"
"26511","VIONE",3,28,3,34,"2018","202"
"26512","VIRLE PIEMONTE",289,209,135,633,"2018","310"
"26513","VISANO",2222,400,9,2631,"2018","203"
"26514","VISCHE",8,0,0,8,"2018","311"
"26515","VISONE",42,0,0,42,"2018","187"
"26516","VISTARINO",33,0,1,34,"2018","181"
"26517","VISTRORIO",8,0,10,18,"2018","312"
"26518","VITTORIO VENETO",197,109,4,310,"2018","092"
"26519","VITTUONE",1,201,0,202,"2018","243"
"26520","VIU'",51,0,76,127,"2018","313"
"26521","VIVERONE",47,0,0,47,"2018","080"
"26522","VIZZOLO PREDABISSI",17,0,44,61,"2018","244"
"26523","VO'",75,74,0,149,"2018","105"
"26524","VOBARNO",35,78,7,120,"2018","204"
"26525","VOCCA",0,21,0,21,"2018","166"
"26526","VODO CADORE",0,0,24,24,"2018","066"
"26527","VOGHERA",62,0,0,62,"2018","182"
"26528","VOGHIERA",4,0,0,4,"2018","023"
"26529","VOGOGNA",21,2,0,23,"2018","077"
"26530","VOLONGO",37,0,0,37,"2018","114"
"26531","VOLPAGO DEL MONTELLO",1140,566,25,1731,"2018","093"
"26532","VOLPEDO",2,0,0,2,"2018","188"
"26533","VOLPIANO",260,173,41,474,"2018","314"
"26534","VOLTA MANTOVANA",3212,1209,934,5355,"2018","070"
"26535","VOLTAGGIO",5,0,65,70,"2018","190"
"26536","VOLTIDO",0,364,0,364,"2018","115"
"26537","VOLVERA",1330,352,0,1682,"2018","315"
"26538","VOTTIGNASCO",1733,101,88,1922,"2018","250"
"26539","ZANDOBBIO",18,0,0,18,"2018","244"
"26540","ZANE'",252,167,0,419,"2018","119"
"26541","ZANICA",246,1211,0,1457,"2018","245"
"26542","ZAVATTARELLO",82,0,0,82,"2018","184"
"26543","ZECCONE",16,277,0,293,"2018","185"
"26544","ZELBIO",0,0,9,9,"2018","246"
"26545","ZELO BUON PERSICO",0,1199,0,1199,"2018","061"
"26546","ZELO SURRIGONE",4,233,0,237,"2018","246"
"26547","ZEME",48,22,0,70,"2018","186"
"26548","ZENEVREDO",2,0,0,2,"2018","187"
"26549","ZENSON DI PIAVE",8,0,0,8,"2018","094"
"26550","ZERBOLO'",0,170,0,170,"2018","189"
"26551","ZERMEGHEDO",0,46,0,46,"2018","120"
"26552","ZERO BRANCO",282,160,0,442,"2018","095"
"26553","ZEVIO",4196,702,81,4979,"2018","097"
"26554","ZIANO PIACENTINO",90,0,0,90,"2018","048"
"26555","ZIBIDO SAN GIACOMO",45,435,73,553,"2018","247"
"26556","ZIMELLA",8650,525,0,9175,"2018","098"
"26557","ZIMONE",5,0,0,5,"2018",NA
"26558","ZINASCO",24,0,0,24,"2018","190"
"26559","ZOCCA",55,838,0,893,"2018","047"
"26560","ZOGNO",104,54,0,158,"2018","246"
"26561","ZOLA PREDOSA",23,242,0,265,"2018","060"
"26562","ZONE",5,29,0,34,"2018","205"
"26563","ZOPPE' DI CADORE",0,1,0,1,"2018",NA
"26564","ZOVENCEDO",7,0,0,7,"2018","121"
"26565","ZUBIENA",35,0,18,53,"2018","082"
"26566","ZUGLIANO",542,151,14,707,"2018","122"
"26567","ZUMAGLIA",37,0,0,37,"2018","083"
"26568","ABANO TERME",54,184,0,238,"2019","001"
"26569","ABBADIA CERRETO",0,1193,0,1193,"2019","001"
"26570","ABBADIA LARIANA",8,14,1,23,"2019","001"
"26571","ABBIATEGRASSO",76,1493,4,1573,"2019","002"
"26572","ACCEGLIO",133,0,0,133,"2019","001"
"26573","ACQUAFREDDA",1552,93,8,1653,"2019","001"
"26574","ACQUANEGRA CREMONESE",0,207,558,765,"2019","001"
"26575","ACQUANEGRA SUL CHIESE",1419,517,389,2325,"2019","001"
"26576","ACQUI TERME",288,0,0,288,"2019","001"
"26577","ADRARA SAN MARTINO",52,24,0,76,"2019","001"
"26578","ADRARA SAN ROCCO",12,0,0,12,"2019","002"
"26579","ADRIA",2724,251,0,2975,"2019","001"
"26580","ADRO",508,25,0,533,"2019","002"
"26581","AGAZZANO",99,382,0,481,"2019","001"
"26582","AGLIANO TERME",44,0,0,44,"2019","001"
"26583","AGLIE'",356,36,44,436,"2019","001"
"26584","AGNA",347,0,0,347,"2019","002"
"26585","AGNADELLO",12,1314,500,1826,"2019","002"
"26586","AGNOSINE",11,57,5,73,"2019","003"
"26587","AGORDO",5,14,0,19,"2019","001"
"26588","AGRATE CONTURBIA",37,0,0,37,"2019","001"
"26589","AGUGLIARO",339,1,0,340,"2019","001"
"26590","AICURZIO",9,41,0,50,"2019",NA
"26591","AILOCHE",0,9,0,9,"2019","001"
"26592","AIRASCA",659,628,0,1287,"2019","002"
"26593","AIRUNO",1,0,0,1,"2019","002"
"26594","AISONE",21,0,0,21,"2019","002"
"26595","ALA DI STURA",28,0,0,28,"2019","003"
"26596","ALAGNA VALSESIA",17,26,0,43,"2019","002"
"26597","ALANO DI PIAVE",406,66,0,472,"2019","002"
"26598","ALBA",721,0,0,721,"2019","003"
"26599","ALBAIRATE",34,627,0,661,"2019","005"
"26600","ALBANO SANT'ALESSANDRO",8,0,0,8,"2019","003"
"26601","ALBAREDO D'ADIGE",11304,187,0,11491,"2019","002"
"26602","ALBAREDO PER SAN MARCO",3,17,0,20,"2019","001"
"26603","ALBARETO",96,60,0,156,"2019","001"
"26604","ALBARETTO DELLA TORRE",29,0,0,29,"2019","004"
"26605","ALBAVILLA",2,0,0,2,"2019","003"
"26606","ALBERA LIGURE",23,0,0,23,"2019","002"
"26607","ALBESE CON CASSANO",0,0,3,3,"2019","004"
"26608","ALBETTONE",1915,674,50,2639,"2019","002"
"26609","ALBIANO D'IVREA",146,29,0,175,"2019","004"
"26610","ALBIATE",294,0,0,294,"2019",NA
"26611","ALBIGNASEGO",114,211,1,326,"2019","003"
"26612","ALBINEA",14,1081,0,1095,"2019","001"
"26613","ALBINO",49,51,17,117,"2019","004"
"26614","ALBIOLO",0,0,14,14,"2019","005"
"26615","ALBIZZATE",3,0,0,3,"2019","002"
"26616","ALBOSAGGIA",41,63,57,161,"2019","002"
"26617","ALBUGNANO",57,0,0,57,"2019","002"
"26618","ALBUZZANO",32,0,0,32,"2019","004"
"26619","ALESSANDRIA",10487,2277,0,12764,"2019","003"
"26620","ALFIANELLO",5,485,4,494,"2019","004"
"26621","ALFIANO NATTA",37,0,0,37,"2019","004"
"26622","ALFONSINE",30,0,0,30,"2019","001"
"26623","ALGUA",8,3,0,11,"2019","248"
"26624","ALICE BEL COLLE",1,0,0,1,"2019","005"
"26625","ALICE CASTELLO",848,25,0,873,"2019","004"
"26626","ALLEGHE",2,0,0,2,"2019","003"
"26627","ALLUVIONI PIOVERA",101,157,0,258,"2019",NA
"26628","ALME'",3,0,0,3,"2019","005"
"26629","ALMENNO SAN BARTOLOMEO",32,5,2,39,"2019","006"
"26630","ALMENNO SAN SALVATORE",4,0,0,4,"2019","007"
"26631","ALMESE",42,20,0,62,"2019","006"
"26632","ALONTE",661,15,0,676,"2019","003"
"26633","ALPAGO",20,210,0,230,"2019",NA
"26634","ALPETTE",13,0,0,13,"2019","007"
"26635","ALPIGNANO",389,114,39,542,"2019","008"
"26636","ALSENO",98,905,0,1003,"2019","002"
"26637","ALSERIO",4,0,0,4,"2019","006"
"26638","ALTA VAL TIDONE",567,156,0,723,"2019",NA
"26639","ALTA VALLE INTELVI",54,27,5,86,"2019",NA
"26640","ALTAVILLA MONFERRATO",98,0,0,98,"2019","007"
"26641","ALTAVILLA VICENTINA",142,0,0,142,"2019","004"
"26642","ALTISSIMO",34,48,0,82,"2019","005"
"26643","ALTIVOLE",12396,59,2,12457,"2019","001"
"26644","ALTO RENO TERME",101,0,0,101,"2019",NA
"26645","ALTO SERMENZA",5,16,0,21,"2019",NA
"26646","ALZANO LOMBARDO",18,37,0,55,"2019","008"
"26647","ALZANO SCRIVIA",1,0,0,1,"2019","008"
"26648","ALZATE BRIANZA",7,168,0,175,"2019","007"
"26649","AMBIVERE",2,0,0,2,"2019","009"
"26650","AMENO",7,6,34,47,"2019","002"
"26651","ANDALO VALTELLINO",15,0,0,15,"2019",NA
"26652","ANDEZENO",339,0,0,339,"2019","009"
"26653","ANDORNO MICCA",24,0,55,79,"2019","002"
"26654","ANDRATE",46,0,0,46,"2019","010"
"26655","ANFO",0,12,0,12,"2019","005"
"26656","ANGERA",57,148,28,233,"2019","003"
"26657","ANGOLO TERME",6,53,3,62,"2019","006"
"26658","ANGROGNA",96,0,30,126,"2019","011"
"26659","ANGUILLARA VENETA",5,0,0,5,"2019","004"
"26660","ANNICCO",3,893,254,1150,"2019","003"
"26661","ANNONE DI BRIANZA",23,8,0,31,"2019","003"
"26662","ANNONE VENETO",14,31,0,45,"2019","001"
"26663","ANTEGNATE",736,1518,0,2254,"2019","010"
"26664","ANTIGNANO",95,0,0,95,"2019","003"
"26665","ANTRONA SCHIERANCO",2,0,0,2,"2019","001"
"26666","ANZANO DEL PARCO",3,133,0,136,"2019","009"
"26667","ANZOLA D'OSSOLA",2,154,0,156,"2019","002"
"26668","ANZOLA DELL'EMILIA",53,456,0,509,"2019","001"
"26669","APPIANO GENTILE",73,233,35,341,"2019","010"
"26670","APRICA",0,1,0,1,"2019","004"
"26671","ARAMENGO",210,0,0,210,"2019","004"
"26672","ARCADE",783,56,0,839,"2019","002"
"26673","ARCENE",2,436,0,438,"2019","011"
"26674","ARCISATE",59,584,325,968,"2019","004"
"26675","ARCOLE",1357,108,0,1465,"2019","004"
"26676","ARCONATE",38,88,0,126,"2019","007"
"26677","ARCORE",93,0,0,93,"2019",NA
"26678","ARCUGNANO",68,4,0,72,"2019","006"
"26679","ARDENNO",33,37,14,84,"2019","005"
"26680","ARDESIO",52,56,0,108,"2019","012"
"26681","ARENA PO",56,544,141,741,"2019","005"
"26682","ARESE",0,115,0,115,"2019","009"
"26683","ARGEGNO",1,0,0,1,"2019","011"
"26684","ARGELATO",88,66,0,154,"2019","002"
"26685","ARGENTA",1392,7,0,1399,"2019","001"
"26686","ARGUELLO",66,0,0,66,"2019","007"
"26687","ARIANO NEL POLESINE",646,207,0,853,"2019","002"
"26688","ARIGNANO",564,0,0,564,"2019","012"
"26689","ARLUNO",87,274,12,373,"2019","010"
"26690","ARMENO",87,75,0,162,"2019","006"
"26691","AROLA",1,0,13,14,"2019","004"
"26692","ARONA",2,0,0,2,"2019","008"
"26693","AROSIO",0,2,0,2,"2019","012"
"26694","ARQUA' PETRARCA",146,0,0,146,"2019","005"
"26695","ARQUA' POLESINE",825,0,0,825,"2019","003"
"26696","ARQUATA SCRIVIA",12,0,0,12,"2019","009"
"26697","ARRE",0,19,0,19,"2019","006"
"26698","ARSAGO SEPRIO",9,0,0,9,"2019","005"
"26699","ARSIE'",17,4,437,458,"2019","004"
"26700","ARSIERO",1,21,4,26,"2019","007"
"26701","ARTOGNE",5,329,47,381,"2019","007"
"26702","ARZAGO D'ADDA",345,1034,0,1379,"2019","013"
"26703","ARZERGRANDE",642,159,0,801,"2019","007"
"26704","ARZIGNANO",121,320,0,441,"2019","008"
"26705","ASIAGO",60,1128,31,1219,"2019","009"
"26706","ASIGLIANO VENETO",186,0,0,186,"2019","010"
"26707","ASIGLIANO VERCELLESE",20,0,0,20,"2019","007"
"26708","ASOLA",9545,1590,1454,12589,"2019","002"
"26709","ASOLO",9540,513,7,10060,"2019","003"
"26710","ASSAGO",2,0,0,2,"2019","011"
"26711","ASSO",11,0,13,24,"2019","013"
"26712","ASTI",2275,6,0,2281,"2019","005"
"26713","AURANO",7,0,0,7,"2019","005"
"26714","AURONZO DI CADORE",20,10,0,30,"2019","005"
"26715","AVIATICO",0,18,0,18,"2019","015"
"26716","AVIGLIANA",198,39,8,245,"2019","013"
"26717","AVOLASCA",200,0,0,200,"2019","010"
"26718","AZEGLIO",78,20,61,159,"2019","014"
"26719","AZZANELLO",1,171,0,172,"2019","004"
"26720","AZZANO D'ASTI",1,0,0,1,"2019",NA
"26721","AZZANO MELLA",118,984,0,1102,"2019","008"
"26722","AZZANO SAN PAOLO",31,135,0,166,"2019","016"
"26723","AZZATE",15,16,0,31,"2019","006"
"26724","AZZIO",6,107,0,113,"2019","007"
"26725","BACENO",2,24,0,26,"2019","006"
"26726","BADIA CALAVENA",1282,212,26,1520,"2019","005"
"26727","BADIA PAVESE",12,0,0,12,"2019","006"
"26728","BADIA POLESINE",186,0,0,186,"2019","004"
"26729","BAGNACAVALLO",33,0,0,33,"2019","002"
"26730","BAGNARA DI ROMAGNA",7,0,0,7,"2019","003"
"26731","BAGNARIA",8,0,0,8,"2019","007"
"26732","BAGNASCO",107,0,0,107,"2019","008"
"26733","BAGNATICA",4,158,0,162,"2019","018"
"26734","BAGNO DI ROMAGNA",789,18,0,807,"2019","001"
"26735","BAGNOLI DI SOPRA",1037,6,0,1043,"2019","008"
"26736","BAGNOLO CREMASCO",4,1866,0,1870,"2019","005"
"26737","BAGNOLO IN PIANO",4,509,0,513,"2019","002"
"26738","BAGNOLO MELLA",199,2879,420,3498,"2019","009"
"26739","BAGNOLO PIEMONTE",876,0,162,1038,"2019","009"
"26740","BAGNOLO SAN VITO",176,2439,1288,3903,"2019","003"
"26741","BAGOLINO",4,287,3,294,"2019","010"
"26742","BAIRO",103,81,5,189,"2019","015"
"26743","BAISO",11,909,0,920,"2019","003"
"26744","BALANGERO",190,34,110,334,"2019","016"
"26745","BALDICHIERI D'ASTI",35,0,0,35,"2019","007"
"26746","BALDISSERO CANAVESE",0,73,0,73,"2019","017"
"26747","BALDISSERO D'ALBA",635,0,0,635,"2019","010"
"26748","BALDISSERO TORINESE",146,0,0,146,"2019","018"
"26749","BALLABIO",18,73,14,105,"2019","004"
"26750","BALME",10,0,0,10,"2019","019"
"26751","BALOCCO",39,0,22,61,"2019","009"
"26752","BANCHETTE",3,0,3,6,"2019","020"
"26753","BANNIO ANZINO",76,0,2,78,"2019","007"
"26754","BAONE",8,0,0,8,"2019","009"
"26755","BARBANIA",27,172,85,284,"2019","021"
"26756","BARBARANO MOSSANO",754,375,6,1135,"2019",NA
"26757","BARBARESCO",14,0,0,14,"2019","011"
"26758","BARBARIGA",1041,1500,0,2541,"2019","011"
"26759","BARBATA",0,817,0,817,"2019","019"
"26760","BARBIANELLO",133,6,0,139,"2019","008"
"26761","BARBONA",331,3,0,334,"2019","010"
"26762","BARDELLO",18,0,0,18,"2019","009"
"26763","BARDI",72,607,0,679,"2019","002"
"26764","BARDOLINO",24,101,0,125,"2019","006"
"26765","BARDONECCHIA",26,0,0,26,"2019","022"
"26766","BAREGGIO",36,91,15,142,"2019","012"
"26767","BARENGO",1,131,0,132,"2019","012"
"26768","BARGE",4687,1565,800,7052,"2019","012"
"26769","BARGHE",4,9,0,13,"2019","012"
"26770","BARIANO",3,362,0,365,"2019","020"
"26771","BARLASSINA",4,0,0,4,"2019",NA
"26772","BARNI",1,7,2,10,"2019","015"
"26773","BAROLO",38,0,0,38,"2019","013"
"26774","BARONE CANAVESE",150,62,0,212,"2019","023"
"26775","BARZAGO",246,13,0,259,"2019","005"
"26776","BARZANO'",9,0,0,9,"2019","006"
"26777","BARZIO",6,51,15,72,"2019","007"
"26778","BASALUZZO",232,0,0,232,"2019","012"
"26779","BASCAPE'",0,795,0,795,"2019","009"
"26780","BASIGLIO",0,67,0,67,"2019","015"
"26781","BASSANO BRESCIANO",0,123,0,123,"2019","013"
"26782","BASSANO DEL GRAPPA",138,179,6,323,"2019","012"
"26783","BASSIGNANA",2,0,0,2,"2019","013"
"26784","BASTIA MONDOVI'",727,0,0,727,"2019","014"
"26785","BASTIGLIA",103,0,0,103,"2019","001"
"26786","BATTAGLIA TERME",2,0,0,2,"2019","011"
"26787","BEDERO VALCUVIA",11,0,0,11,"2019","010"
"26788","BEDIZZOLE",3574,1329,41,4944,"2019","014"
"26789","BEDONIA",258,114,0,372,"2019","003"
"26790","BEDULITA",8,0,0,8,"2019","022"
"26791","BEE",2,0,0,2,"2019","009"
"26792","BEINASCO",18,0,0,18,"2019","024"
"26793","BEINETTE",765,361,0,1126,"2019","016"
"26794","BELFIORE",2589,0,0,2589,"2019","007"
"26795","BELGIOIOSO",0,142,0,142,"2019","013"
"26796","BELLAGIO",2,67,27,96,"2019","019"
"26797","BELLANO",7,0,0,7,"2019","008"
"26798","BELLARIA-IGEA MARINA",7,0,0,7,"2019","001"
"26799","BELLINO",122,0,0,122,"2019","017"
"26800","BELLINZAGO LOMBARDO",80,1395,0,1475,"2019","016"
"26801","BELLINZAGO NOVARESE",489,600,0,1089,"2019","016"
"26802","BELLUNO",682,292,160,1134,"2019","006"
"26803","BELVEDERE LANGHE",99,0,89,188,"2019","018"
"26804","BEMA",0,5,0,5,"2019","006"
"26805","BENE LARIO",2,0,61,63,"2019","021"
"26806","BENE VAGIENNA",1664,511,0,2175,"2019","019"
"26807","BENEVELLO",140,0,0,140,"2019","020"
"26808","BENNA",0,32,17,49,"2019","003"
"26809","BENTIVOGLIO",6,86,0,92,"2019","005"
"26810","BERBENNO",8,30,0,38,"2019","023"
"26811","BERBENNO DI VALTELLINA",15,214,0,229,"2019","007"
"26812","BERCETO",42,398,0,440,"2019","004"
"26813","BEREGAZZO CON FIGLIARO",6,0,0,6,"2019","022"
"26814","BEREGUARDO",9,550,78,637,"2019","014"
"26815","BERGAMASCO",56,0,0,56,"2019","015"
"26816","BERGAMO",135,156,0,291,"2019","024"
"26817","BERLINGO",3185,303,42,3530,"2019","015"
"26818","BERNAREGGIO",2,17,0,19,"2019",NA
"26819","BERNATE TICINO",15,124,0,139,"2019","019"
"26820","BERNEZZO",324,37,13,374,"2019","022"
"26821","BERTINORO",186,6,0,192,"2019","003"
"26822","BERTONICO",1,2720,0,2721,"2019","002"
"26823","BERZANO DI SAN PIETRO",5,0,0,5,"2019","009"
"26824","BERZO DEMO",7,68,7,82,"2019","016"
"26825","BERZO INFERIORE",4,137,2,143,"2019","017"
"26826","BERZO SAN FERMO",695,66,34,795,"2019","025"
"26827","BESANA IN BRIANZA",841,56,33,930,"2019",NA
"26828","BESANO",22,0,19,41,"2019","011"
"26829","BESATE",145,0,0,145,"2019","022"
"26830","BESENZONE",110,1717,0,1827,"2019","003"
"26831","BESNATE",8,217,0,225,"2019","012"
"26832","BESOZZO",20,55,0,75,"2019","013"
"26833","BETTOLA",320,137,0,457,"2019","004"
"26834","BEURA-CARDEZZA",21,9,8,38,"2019","011"
"26835","BEVILACQUA",81,39,0,120,"2019","008"
"26836","BIANDRONNO",12,0,6,18,"2019","014"
"26837","BIANZANO",9,11,0,20,"2019","026"
"26838","BIANZE'",84,395,0,479,"2019","011"
"26839","BIANZONE",3,1,0,4,"2019","008"
"26840","BIASSONO",8,0,0,8,"2019",NA
"26841","BIBBIANO",21,2389,0,2410,"2019","004"
"26842","BIBIANA",539,0,0,539,"2019","025"
"26843","BIELLA",168,41,102,311,"2019","004"
"26844","BIENNO",2,134,6,142,"2019","018"
"26845","BINAGO",39,90,88,217,"2019","023"
"26846","BIOGLIO",5,0,0,5,"2019","005"
"26847","BIONE",5,8,1,14,"2019","019"
"26848","BISTAGNO",9,0,0,9,"2019","017"
"26849","BISUSCHIO",4,0,0,4,"2019","015"
"26850","BIZZARONE",0,7,6,13,"2019","024"
"26851","BLELLO",0,76,0,76,"2019","027"
"26852","BLESSAGNO",0,0,4,4,"2019","025"
"26853","BOARA PISANI",1,0,0,1,"2019","012"
"26854","BOBBIO",207,62,0,269,"2019","005"
"26855","BOBBIO PELLICE",53,11,145,209,"2019","026"
"26856","BOCCIOLETO",9,0,0,9,"2019","014"
"26857","BOFFALORA D'ADDA",37,329,0,366,"2019","003"
"26858","BOFFALORA SOPRA TICINO",70,97,17,184,"2019","026"
"26859","BOLGARE",40,204,29,273,"2019","028"
"26860","BOLLATE",0,242,9,251,"2019","027"
"26861","BOLLENGO",63,58,0,121,"2019","027"
"26862","BOLOGNA",31,42,0,73,"2019","006"
"26863","BOLTIERE",12,62,0,74,"2019","029"
"26864","BOLZANO NOVARESE",0,21,0,21,"2019","022"
"26865","BOLZANO VICENTINO",204,1154,0,1358,"2019","013"
"26866","BOMPORTO",12,157,0,169,"2019","002"
"26867","BONATE SOPRA",298,0,0,298,"2019","030"
"26868","BONATE SOTTO",89,1,0,90,"2019","031"
"26869","BONAVIGO",3586,36,32,3654,"2019","009"
"26870","BONDENO",615,351,0,966,"2019","003"
"26871","BONEMERSE",21,132,0,153,"2019","006"
"26872","BORDOLANO",26,530,113,669,"2019","007"
"26873","BORE",45,4,0,49,"2019","005"
"26874","BORETTO",0,241,0,241,"2019","005"
"26875","BORGARO TORINESE",86,56,0,142,"2019","028"
"26876","BORGHETTO DI BORBERA",146,0,14,160,"2019","018"
"26877","BORGHETTO LODIGIANO",17,1963,187,2167,"2019","004"
"26878","BORGHI",1412,0,0,1412,"2019","004"
"26879","BORGIALLO",4,24,0,28,"2019","029"
"26880","BORGO D'ALE",257,0,0,257,"2019","015"
"26881","BORGO DI TERZO",3,0,0,3,"2019","032"
"26882","BORGO MANTOVANO",0,893,241,1134,"2019",NA
"26883","BORGO PRIOLO",4,0,0,4,"2019","016"
"26884","BORGO SAN DALMAZZO",518,0,90,608,"2019","025"
"26885","BORGO SAN GIACOMO",750,3832,126,4708,"2019","020"
"26886","BORGO SAN GIOVANNI",8,978,0,986,"2019","005"
"26887","BORGO SAN SIRO",2,785,0,787,"2019","018"
"26888","BORGO TICINO",28,0,0,28,"2019","025"
"26889","BORGO TOSSIGNANO",11,0,0,11,"2019","007"
"26890","BORGO VAL DI TARO",83,263,0,346,"2019","006"
"26891","BORGO VALBELLUNA",157,751,0,908,"2019",NA
"26892","BORGO VENETO",1918,43,0,1961,"2019",NA
"26893","BORGO VERCELLI",1,0,0,1,"2019","017"
"26894","BORGO VIRGILIO",179,3702,2348,6229,"2019",NA
"26895","BORGOCARBONARA",0,315,342,657,"2019",NA
"26896","BORGOFRANCO D'IVREA",228,0,0,228,"2019","030"
"26897","BORGOLAVEZZARO",5,0,0,5,"2019","023"
"26898","BORGOMALE",50,0,0,50,"2019","024"
"26899","BORGOMANERO",89,26,0,115,"2019","024"
"26900","BORGOMASINO",21,0,12,33,"2019","031"
"26901","BORGOMEZZAVALLE",3,0,0,3,"2019",NA
"26902","BORGONE SUSA",25,31,0,56,"2019","032"
"26903","BORGONOVO VAL TIDONE",807,2193,0,3000,"2019","006"
"26904","BORGORATTO ALESSANDRINO",21,0,0,21,"2019","019"
"26905","BORGORATTO MORMOROLO",9,0,0,9,"2019","017"
"26906","BORGORICCO",57,24,0,81,"2019","013"
"26907","BORGOSATOLLO",2,581,42,625,"2019","021"
"26908","BORGOSESIA",46,58,0,104,"2019","016"
"26909","BORMIO",27,404,16,447,"2019","009"
"26910","BORNASCO",132,542,2,676,"2019","019"
"26911","BORNO",0,100,63,163,"2019","022"
"26912","BORRIANA",100,63,0,163,"2019","006"
"26913","BORSO DEL GRAPPA",101,241,9,351,"2019","004"
"26914","BOSARO",2,0,0,2,"2019","007"
"26915","BOSCHI SANT'ANNA",46,0,0,46,"2019","010"
"26916","BOSCO CHIESANUOVA",297,1395,0,1692,"2019","011"
"26917","BOSCO MARENGO",44,26,0,70,"2019","021"
"26918","BOSCONERO",63,31,0,94,"2019","033"
"26919","BOSIA",401,0,0,401,"2019","026"
"26920","BOSIO",13,0,2,15,"2019","022"
"26921","BOSISIO PARINI",0,146,0,146,"2019","009"
"26922","BOSSICO",37,56,0,93,"2019","033"
"26923","BOSSOLASCO",43,66,0,109,"2019","027"
"26924","BOTTANUCO",3,333,449,785,"2019","034"
"26925","BOTTICINO",22,0,0,22,"2019","023"
"26926","BOVEGNO",45,60,41,146,"2019","024"
"26927","BOVES",669,716,116,1501,"2019","028"
"26928","BOVOLENTA",3595,269,0,3864,"2019","014"
"26929","BOVOLONE",4003,318,0,4321,"2019","012"
"26930","BOZZOLO",40,1293,17,1350,"2019","007"
"26931","BRA",3515,1429,172,5116,"2019","029"
"26932","BRACCA",3,0,0,3,"2019","035"
"26933","BRALLO DI PREGOLA",7,0,2,9,"2019","021"
"26934","BRANDICO",0,723,0,723,"2019","026"
"26935","BRANDIZZO",0,0,83,83,"2019","034"
"26936","BRANZI",5,25,0,30,"2019","036"
"26937","BRAONE",0,29,1,30,"2019","027"
"26938","BREBBIA",35,0,0,35,"2019","017"
"26939","BREDA DI PIAVE",46,409,4,459,"2019","005"
"26940","BREGANO",6,0,0,6,"2019","018"
"26941","BREGANZE",346,651,97,1094,"2019","014"
"26942","BREGNANO",14,67,0,81,"2019","028"
"26943","BREMBATE",35,0,261,296,"2019","037"
"26944","BREMBATE DI SOPRA",0,240,0,240,"2019","038"
"26945","BREMBIO",189,2184,103,2476,"2019","006"
"26946","BREME",18,0,0,18,"2019","022"
"26947","BRENDOLA",300,110,0,410,"2019","015"
"26948","BRENNA",2,0,0,2,"2019","029"
"26949","BRENO",5,232,6,243,"2019","028"
"26950","BRENTINO BELLUNO",3,0,0,3,"2019","013"
"26951","BRENZONE",4,0,0,4,"2019","014"
"26952","BRESCELLO",0,21,0,21,"2019","006"
"26953","BRESCIA",34,576,0,610,"2019","029"
"26954","BRESSANA BOTTARONE",163,0,0,163,"2019","023"
"26955","BRESSANVIDO",34,1221,20,1275,"2019","016"
"26956","BRESSO",3,0,0,3,"2019",NA
"26957","BREZZO DI BEDERO",2,0,0,2,"2019","020"
"26958","BRIAGLIA",71,0,0,71,"2019","030"
"26959","BRICHERASIO",704,63,23,790,"2019","035"
"26960","BRIGA NOVARESE",0,90,0,90,"2019","026"
"26961","BRIGNANO GERA D'ADDA",250,1677,0,1927,"2019","040"
"26962","BRIGNANO-FRASCATA",3,0,0,3,"2019","024"
"26963","BRINZIO",6,0,0,6,"2019","021"
"26964","BRIONA",12,1721,0,1733,"2019","027"
"26965","BRIONE",12,0,0,12,"2019","030"
"26966","BRIOSCO",9,0,0,9,"2019",NA
"26967","BRISIGHELLA",310,61,0,371,"2019","004"
"26968","BRISSAGO-VALTRAVAGLIA",6,0,0,6,"2019","022"
"26969","BRIVIO",19,59,0,78,"2019","010"
"26970","BROGLIANO",39,34,0,73,"2019","017"
"26971","BRONDELLO",6,0,0,6,"2019","032"
"26972","BRONI",61,0,0,61,"2019","024"
"26973","BROSSASCO",57,0,0,57,"2019","033"
"26974","BROSSO",58,21,7,86,"2019","036"
"26975","BROVELLO-CARPUGNINO",14,0,10,24,"2019","013"
"26976","BROZOLO",34,0,0,34,"2019","037"
"26977","BRUGHERIO",5,253,0,258,"2019",NA
"26978","BRUGINE",3532,67,0,3599,"2019","015"
"26979","BRUINO",108,0,0,108,"2019","038"
"26980","BRUMANO",13,23,0,36,"2019","041"
"26981","BRUNELLO",8,1,0,9,"2019","023"
"26982","BRUNO",10,0,0,10,"2019","010"
"26983","BRUSAPORTO",31,0,13,44,"2019","042"
"26984","BRUSASCO",117,0,0,117,"2019","039"
"26985","BRUSNENGO",11,0,0,11,"2019","007"
"26986","BRUZOLO",45,37,11,93,"2019","040"
"26987","BUBBIANO",0,24,0,24,"2019","035"
"26988","BUBBIO",68,0,0,68,"2019","011"
"26989","BUCCINASCO",10,601,0,611,"2019","036"
"26990","BUDRIO",161,250,0,411,"2019","008"
"26991","BUGLIO IN MONTE",26,271,34,331,"2019","010"
"26992","BULCIAGO",11,0,119,130,"2019","011"
"26993","BULGAROGRASSO",39,328,0,367,"2019","034"
"26994","BURIASCO",1305,700,140,2145,"2019","041"
"26995","BUROLO",17,0,0,17,"2019","042"
"26996","BURONZO",6,16,0,22,"2019","021"
"26997","BUSANO",43,26,0,69,"2019","043"
"26998","BUSCA",4620,1407,463,6490,"2019","034"
"26999","BUSCATE",75,0,0,75,"2019","038"
"27000","BUSNAGO",18,4,0,22,"2019",NA
"27001","BUSSERO",1,441,0,442,"2019","040"
"27002","BUSSETO",1,3679,0,3680,"2019","007"
"27003","BUSSOLENGO",482,117,110,709,"2019","015"
"27004","BUSSOLENO",32,205,12,249,"2019","044"
"27005","BUSTO ARSIZIO",22,177,32,231,"2019","026"
"27006","BUSTO GAROLFO",66,214,0,280,"2019","041"
"27007","BUTTAPIETRA",172,182,0,354,"2019","016"
"27008","BUTTIGLIERA ALTA",106,34,0,140,"2019","045"
"27009","BUTTIGLIERA D'ASTI",2043,96,94,2233,"2019","012"
"27010","CABELLA LIGURE",85,0,0,85,"2019","025"
"27011","CADEGLIANO-VICONAGO",4,0,0,4,"2019","027"
"27012","CADELBOSCO DI SOPRA",11,1710,0,1721,"2019","008"
"27013","CADEO",314,2841,0,3155,"2019","007"
"27014","CADONEGHE",9,13,0,22,"2019","016"
"27015","CADORAGO",5,0,44,49,"2019","036"
"27016","CADREZZATE CON OSMATE",23,0,0,23,"2019",NA
"27017","CAERANO DI SAN MARCO",234,47,0,281,"2019","006"
"27018","CAFASSE",102,47,11,160,"2019","046"
"27019","CAGLIO",48,0,0,48,"2019","037"
"27020","CAINO",5,0,0,5,"2019","031"
"27021","CAIOLO",0,70,0,70,"2019","011"
"27022","CAIRATE",4,0,0,4,"2019","029"
"27023","CALAMANDRANA",78,0,0,78,"2019","013"
"27024","CALASCA-CASTIGLIONE",7,0,0,7,"2019","014"
"27025","CALCINATE",236,217,16,469,"2019","043"
"27026","CALCINATO",6810,1665,1297,9772,"2019","032"
"27027","CALCIO",223,1514,0,1737,"2019","044"
"27028","CALCO",13,205,0,218,"2019","012"
"27029","CALDERARA DI RENO",69,56,0,125,"2019","009"
"27030","CALDOGNO",163,381,139,683,"2019","018"
"27031","CALENDASCO",115,403,0,518,"2019","008"
"27032","CALESTANO",35,315,0,350,"2019","008"
"27033","CALLABIANA",26,0,0,26,"2019","008"
"27034","CALLIANO",189,0,0,189,"2019","014"
"27035","CALOLZIOCORTE",11,0,13,24,"2019","013"
"27036","CALOSSO",3,0,0,3,"2019","015"
"27037","CALTIGNAGA",1368,167,0,1535,"2019","030"
"27038","CALTO",20,0,0,20,"2019","008"
"27039","CALTRANO",2126,3,0,2129,"2019","019"
"27040","CALUSCO D'ADDA",9,0,0,9,"2019","046"
"27041","CALUSO",1028,153,0,1181,"2019","047"
"27042","CALVAGESE DELLA RIVIERA",224,218,3,445,"2019","033"
"27043","CALVATONE",7,135,0,142,"2019","009"
"27044","CALVENE",10,25,0,35,"2019","020"
"27045","CALVENZANO",27,643,0,670,"2019","047"
"27046","CALVIGNASCO",1,33,0,34,"2019","042"
"27047","CALVISANO",15824,4553,196,20573,"2019","034"
"27048","CAMAGNA MONFERRATO",21,0,0,21,"2019","026"
"27049","CAMANDONA",9,0,0,9,"2019","009"
"27050","CAMBIAGO",24,100,0,124,"2019","044"
"27051","CAMBIANO",296,0,0,296,"2019","048"
"27052","CAMBIASCA",12,0,0,12,"2019","015"
"27053","CAMBURZANO",82,0,11,93,"2019","010"
"27054","CAMERANA",323,0,0,323,"2019","035"
"27055","CAMERANO CASASCO",18,0,0,18,"2019","016"
"27056","CAMERATA CORNELLO",9,75,0,84,"2019","048"
"27057","CAMERI",81,600,0,681,"2019","032"
"27058","CAMISANO",277,2566,467,3310,"2019","010"
"27059","CAMISANO VICENTINO",268,1323,240,1831,"2019","021"
"27060","CAMPAGNA LUPIA",106,87,0,193,"2019","002"
"27061","CAMPAGNOLA CREMASCA",46,491,224,761,"2019","011"
"27062","CAMPAGNOLA EMILIA",1,750,0,751,"2019","009"
"27063","CAMPEGINE",2,1126,0,1128,"2019","010"
"27064","CAMPERTOGNO",0,49,0,49,"2019","025"
"27065","CAMPIGLIA CERVO",3,2,0,5,"2019","011"
"27066","CAMPIGLIA DEI BERICI",574,127,2,703,"2019","022"
"27067","CAMPIGLIONE-FENILE",520,0,29,549,"2019","049"
"27068","CAMPO SAN MARTINO",478,84,0,562,"2019","020"
"27069","CAMPODARSEGO",823,42,0,865,"2019","017"
"27070","CAMPODORO",60,157,16,233,"2019","018"
"27071","CAMPOGALLIANO",3,354,0,357,"2019","003"
"27072","CAMPOLONGO MAGGIORE",35,45,0,80,"2019","003"
"27073","CAMPONOGARA",134,52,0,186,"2019","004"
"27074","CAMPOSAMPIERO",114,96,5,215,"2019","019"
"27075","CAMUGNANO",380,78,0,458,"2019","010"
"27076","CANALE",811,0,0,811,"2019","037"
"27077","CANARO",466,12,0,478,"2019","009"
"27078","CANDA",14,0,0,14,"2019","010"
"27079","CANDELO",72,49,83,204,"2019","012"
"27080","CANDIA CANAVESE",30,0,0,30,"2019","050"
"27081","CANDIANA",10584,224,0,10808,"2019","021"
"27082","CANDIOLO",93,487,146,726,"2019","051"
"27083","CANELLI",7,0,0,7,"2019","017"
"27084","CANISCHIO",11,27,0,38,"2019","052"
"27085","CANNETO SULL'OGLIO",1605,1667,1361,4633,"2019","008"
"27086","CANNOBIO",10,3,0,13,"2019","017"
"27087","CANONICA D'ADDA",13,416,0,429,"2019","049"
"27088","CANOSIO",15,0,117,132,"2019","038"
"27089","CANOSSA",33,262,0,295,"2019","018"
"27090","CANTALUPA",22,0,0,22,"2019","053"
"27091","CANTALUPO LIGURE",4,0,0,4,"2019","028"
"27092","CANTARANA",76,0,0,76,"2019","018"
"27093","CANTELLO",133,139,0,272,"2019","030"
"27094","CANTOIRA",94,25,10,129,"2019","054"
"27095","CANTU'",249,234,32,515,"2019","041"
"27096","CANZO",0,0,17,17,"2019","042"
"27097","CAORLE",765,25,48,838,"2019","005"
"27098","CAORSO",4,450,0,454,"2019","010"
"27099","CAPERGNANICA",393,1181,14,1588,"2019","012"
"27100","CAPIAGO INTIMIANO",0,16,2,18,"2019","043"
"27101","CAPIZZONE",28,22,0,50,"2019","050"
"27102","CAPO DI PONTE",29,141,2,172,"2019","035"
"27103","CAPONAGO",102,0,0,102,"2019",NA
"27104","CAPOVALLE",8,0,8,16,"2019","036"
"27105","CAPPELLA CANTONE",0,399,0,399,"2019","013"
"27106","CAPPELLA DE' PICENARDI",6,393,0,399,"2019","014"
"27107","CAPPELLA MAGGIORE",5,12,0,17,"2019","007"
"27108","CAPRALBA",1,1383,145,1529,"2019","015"
"27109","CAPRAUNA",3,0,0,3,"2019","039"
"27110","CAPRIANO DEL COLLE",14,426,0,440,"2019","037"
"27111","CAPRIATA D'ORBA",15,0,0,15,"2019","029"
"27112","CAPRIE",37,0,0,37,"2019","055"
"27113","CAPRIGLIO",2,0,0,2,"2019","019"
"27114","CAPRILE",34,3,0,37,"2019","013"
"27115","CAPRINO BERGAMASCO",10,0,0,10,"2019","052"
"27116","CAPRINO VERONESE",63,657,88,808,"2019","018"
"27117","CAPRIOLO",270,0,58,328,"2019","038"
"27118","CARAGLIO",3636,813,408,4857,"2019","040"
"27119","CARAMAGNA PIEMONTE",1925,683,82,2690,"2019","041"
"27120","CARATE BRIANZA",49,0,0,49,"2019",NA
"27121","CARAVAGGIO",406,3045,0,3451,"2019","053"
"27122","CARAVATE",0,91,0,91,"2019","031"
"27123","CARBONARA AL TICINO",0,339,0,339,"2019","030"
"27124","CARBONARA SCRIVIA",31,0,0,31,"2019","030"
"27125","CARBONATE",121,49,26,196,"2019","045"
"27126","CARBONERA",48,238,87,373,"2019","008"
"27127","CARCERI",1496,0,0,1496,"2019","022"
"27128","CARCOFORO",0,0,8,8,"2019","029"
"27129","CARDANO AL CAMPO",10,0,0,10,"2019","032"
"27130","CARDE'",2498,1884,20,4402,"2019","042"
"27131","CAREMA",71,0,2,73,"2019","057"
"27132","CARENNO",26,0,5,31,"2019","014"
"27133","CARENTINO",89,597,0,686,"2019","031"
"27134","CARESANA",5,0,0,5,"2019","030"
"27135","CAREZZANO",3,0,0,3,"2019","032"
"27136","CARIGNANO",2890,1547,319,4756,"2019","058"
"27137","CARISIO",28,0,0,28,"2019","032"
"27138","CARLAZZO",22,58,17,97,"2019","047"
"27139","CARMAGNOLA",6864,3071,0,9935,"2019","059"
"27140","CARMIGNANO DI BRENTA",105,1257,0,1362,"2019","023"
"27141","CARNAGO",20,49,0,69,"2019","033"
"27142","CAROBBIO DEGLI ANGELI",77,34,0,111,"2019","055"
"27143","CARONNO PERTUSELLA",3,0,0,3,"2019","034"
"27144","CARONNO VARESINO",32,0,0,32,"2019","035"
"27145","CARPANETO PIACENTINO",46,4673,0,4719,"2019","011"
"27146","CARPENEDOLO",1592,4097,221,5910,"2019","039"
"27147","CARPENETO",114,0,0,114,"2019","033"
"27148","CARPI",4,2068,0,2072,"2019","005"
"27149","CARPIANO",124,1238,236,1598,"2019","050"
"27150","CARPIGNANO SESIA",98,0,0,98,"2019","036"
"27151","CARPINETI",99,1306,0,1405,"2019","011"
"27152","CARRE'",368,118,0,486,"2019","024"
"27153","CARREGA LIGURE",37,0,0,37,"2019","034"
"27154","CARRU'",717,50,58,825,"2019","043"
"27155","CARTIGLIANO",22,13,0,35,"2019","025"
"27156","CARTIGNANO",162,62,0,224,"2019","044"
"27157","CARTOSIO",55,0,0,55,"2019","036"
"27158","CARTURA",400,20,0,420,"2019","026"
"27159","CARUGATE",19,105,0,124,"2019","051"
"27160","CARUGO",7,0,0,7,"2019","048"
"27161","CARVICO",1,0,0,1,"2019","057"
"27162","CASALBELTRAME",1,0,173,174,"2019","037"
"27163","CASALBORGONE",53,0,0,53,"2019","060"
"27164","CASALBUTTANO ED UNITI",10,1845,0,1855,"2019","016"
"27165","CASALE CORTE CERRO",16,0,0,16,"2019","019"
"27166","CASALE CREMASCO-VIDOLASCO",0,1929,60,1989,"2019","017"
"27167","CASALE DI SCODOSIA",654,0,0,654,"2019","027"
"27168","CASALE LITTA",19,162,20,201,"2019","036"
"27169","CASALE MONFERRATO",125,159,0,284,"2019","039"
"27170","CASALE SUL SILE",729,28,69,826,"2019","009"
"27171","CASALEGGIO BOIRO",22,0,0,22,"2019","038"
"27172","CASALEONE",143,0,0,143,"2019","019"
"27173","CASALETTO CEREDANO",9,4,0,13,"2019","018"
"27174","CASALETTO DI SOPRA",16,311,0,327,"2019","019"
"27175","CASALETTO LODIGIANO",34,316,0,350,"2019","008"
"27176","CASALETTO VAPRIO",160,587,137,884,"2019","020"
"27177","CASALFIUMANESE",659,161,0,820,"2019","012"
"27178","CASALGRANDE",31,1113,0,1144,"2019","012"
"27179","CASALGRASSO",322,272,124,718,"2019","045"
"27180","CASALINO",11,160,0,171,"2019","040"
"27181","CASALMAGGIORE",8,655,0,663,"2019","021"
"27182","CASALMAIOCCO",8,505,0,513,"2019","009"
"27183","CASALMORANO",106,2351,167,2624,"2019","022"
"27184","CASALMORO",351,0,509,860,"2019","010"
"27185","CASALNOCETO",26,0,0,26,"2019","040"
"27186","CASALOLDO",946,707,1534,3187,"2019","011"
"27187","CASALPUSTERLENGO",0,1220,0,1220,"2019","010"
"27188","CASALROMANO",331,250,251,832,"2019","012"
"27189","CASALSERUGO",128,7,0,135,"2019","028"
"27190","CASALVOLONE",0,49,0,49,"2019","041"
"27191","CASALZUIGNO",2,111,0,113,"2019","037"
"27192","CASARGO",9,25,0,34,"2019","015"
"27193","CASARILE",54,0,0,54,"2019","055"
"27194","CASATENOVO",417,0,0,417,"2019","016"
"27195","CASAZZA",6,15,0,21,"2019","058"
"27196","CASCIAGO",19,0,34,53,"2019","038"
"27197","CASEI GEROLA",638,0,0,638,"2019","033"
"27198","CASELETTE",88,329,47,464,"2019","062"
"27199","CASELLE LANDI",282,496,0,778,"2019","011"
"27200","CASELLE LURANI",49,323,0,372,"2019","012"
"27201","CASELLE TORINESE",390,1315,0,1705,"2019","063"
"27202","CASIER",8,99,0,107,"2019","010"
"27203","CASINA",67,930,0,997,"2019","013"
"27204","CASIRATE D'ADDA",164,384,0,548,"2019","059"
"27205","CASLINO D'ERBA",3,0,10,13,"2019","052"
"27206","CASNATE CON BERNATE",22,0,0,22,"2019","053"
"27207","CASNIGO",36,109,0,145,"2019","060"
"27208","CASOLA VALSENIO",131,18,0,149,"2019","005"
"27209","CASORATE PRIMO",16,116,0,132,"2019","034"
"27210","CASORATE SEMPIONE",1,0,0,1,"2019","039"
"27211","CASOREZZO",0,330,0,330,"2019","058"
"27212","CASORZO",4,0,0,4,"2019","020"
"27213","CASPOGGIO",2,43,0,45,"2019","013"
"27214","CASSAGO BRIANZA",2,46,0,48,"2019","017"
"27215","CASSANO D'ADDA",269,291,0,560,"2019","059"
"27216","CASSANO MAGNAGO",10,70,31,111,"2019","040"
"27217","CASSANO SPINOLA",229,0,0,229,"2019","042"
"27218","CASSANO VALCUVIA",3,0,0,3,"2019","041"
"27219","CASSINA DE' PECCHI",0,316,0,316,"2019","060"
"27220","CASSINA VALSASSINA",5,34,0,39,"2019","018"
"27221","CASSINASCO",28,22,0,50,"2019","021"
"27222","CASSINE",327,0,0,327,"2019","043"
"27223","CASSINELLE",5,0,0,5,"2019","044"
"27224","CASSINETTA DI LUGAGNANO",0,235,0,235,"2019","061"
"27225","CASSOLA",518,26,0,544,"2019","026"
"27226","CASSOLNOVO",0,35,0,35,"2019","035"
"27227","CASTAGNARO",601,0,0,601,"2019","020"
"27228","CASTAGNETO PO",47,0,0,47,"2019","064"
"27229","CASTAGNITO",122,0,0,122,"2019","046"
"27230","CASTAGNOLE DELLE LANZE",270,0,0,270,"2019","022"
"27231","CASTAGNOLE MONFERRATO",58,0,0,58,"2019","023"
"27232","CASTAGNOLE PIEMONTE",1356,742,74,2172,"2019","065"
"27233","CASTANA",2,0,0,2,"2019","036"
"27234","CASTANO PRIMO",82,0,0,82,"2019","062"
"27235","CASTEGGIO",8,0,0,8,"2019","037"
"27236","CASTEGNATO",38,1072,13,1123,"2019","040"
"27237","CASTEGNERO",35,45,0,80,"2019","027"
"27238","CASTEL BOGLIONE",7,0,0,7,"2019","024"
"27239","CASTEL BOLOGNESE",30,0,0,30,"2019","006"
"27240","CASTEL D'AIANO",23,583,0,606,"2019","013"
"27241","CASTEL D'ARIO",187,21,1112,1320,"2019","014"
"27242","CASTEL D'AZZANO",1744,97,0,1841,"2019","021"
"27243","CASTEL DEL RIO",72,0,0,72,"2019","014"
"27244","CASTEL DI CASIO",78,22,0,100,"2019","015"
"27245","CASTEL GABBIANO",0,1757,0,1757,"2019","024"
"27246","CASTEL GOFFREDO",2066,443,606,3115,"2019","015"
"27247","CASTEL GUELFO DI BOLOGNA",143,263,2,408,"2019","016"
"27248","CASTEL MELLA",3,369,0,372,"2019","042"
"27249","CASTEL ROZZONE",1,24,0,25,"2019","063"
"27250","CASTEL SAN GIOVANNI",109,876,0,985,"2019","013"
"27251","CASTEL SAN PIETRO TERME",988,308,0,1296,"2019","020"
"27252","CASTELBELFORTE",1682,0,0,1682,"2019","013"
"27253","CASTELCOVATI",5,422,31,458,"2019","041"
"27254","CASTELCUCCO",60,193,0,253,"2019","011"
"27255","CASTELDELCI",211,0,0,211,"2019","021"
"27256","CASTELDELFINO",56,0,0,56,"2019","047"
"27257","CASTELDIDONE",54,0,0,54,"2019","023"
"27258","CASTELFRANCO EMILIA",1501,2766,0,4267,"2019","006"
"27259","CASTELFRANCO VENETO",4775,173,16,4964,"2019","012"
"27260","CASTELGERUNDO",35,1815,69,1919,"2019",NA
"27261","CASTELGOMBERTO",355,405,0,760,"2019","028"
"27262","CASTELGUGLIELMO",501,0,0,501,"2019","011"
"27263","CASTELL'ALFERO",392,0,0,392,"2019","025"
"27264","CASTELL'ARQUATO",93,763,0,856,"2019","012"
"27265","CASTELLAMONTE",398,345,22,765,"2019","066"
"27266","CASTELLARANO",19,317,0,336,"2019","014"
"27267","CASTELLAZZO BORMIDA",130,86,0,216,"2019","047"
"27268","CASTELLEONE",728,3945,110,4783,"2019","025"
"27269","CASTELLETTO CERVO",25,32,0,57,"2019","015"
"27270","CASTELLETTO D'ERRO",1,0,0,1,"2019",NA
"27271","CASTELLETTO D'ORBA",9,0,0,9,"2019","049"
"27272","CASTELLETTO DI BRANDUZZO",10,0,0,10,"2019","038"
"27273","CASTELLETTO MERLI",72,0,0,72,"2019","050"
"27274","CASTELLETTO MONFERRATO",69,0,0,69,"2019","051"
"27275","CASTELLETTO SOPRA TICINO",130,42,0,172,"2019","043"
"27276","CASTELLETTO STURA",1838,41,51,1930,"2019","049"
"27277","CASTELLI CALEPIO",37,238,0,275,"2019","062"
"27278","CASTELLINALDO D'ALBA",918,0,0,918,"2019",NA
"27279","CASTELLINO TANARO",154,0,0,154,"2019","052"
"27280","CASTELLO CABIAGLIO",13,0,0,13,"2019","043"
"27281","CASTELLO D'AGOGNA",8,0,0,8,"2019",NA
"27282","CASTELLO D'ARGILE",81,0,0,81,"2019","017"
"27283","CASTELLO DELL'ACQUA",17,13,0,30,"2019","014"
"27284","CASTELLO DI ANNONE",156,0,0,156,"2019","028"
"27285","CASTELLO DI BRIANZA",16,0,0,16,"2019","019"
"27286","CASTELLO DI GODEGO",6211,135,1,6347,"2019","013"
"27287","CASTELLUCCHIO",925,1593,2137,4655,"2019","016"
"27288","CASTELMAGNO",61,8,7,76,"2019","053"
"27289","CASTELMARTE",8,0,0,8,"2019","058"
"27290","CASTELMASSA",0,99,0,99,"2019","012"
"27291","CASTELNOVO BARIANO",2175,22,0,2197,"2019","013"
"27292","CASTELNOVO DI SOTTO",8,1162,0,1170,"2019","015"
"27293","CASTELNOVO NE' MONTI",61,1455,0,1516,"2019","016"
"27294","CASTELNUOVO BOCCA D'ADDA",2974,290,61,3325,"2019","013"
"27295","CASTELNUOVO BORMIDA",11,0,0,11,"2019","052"
"27296","CASTELNUOVO BOZZENTE",5,11,0,16,"2019","059"
"27297","CASTELNUOVO CALCEA",7,0,0,7,"2019","030"
"27298","CASTELNUOVO DEL GARDA",3323,204,0,3527,"2019","022"
"27299","CASTELNUOVO DON BOSCO",160,0,0,160,"2019","031"
"27300","CASTELNUOVO NIGRA",41,0,0,41,"2019","067"
"27301","CASTELNUOVO RANGONE",1,816,0,817,"2019","007"
"27302","CASTELNUOVO SCRIVIA",17,0,10,27,"2019","053"
"27303","CASTELSEPRIO",3,0,4,7,"2019","044"
"27304","CASTELSPINA",12,0,0,12,"2019","054"
"27305","CASTELVECCANA",1,0,0,1,"2019","045"
"27306","CASTELVERDE",391,3563,105,4059,"2019","026"
"27307","CASTELVETRO DI MODENA",12,1126,0,1138,"2019","008"
"27308","CASTELVETRO PIACENTINO",638,1016,0,1654,"2019","014"
"27309","CASTELVISCONTI",12,1610,49,1671,"2019","027"
"27310","CASTENASO",116,105,0,221,"2019","021"
"27311","CASTENEDOLO",865,1047,17,1929,"2019","043"
"27312","CASTIGLIONE D'ADDA",3,271,0,274,"2019","014"
"27313","CASTIGLIONE DEI PEPOLI",225,32,0,257,"2019","022"
"27314","CASTIGLIONE DELLE STIVIERE",4277,1683,1536,7496,"2019","017"
"27315","CASTIGLIONE FALLETTO",32,0,0,32,"2019","055"
"27316","CASTIGLIONE OLONA",4,0,9,13,"2019","046"
"27317","CASTIGLIONE TINELLA",37,0,0,37,"2019","056"
"27318","CASTIGLIONE TORINESE",12,0,0,12,"2019","068"
"27319","CASTINO",122,0,0,122,"2019","057"
"27320","CASTIONE ANDEVENNO",16,43,0,59,"2019","015"
"27321","CASTIONE DELLA PRESOLANA",20,9,2,31,"2019","064"
"27322","CASTIRAGA VIDARDO",8,271,0,279,"2019","015"
"27323","CASTO",17,34,1,52,"2019","044"
"27324","CASTREZZATO",404,1063,109,1576,"2019","045"
"27325","CASTRO",1,0,0,1,"2019","065"
"27326","CASTROCARO TERME E TERRA DEL SOLE",16,5,0,21,"2019","005"
"27327","CASTRONNO",4,0,0,4,"2019","047"
"27328","CAVAGLIA'",1242,171,0,1413,"2019","016"
"27329","CAVAGLIETTO",2,189,0,191,"2019","044"
"27330","CAVAGNOLO",37,0,0,37,"2019","069"
"27331","CAVAION VERONESE",6,0,0,6,"2019","023"
"27332","CAVALLERLEONE",417,1209,92,1718,"2019","058"
"27333","CAVALLERMAGGIORE",2576,2278,44,4898,"2019","059"
"27334","CAVALLINO-TREPORTI",7,0,0,7,"2019","044"
"27335","CAVARGNA",1,0,17,18,"2019","062"
"27336","CAVARIA CON PREMEZZO",7,0,0,7,"2019","048"
"27337","CAVARZERE",5724,0,0,5724,"2019","006"
"27338","CAVASO DEL TOMBA",79,72,0,151,"2019","014"
"27339","CAVATORE",5,0,0,5,"2019","055"
"27340","CAVENAGO D'ADDA",11,629,136,776,"2019","017"
"27341","CAVEZZO",0,446,0,446,"2019","009"
"27342","CAVOUR",3896,337,1078,5311,"2019","070"
"27343","CAVRIAGO",25,548,0,573,"2019","017"
"27344","CAVRIANA",1861,1255,587,3703,"2019","018"
"27345","CAZZAGO SAN MARTINO",4175,190,121,4486,"2019","046"
"27346","CAZZANO DI TRAMIGNA",21,0,0,21,"2019","024"
"27347","CAZZANO SANT'ANDREA",308,8,0,316,"2019","067"
"27348","CECIMA",15,0,0,15,"2019","042"
"27349","CEDEGOLO",0,14,2,16,"2019","047"
"27350","CEDRASCO",0,58,0,58,"2019","016"
"27351","CEGGIA",15,1,0,16,"2019","007"
"27352","CELLA DATI",1916,76,34,2026,"2019","028"
"27353","CELLA MONTE",117,0,0,117,"2019","056"
"27354","CELLARENGO",228,83,177,488,"2019","033"
"27355","CELLATICA",1,60,0,61,"2019","048"
"27356","CELLE DI MACRA",90,0,13,103,"2019","060"
"27357","CELLE ENOMONDO",173,0,0,173,"2019","034"
"27358","CELLIO CON BREIA",11,0,0,11,"2019",NA
"27359","CENATE SOPRA",11,9,0,20,"2019","068"
"27360","CENATE SOTTO",16,0,0,16,"2019","069"
"27361","CENCENIGHE AGORDINO",3,0,0,3,"2019","010"
"27362","CENE",37,66,0,103,"2019","070"
"27363","CENESELLI",0,242,23,265,"2019","014"
"27364","CENTALLO",5621,768,445,6834,"2019","061"
"27365","CENTO",4,0,0,4,"2019","004"
"27366","CENTRO VALLE INTELVI",52,11,10,73,"2019",NA
"27367","CEPPO MORELLI",22,0,0,22,"2019","021"
"27368","CERANO",47,0,0,47,"2019","049"
"27369","CERANO D'INTELVI",8,0,51,59,"2019","063"
"27370","CERANOVA",0,578,0,578,"2019","043"
"27371","CERCENASCO",151,315,0,466,"2019","071"
"27372","CERCINO",9,40,0,49,"2019","017"
"27373","CEREA",1211,201,0,1412,"2019","025"
"27374","CERES",4,0,0,4,"2019","072"
"27375","CERESARA",1452,368,123,1943,"2019","019"
"27376","CERESETO",106,0,0,106,"2019","057"
"27377","CERESOLE ALBA",3363,658,0,4021,"2019","062"
"27378","CERESOLE REALE",0,5,0,5,"2019","073"
"27379","CERETE",21,124,0,145,"2019","071"
"27380","CERIANO LAGHETTO",0,48,0,48,"2019",NA
"27381","CERIGNALE",34,0,0,34,"2019","015"
"27382","CERMENATE",24,145,8,177,"2019","064"
"27383","CERNOBBIO",2,0,0,2,"2019",NA
"27384","CERNUSCO LOMBARDONE",5,0,0,5,"2019","020"
"27385","CERNUSCO SUL NAVIGLIO",15,171,0,186,"2019","070"
"27386","CERRETO GRUE",32,0,0,32,"2019","058"
"27387","CERRETTO LANGHE",8,0,0,8,"2019","063"
"27388","CERRINA MONFERRATO",29,12,17,58,"2019","059"
"27389","CERRIONE",384,127,0,511,"2019","018"
"27390","CERRO AL LAMBRO",1,836,0,837,"2019","071"
"27391","CERRO MAGGIORE",3,72,0,75,"2019","072"
"27392","CERRO TANARO",305,0,0,305,"2019","036"
"27393","CERRO VERONESE",20,151,0,171,"2019","026"
"27394","CERTOSA DI PAVIA",12,0,0,12,"2019","046"
"27395","CERVARESE SANTA CROCE",30,177,4,211,"2019","030"
"27396","CERVASCA",1230,148,27,1405,"2019","064"
"27397","CERVENO",0,21,2,23,"2019","049"
"27398","CERVERE",1589,149,216,1954,"2019","065"
"27399","CERVIGNANO D'ADDA",0,894,0,894,"2019","018"
"27400","CESANA BRIANZA",5,20,0,25,"2019","021"
"27401","CESANA TORINESE",46,0,40,86,"2019","074"
"27402","CESANO BOSCONE",0,86,0,86,"2019","074"
"27403","CESARA",1,0,0,1,"2019","022"
"27404","CESATE",2,0,0,2,"2019","076"
"27405","CESENA",73,19,0,92,"2019","007"
"27406","CESIOMAGGIORE",189,108,0,297,"2019","011"
"27407","CESSALTO",48,99,0,147,"2019","015"
"27408","CESSOLE",177,0,0,177,"2019","037"
"27409","CETO",6,24,48,78,"2019","050"
"27410","CEVA",1508,0,0,1508,"2019","066"
"27411","CEVO",0,5,33,38,"2019","051"
"27412","CHERASCO",4985,940,113,6038,"2019","067"
"27413","CHIALAMBERTO",10,0,13,23,"2019","075"
"27414","CHIAMPO",29,47,0,76,"2019","029"
"27415","CHIANOCCO",34,0,0,34,"2019","076"
"27416","CHIARANO",8,377,2,387,"2019","016"
"27417","CHIARI",1287,5713,227,7227,"2019","052"
"27418","CHIAVENNA",4,7,2,13,"2019","018"
"27419","CHIAVERANO",27,0,0,27,"2019","077"
"27420","CHIERI",2750,491,41,3282,"2019","078"
"27421","CHIES D'ALPAGO",14,12,0,26,"2019","012"
"27422","CHIESA IN VALMALENCO",19,39,0,58,"2019","019"
"27423","CHIESANUOVA",3,0,0,3,"2019","079"
"27424","CHIEVE",0,901,0,901,"2019","029"
"27425","CHIGNOLO D'ISOLA",58,415,0,473,"2019","072"
"27426","CHIGNOLO PO",6,99,0,105,"2019","048"
"27427","CHIOGGIA",3406,0,0,3406,"2019","008"
"27428","CHIOMONTE",0,29,0,29,"2019","080"
"27429","CHIUDUNO",20,0,0,20,"2019","073"
"27430","CHIUPPANO",8,19,0,27,"2019","030"
"27431","CHIURO",15,1,0,16,"2019","020"
"27432","CHIUSA DI PESIO",1501,333,16,1850,"2019","068"
"27433","CHIUSA DI SAN MICHELE",0,0,69,69,"2019","081"
"27434","CHIUSANO D'ASTI",9,0,0,9,"2019","038"
"27435","CHIVASSO",1289,271,0,1560,"2019","082"
"27436","CICOGNOLO",0,1088,0,1088,"2019","030"
"27437","CICONIO",73,124,0,197,"2019","083"
"27438","CIGLIANO",265,65,38,368,"2019","042"
"27439","CIGLIE'",431,0,0,431,"2019","069"
"27440","CIGOGNOLA",1,0,0,1,"2019","049"
"27441","CIGOLE",2093,1547,0,3640,"2019","053"
"27442","CILAVEGNA",5,0,0,5,"2019","050"
"27443","CIMADOLMO",397,65,0,462,"2019","017"
"27444","CIMBERGO",3,1,0,4,"2019","054"
"27445","CINAGLIO",345,0,9,354,"2019","039"
"27446","CINGIA DE' BOTTI",0,893,60,953,"2019","031"
"27447","CINO",7,12,0,19,"2019","021"
"27448","CINTANO",35,0,0,35,"2019","084"
"27449","CINTO CAOMAGGIORE",447,2,31,480,"2019","009"
"27450","CINTO EUGANEO",52,31,0,83,"2019","031"
"27451","CINZANO",14,0,0,14,"2019","085"
"27452","CIRIE'",373,183,46,602,"2019","086"
"27453","CIRIMIDO",1,35,0,36,"2019","068"
"27454","CISANO BERGAMASCO",28,0,0,28,"2019","074"
"27455","CISERANO",25,40,0,65,"2019","075"
"27456","CISLAGO",3,0,0,3,"2019","050"
"27457","CISLIANO",141,477,0,618,"2019","078"
"27458","CISON DI VALMARINO",111,0,7,118,"2019","018"
"27459","CISSONE",5,0,0,5,"2019","070"
"27460","CISTERNA D'ASTI",68,0,0,68,"2019","040"
"27461","CITTADELLA",2034,927,151,3112,"2019","032"
"27462","CITTIGLIO",7,11,0,18,"2019","051"
"27463","CIVATE",5,0,0,5,"2019","022"
"27464","CIVIASCO",1,4,0,5,"2019","043"
"27465","CIVIDATE AL PIANO",710,550,0,1260,"2019","076"
"27466","CIVIDATE CAMUNO",1,0,0,1,"2019","055"
"27467","CIVITELLA DI ROMAGNA",381,12,20,413,"2019","009"
"27468","CIVO",9,17,0,26,"2019","022"
"27469","CLAINO CON OSTENO",1,0,1,2,"2019","071"
"27470","CLAVESANA",457,0,0,457,"2019","071"
"27471","CLIVIO",18,74,0,92,"2019","052"
"27472","CLUSONE",69,181,1,251,"2019","077"
"27473","COASSOLO TORINESE",28,0,1,29,"2019","088"
"27474","COAZZE",15,0,11,26,"2019","089"
"27475","COAZZOLO",34,0,0,34,"2019","041"
"27476","COCCAGLIO",202,986,8,1196,"2019","056"
"27477","COCCONATO",58,0,0,58,"2019","042"
"27478","COCQUIO-TREVISAGO",22,0,0,22,"2019","053"
"27479","CODEVIGO",465,97,0,562,"2019","033"
"27480","CODEVILLA",4,0,0,4,"2019","051"
"27481","CODIGORO",3687,227,0,3914,"2019","005"
"27482","CODOGNE'",40,212,3,255,"2019","019"
"27483","CODOGNO",6,1002,0,1008,"2019","019"
"27484","COGGIOLA",8,0,0,8,"2019","019"
"27485","COGLIATE",63,0,0,63,"2019",NA
"27486","COGOLLO DEL CENGIO",382,105,0,487,"2019","032"
"27487","COLCERESA",17,422,19,458,"2019",NA
"27488","COLERE",3,0,0,3,"2019","078"
"27489","COLI",66,0,0,66,"2019","016"
"27490","COLICO",78,97,45,220,"2019","023"
"27491","COLLE BRIANZA",5,0,0,5,"2019","024"
"27492","COLLE SANTA LUCIA",0,12,0,12,"2019","014"
"27493","COLLE UMBERTO",22,108,8,138,"2019","020"
"27494","COLLECCHIO",5,2541,0,2546,"2019","009"
"27495","COLLEGNO",137,326,6,469,"2019","090"
"27496","COLLERETTO CASTELNUOVO",4,25,0,29,"2019","091"
"27497","COLLERETTO GIACOSA",30,0,0,30,"2019","092"
"27498","COLLI VERDI",132,0,0,132,"2019",NA
"27499","COLLIO",37,55,14,106,"2019","058"
"27500","COLOGNA VENETA",9779,211,0,9990,"2019","027"
"27501","COLOGNE",463,665,1,1129,"2019","059"
"27502","COLOGNO AL SERIO",36,958,9,1003,"2019","079"
"27503","COLORINA",40,366,0,406,"2019","023"
"27504","COLORNO",0,1342,0,1342,"2019","010"
"27505","COLTURANO",0,20,0,20,"2019","082"
"27506","COLVERDE",21,97,11,129,"2019",NA
"27507","COLZATE",27,24,0,51,"2019","080"
"27508","COMACCHIO",330,208,0,538,"2019","006"
"27509","COMAZZO",41,846,11,898,"2019","020"
"27510","COMELICO SUPERIORE",23,135,0,158,"2019","015"
"27511","COMERIO",4,0,0,4,"2019","055"
"27512","COMEZZANO-CIZZAGO",132,1779,5,1916,"2019","060"
"27513","COMMESSAGGIO",1,14,19,34,"2019","020"
"27514","COMO",4,58,10,72,"2019","075"
"27515","COMPIANO",14,23,0,37,"2019","011"
"27516","COMUN NUOVO",86,0,0,86,"2019","081"
"27517","CONA",13211,0,0,13211,"2019","010"
"27518","CONCAMARISE",0,276,0,276,"2019","029"
"27519","CONCESIO",19,8,0,27,"2019","061"
"27520","CONCORDIA SAGITTARIA",1139,0,0,1139,"2019","011"
"27521","CONCORDIA SULLA SECCHIA",19,344,0,363,"2019","010"
"27522","CONCOREZZO",3,31,0,34,"2019",NA
"27523","CONDOVE",125,20,64,209,"2019","093"
"27524","CONEGLIANO",19,31,13,63,"2019","021"
"27525","CONFIENZA",26,14,55,95,"2019","052"
"27526","CONIOLO",164,0,0,164,"2019","060"
"27527","CONSELICE",534,212,0,746,"2019","008"
"27528","CONSELVE",1146,39,0,1185,"2019","034"
"27529","CONZANO",115,0,0,115,"2019","061"
"27530","COPPARO",116,0,0,116,"2019","007"
"27531","CORBETTA",373,62,19,454,"2019","085"
"27532","CORBOLA",38,126,0,164,"2019","017"
"27533","CORDIGNANO",75,132,0,207,"2019","022"
"27534","CORIANO",38,124,0,162,"2019","003"
"27535","CORIO",146,47,6,199,"2019","094"
"27536","CORNA IMAGNA",26,27,0,53,"2019","082"
"27537","CORNALBA",1,12,0,13,"2019","249"
"27538","CORNAREDO",8,217,11,236,"2019","087"
"27539","CORNATE D'ADDA",18,103,0,121,"2019",NA
"27540","CORNEDO VICENTINO",6,139,0,145,"2019","034"
"27541","CORNEGLIANO LAUDENSE",0,191,0,191,"2019","021"
"27542","CORNELIANO D'ALBA",123,0,0,123,"2019","072"
"27543","CORNIGLIO",49,457,0,506,"2019","012"
"27544","CORNO GIOVINE",208,58,0,266,"2019","022"
"27545","CORNOVECCHIO",117,0,0,117,"2019","023"
"27546","CORNUDA",807,482,0,1289,"2019","023"
"27547","CORREGGIO",1,2002,0,2003,"2019","020"
"27548","CORREZZANA",1,21,0,22,"2019",NA
"27549","CORREZZOLA",5195,22,0,5217,"2019","035"
"27550","CORRIDO",20,23,3,46,"2019","077"
"27551","CORSIONE",14,0,0,14,"2019","044"
"27552","CORTANDONE",1,0,0,1,"2019",NA
"27553","CORTANZE",83,0,0,83,"2019","046"
"27554","CORTE BRUGNATELLA",135,14,0,149,"2019","017"
"27555","CORTE DE' CORTESI CON CIGNONE",0,6,149,155,"2019","032"
"27556","CORTE DE' FRATI",8,629,256,893,"2019","033"
"27557","CORTE FRANCA",110,61,8,179,"2019","062"
"27558","CORTE PALASIO",5,2009,25,2039,"2019","024"
"27559","CORTEMAGGIORE",187,1793,0,1980,"2019","018"
"27560","CORTEMILIA",214,0,0,214,"2019","073"
"27561","CORTENO GOLGI",5,95,23,123,"2019","063"
"27562","CORTENOVA",3,30,3,36,"2019","025"
"27563","CORTENUOVA",182,1334,0,1516,"2019","083"
"27564","CORTEOLONA E GENZONE",209,82,0,291,"2019",NA
"27565","CORTIGLIONE",1,0,0,1,"2019","048"
"27566","CORTINA D'AMPEZZO",7,22,0,29,"2019","016"
"27567","CORVINO SAN QUIRICO",2,0,0,2,"2019","057"
"27568","CORZANO",7,222,0,229,"2019","064"
"27569","COSIO VALTELLINO",20,537,2,559,"2019","024"
"27570","COSSANO BELBO",349,0,0,349,"2019","074"
"27571","COSSANO CANAVESE",2,0,0,2,"2019","095"
"27572","COSSATO",242,154,14,410,"2019","020"
"27573","COSSOGNO",1,0,0,1,"2019","023"
"27574","COSTA DE' NOBILI",53,20,11,84,"2019","058"
"27575","COSTA DI MEZZATE",27,0,0,27,"2019","084"
"27576","COSTA DI ROVIGO",0,275,0,275,"2019","018"
"27577","COSTA MASNAGA",13,0,0,13,"2019","026"
"27578","COSTA SERINA",10,6,0,16,"2019","247"
"27579","COSTA VALLE IMAGNA",4,5,0,9,"2019","085"
"27580","COSTA VESCOVATO",36,0,0,36,"2019","062"
"27581","COSTA VOLPINO",13,41,0,54,"2019","086"
"27582","COSTABISSARA",20,41,0,61,"2019","035"
"27583","COSTERMANO",19,65,0,84,"2019","030"
"27584","COSTIGLIOLE D'ASTI",413,0,0,413,"2019","050"
"27585","COSTIGLIOLE SALUZZO",399,27,24,450,"2019","075"
"27586","COTIGNOLA",79,0,0,79,"2019","009"
"27587","COVO",218,1104,0,1322,"2019","087"
"27588","CRANDOLA VALSASSINA",1,5,3,9,"2019","027"
"27589","CRAVAGLIANA",1,23,0,24,"2019","048"
"27590","CRAVANZANA",1,0,0,1,"2019","076"
"27591","CRAVEGGIA",20,0,0,20,"2019","024"
"27592","CREAZZO",20,26,0,46,"2019","036"
"27593","CREDARO",7,153,0,160,"2019","088"
"27594","CREDERA RUBBIANO",0,910,557,1467,"2019","034"
"27595","CREMA",265,1499,809,2573,"2019","035"
"27596","CREMELLA",7,0,0,7,"2019","028"
"27597","CREMENO",2,31,28,61,"2019","029"
"27598","CREMIA",1,0,6,7,"2019","083"
"27599","CREMOLINO",87,0,0,87,"2019","063"
"27600","CREMONA",75,1338,0,1413,"2019","036"
"27601","CREMOSANO",33,534,0,567,"2019","037"
"27602","CRESCENTINO",107,0,39,146,"2019","049"
"27603","CRESPADORO",24,77,0,101,"2019","037"
"27604","CRESPIATICA",0,279,0,279,"2019","025"
"27605","CRESPINO",2228,0,0,2228,"2019","019"
"27606","CRESSA",49,290,0,339,"2019","055"
"27607","CREVACUORE",3,0,0,3,"2019","021"
"27608","CREVALCORE",164,25,0,189,"2019","024"
"27609","CREVOLADOSSOLA",24,39,68,131,"2019","025"
"27610","CROCETTA DEL MONTELLO",96,48,0,144,"2019","025"
"27611","CRODO",7,95,29,131,"2019","026"
"27612","CROSIO DELLA VALLE",1,0,0,1,"2019","057"
"27613","CROTTA D'ADDA",2,560,0,562,"2019","038"
"27614","CUASSO AL MONTE",16,0,0,16,"2019","058"
"27615","CUCCIAGO",6,0,0,6,"2019","084"
"27616","CUCEGLIO",58,0,0,58,"2019","096"
"27617","CUGGIONO",506,33,0,539,"2019","096"
"27618","CUMIANA",1294,588,52,1934,"2019","097"
"27619","CUMIGNANO SUL NAVIGLIO",0,1285,60,1345,"2019","039"
"27620","CUNARDO",1,0,0,1,"2019","060"
"27621","CUNEO",8710,1036,947,10693,"2019","078"
"27622","CUNICO",1561,0,0,1561,"2019","051"
"27623","CUORGNE'",192,41,0,233,"2019","098"
"27624","CURA CARPIGNANO",21,133,2,156,"2019","060"
"27625","CUREGGIO",22,28,1,51,"2019","058"
"27626","CURIGLIA CON MONTEVIASCO",3,0,2,5,"2019","061"
"27627","CURINO",6,0,0,6,"2019","023"
"27628","CURNO",36,43,0,79,"2019","089"
"27629","CURTAROLO",86,215,0,301,"2019","036"
"27630","CURTATONE",2826,1382,1036,5244,"2019","021"
"27631","CUSAGO",28,598,0,626,"2019","097"
"27632","CUSINO",3,0,1,4,"2019","085"
"27633","CUSIO",4,0,0,4,"2019","090"
"27634","CUVEGLIO",8,2,0,10,"2019","062"
"27635","CUVIO",1,87,5,93,"2019","063"
"27636","DAIRAGO",15,34,0,49,"2019","099"
"27637","DALMINE",97,111,0,208,"2019","091"
"27638","DARFO BOARIO TERME",4,254,36,294,"2019","065"
"27639","DAVERIO",19,0,0,19,"2019","064"
"27640","DAZIO",0,14,0,14,"2019","025"
"27641","DELEBIO",13,140,48,201,"2019","026"
"27642","DELLO",686,1945,35,2666,"2019","066"
"27643","DEMONTE",869,93,0,962,"2019","079"
"27644","DENICE",3,0,0,3,"2019","065"
"27645","DERNICE",9,0,0,9,"2019","066"
"27646","DEROVERE",32,290,1,323,"2019","040"
"27647","DERVIO",2,0,0,2,"2019","030"
"27648","DESANA",34,0,0,34,"2019","054"
"27649","DESENZANO DEL GARDA",59,1519,476,2054,"2019","067"
"27650","DESIO",20,0,0,20,"2019",NA
"27651","DIANO D'ALBA",63,0,0,63,"2019","080"
"27652","DIVIGNANO",47,0,0,47,"2019","060"
"27653","DIZZASCO",0,0,7,7,"2019","087"
"27654","DOGLIANI",1744,0,0,1744,"2019","081"
"27655","DOLO",652,256,0,908,"2019","012"
"27656","DOMASO",0,2,2,4,"2019","089"
"27657","DOMODOSSOLA",16,20,10,46,"2019","028"
"27658","DONATO",117,0,37,154,"2019","024"
"27659","DONGO",3,2,2,7,"2019","090"
"27660","DORMELLETTO",3,0,0,3,"2019","062"
"27661","DORNO",17,29,0,46,"2019","061"
"27662","DORZANO",3,0,0,3,"2019","025"
"27663","DOSOLO",0,332,175,507,"2019","022"
"27664","DOSSENA",33,98,2,133,"2019","092"
"27665","DOSSO DEL LIRO",0,2,16,18,"2019","092"
"27666","DOVADOLA",148,0,0,148,"2019","011"
"27667","DOVERA",30,1216,54,1300,"2019","041"
"27668","DOZZA",0,19,0,19,"2019","025"
"27669","DRONERO",1741,273,51,2065,"2019","082"
"27670","DRUENTO",684,50,0,734,"2019","099"
"27671","DRUOGNO",9,3,1,13,"2019","029"
"27672","DUBINO",24,607,0,631,"2019","027"
"27673","DUE CARRARE",128,0,0,128,"2019","106"
"27674","DUEVILLE",336,617,0,953,"2019","038"
"27675","DUMENZA",2,0,6,8,"2019","065"
"27676","DUSINO SAN MICHELE",348,53,0,401,"2019","052"
"27677","EDOLO",8,62,16,86,"2019","068"
"27678","ELLO",1,0,0,1,"2019","033"
"27679","ELVA",21,0,24,45,"2019","083"
"27680","ENDINE GAIANO",71,93,7,171,"2019","093"
"27681","ENEGO",6,184,1,191,"2019","039"
"27682","ENTRACQUE",157,0,0,157,"2019","084"
"27683","ENTRATICO",32,30,0,62,"2019","094"
"27684","ENVIE",1643,342,353,2338,"2019","085"
"27685","ERACLEA",4445,350,0,4795,"2019","013"
"27686","ERBA",12,391,1,404,"2019","095"
"27687","ERBE'",235,46,0,281,"2019","032"
"27688","ERBEZZO",44,700,5,749,"2019","033"
"27689","ERBUSCO",243,48,0,291,"2019","069"
"27690","ERVE",3,0,0,3,"2019","034"
"27691","ESINE",1,149,5,155,"2019","070"
"27692","ESINO LARIO",28,0,0,28,"2019","035"
"27693","ESTE",1116,52,0,1168,"2019","037"
"27694","EUPILIO",9,1,52,62,"2019","097"
"27695","EXILLES",3,0,0,3,"2019",NA
"27696","FABBRICA CURONE",4,23,0,27,"2019","067"
"27697","FABBRICO",0,196,0,196,"2019","021"
"27698","FAEDO VALTELLINO",4,15,0,19,"2019","028"
"27699","FAENZA",178,87,0,265,"2019","010"
"27700","FAGGETO LARIO",1,0,4,5,"2019","098"
"27701","FAGNANO OLONA",14,6,0,20,"2019","067"
"27702","FALCADE",6,28,0,34,"2019","019"
"27703","FALOPPIO",3,0,2,5,"2019","099"
"27704","FANANO",40,471,0,511,"2019","011"
"27705","FARA GERA D'ADDA",18,574,93,685,"2019","096"
"27706","FARA NOVARESE",1,0,0,1,"2019","065"
"27707","FARA OLIVANA CON SOLA",78,203,0,281,"2019","097"
"27708","FARA VICENTINO",571,372,102,1045,"2019","040"
"27709","FARIGLIANO",545,0,0,545,"2019","086"
"27710","FARINI",86,74,0,160,"2019","019"
"27711","FARRA DI SOLIGO",78,33,0,111,"2019","026"
"27712","FAULE",30,0,155,185,"2019","087"
"27713","FAVRIA",316,695,106,1117,"2019","101"
"27714","FEISOGLIO",75,0,0,75,"2019","088"
"27715","FELETTO",17,0,0,17,"2019","102"
"27716","FELINO",18,1163,0,1181,"2019","013"
"27717","FELIZZANO",16,0,0,16,"2019","068"
"27718","FELTRE",199,1098,0,1297,"2019","021"
"27719","FENEGRO'",37,0,25,62,"2019","100"
"27720","FENESTRELLE",24,0,0,24,"2019","103"
"27721","FERNO",0,4,0,4,"2019","068"
"27722","FERRARA",269,165,0,434,"2019","008"
"27723","FERRARA DI MONTE BALDO",13,26,0,39,"2019","034"
"27724","FERRERA DI VARESE",16,0,0,16,"2019","069"
"27725","FERRERA ERBOGNONE",16,0,0,16,"2019","062"
"27726","FERRERE",885,0,0,885,"2019","053"
"27727","FERRIERE",118,6,0,124,"2019","020"
"27728","FIANO",14,0,0,14,"2019","104"
"27729","FICAROLO",36,0,0,36,"2019","021"
"27730","FIDENZA",174,3658,0,3832,"2019","014"
"27731","FIESCO",10,651,140,801,"2019","043"
"27732","FIESSE",599,405,389,1393,"2019","071"
"27733","FIESSO D'ARTICO",3,32,0,35,"2019","014"
"27734","FIESSO UMBERTIANO",115,0,0,115,"2019","022"
"27735","FIGINO SERENZA",54,83,2,139,"2019","101"
"27736","FILAGO",149,0,0,149,"2019","098"
"27737","FINALE EMILIA",14,57,0,71,"2019","012"
"27738","FINO DEL MONTE",3,37,0,40,"2019","099"
"27739","FINO MORNASCO",12,0,0,12,"2019","102"
"27740","FIORANO AL SERIO",5,12,0,17,"2019","100"
"27741","FIORANO CANAVESE",5,0,0,5,"2019","105"
"27742","FIORANO MODENESE",6,40,0,46,"2019","013"
"27743","FIORENZUOLA D'ARDA",168,2192,0,2360,"2019","021"
"27744","FISCAGLIA",1735,81,0,1816,"2019",NA
"27745","FIUMALBO",93,47,0,140,"2019","014"
"27746","FLERO",455,228,95,778,"2019","072"
"27747","FOBELLO",10,0,4,14,"2019","057"
"27748","FOGLIZZO",169,0,0,169,"2019","106"
"27749","FOLLINA",296,80,0,376,"2019","027"
"27750","FOMBIO",252,203,0,455,"2019","026"
"27751","FONTANELICE",404,81,0,485,"2019","026"
"27752","FONTANELLA",3303,2220,0,5523,"2019","101"
"27753","FONTANELLATO",34,2098,0,2132,"2019","015"
"27754","FONTANELLE",49,526,13,588,"2019","028"
"27755","FONTANETO D'AGOGNA",6,107,0,113,"2019","066"
"27756","FONTANETTO PO",3,0,0,3,"2019","058"
"27757","FONTANILE",2,0,0,2,"2019","054"
"27758","FONTANIVA",288,346,0,634,"2019","038"
"27759","FONTE",696,576,0,1272,"2019","029"
"27760","FONTENO",10,0,0,10,"2019","102"
"27761","FONTEVIVO",0,1650,0,1650,"2019","016"
"27762","FONZASO",43,49,0,92,"2019","022"
"27763","FOPPOLO",0,4,0,4,"2019","103"
"27764","FORCOLA",9,102,0,111,"2019","029"
"27765","FORESTO SPARSO",17,93,7,117,"2019","104"
"27766","FORLI'",456,92,0,548,"2019","012"
"27767","FORLIMPOPOLI",12,6,0,18,"2019","013"
"27768","FORMAZZA",3,19,3,25,"2019","031"
"27769","FORMIGARA",4,1161,128,1293,"2019","044"
"27770","FORMIGINE",2,1813,0,1815,"2019","015"
"27771","FORMIGLIANA",24,0,0,24,"2019","059"
"27772","FORNO CANAVESE",38,0,0,38,"2019","107"
"27773","FORNOVO DI TARO",26,600,0,626,"2019","017"
"27774","FORNOVO SAN GIOVANNI",38,729,0,767,"2019","105"
"27775","FORTUNAGO",43,0,0,43,"2019","064"
"27776","FOSSALTA DI PIAVE",3,0,0,3,"2019","015"
"27777","FOSSALTA DI PORTOGRUARO",0,786,0,786,"2019","016"
"27778","FOSSANO",18483,4497,1198,24178,"2019","089"
"27779","FOSSO'",128,24,0,152,"2019","017"
"27780","FOZA",46,33,13,92,"2019","041"
"27781","FRABOSA SOPRANA",408,0,182,590,"2019","090"
"27782","FRABOSA SOTTANA",62,26,31,119,"2019","091"
"27783","FRACONALTO",30,0,0,30,"2019","069"
"27784","FRASCAROLO",280,59,0,339,"2019","065"
"27785","FRASSINELLE POLESINE",15,0,0,15,"2019","023"
"27786","FRASSINELLO MONFERRATO",48,0,0,48,"2019","072"
"27787","FRASSINETO PO",31,0,0,31,"2019","073"
"27788","FRASSINETTO",110,2,0,112,"2019","108"
"27789","FRASSINO",18,0,0,18,"2019","092"
"27790","FRASSINORO",73,139,0,212,"2019","016"
"27791","FRATTA POLESINE",306,160,0,466,"2019","024"
"27792","FREGONA",13,27,1,41,"2019","030"
"27793","FRESONARA",15,0,0,15,"2019","074"
"27794","FRINCO",290,0,0,290,"2019","055"
"27795","FRONT",60,0,17,77,"2019","109"
"27796","FROSSASCO",2000,0,83,2083,"2019","110"
"27797","FRUGAROLO",143,146,0,289,"2019","075"
"27798","FUBINE",197,0,0,197,"2019","076"
"27799","FUIPIANO VALLE IMAGNA",13,35,0,48,"2019","106"
"27800","FUMANE",17,36,0,53,"2019","035"
"27801","FUSIGNANO",3,0,0,3,"2019","011"
"27802","FUSINE",6,28,0,34,"2019","030"
"27803","GABBIONETA-BINANUOVA",12,699,0,711,"2019","045"
"27804","GABIANO",27,0,0,27,"2019","077"
"27805","GADESCO-PIEVE DELMONA",28,532,98,658,"2019","046"
"27806","GAGGIANO",19,433,9,461,"2019","103"
"27807","GAGGIO MONTANO",310,342,0,652,"2019","027"
"27808","GAGLIANICO",4,0,0,4,"2019","026"
"27809","GAIARINE",720,0,0,720,"2019","031"
"27810","GAIBA",13,0,0,13,"2019","025"
"27811","GAIOLA",21,0,1,22,"2019","093"
"27812","GALBIATE",44,12,0,56,"2019","036"
"27813","GALEATA",224,0,16,240,"2019","014"
"27814","GALGAGNANO",0,716,0,716,"2019","027"
"27815","GALLARATE",2,2,10,14,"2019","070"
"27816","GALLIATE",5,80,0,85,"2019","068"
"27817","GALLIATE LOMBARDO",13,0,0,13,"2019","071"
"27818","GALLIERA",0,36,0,36,"2019","028"
"27819","GALLIERA VENETA",3123,129,0,3252,"2019","039"
"27820","GALLIO",6,230,0,236,"2019","042"
"27821","GALZIGNANO TERME",7,0,0,7,"2019","040"
"27822","GAMALERO",17,0,0,17,"2019","078"
"27823","GAMBARA",4582,2397,390,7369,"2019","073"
"27824","GAMBASCA",2,0,0,2,"2019","094"
"27825","GAMBOLO'",92,93,2,187,"2019","068"
"27826","GAMBUGLIANO",1,42,0,43,"2019","044"
"27827","GANDELLINO",18,0,0,18,"2019","107"
"27828","GANDINO",52,155,0,207,"2019","108"
"27829","GANDOSSO",13,0,0,13,"2019","109"
"27830","GARBAGNA",68,0,0,68,"2019","079"
"27831","GARBAGNA NOVARESE",1,0,0,1,"2019","069"
"27832","GARBAGNATE MILANESE",4,0,0,4,"2019",NA
"27833","GARBAGNATE MONASTERO",7,0,0,7,"2019","037"
"27834","GARDA",2,0,0,2,"2019","036"
"27835","GARDONE RIVIERA",3,0,0,3,"2019","074"
"27836","GARDONE VAL TROMPIA",24,0,0,24,"2019","075"
"27837","GARESSIO",218,0,16,234,"2019","095"
"27838","GARGNANO",17,0,12,29,"2019","076"
"27839","GARLASCO",11,9,0,20,"2019","069"
"27840","GARZENO",11,2,15,28,"2019","106"
"27841","GARZIGLIANA",257,0,0,257,"2019","111"
"27842","GASSINO TORINESE",27,0,0,27,"2019","112"
"27843","GATTATICO",12,2688,0,2700,"2019","022"
"27844","GATTEO",5,0,0,5,"2019","016"
"27845","GATTICO-VERUNO",14,300,46,360,"2019",NA
"27846","GATTINARA",56,0,0,56,"2019","061"
"27847","GAVARDO",74,467,16,557,"2019","077"
"27848","GAVELLO",92,0,0,92,"2019",NA
"27849","GAVERINA TERME",10,50,0,60,"2019","110"
"27850","GAVI",9,0,0,9,"2019","081"
"27851","GAVIRATE",52,0,0,52,"2019","072"
"27852","GAZOLDO DEGLI IPPOLITI",410,105,2,517,"2019","024"
"27853","GAZZADA SCHIANNO",6,0,8,14,"2019","073"
"27854","GAZZANIGA",17,37,0,54,"2019","111"
"27855","GAZZO",28,2702,0,2730,"2019","041"
"27856","GAZZO VERONESE",1094,229,0,1323,"2019","037"
"27857","GAZZOLA",216,1600,0,1816,"2019","022"
"27858","GAZZUOLO",1154,35,6,1195,"2019","025"
"27859","GEMMANO",26,54,0,80,"2019","004"
"27860","GEMONIO",1,0,2,3,"2019","074"
"27861","GENIVOLTA",131,1862,0,1993,"2019","047"
"27862","GENOLA",1986,2142,186,4314,"2019","096"
"27863","GERA LARIO",10,283,7,300,"2019","107"
"27864","GERENZAGO",12,0,0,12,"2019","071"
"27865","GERENZANO",100,95,0,195,"2019","075"
"27866","GERMAGNANO",16,0,2,18,"2019","113"
"27867","GERMAGNO",2,0,0,2,"2019","032"
"27868","GERMIGNAGA",8,71,0,79,"2019","076"
"27869","GERRE DE' CAPRIOLI",0,443,0,443,"2019","048"
"27870","GESSATE",6,461,0,467,"2019","106"
"27871","GHEDI",3799,6841,103,10743,"2019","078"
"27872","GHEMME",19,0,8,27,"2019","073"
"27873","GHIFFA",2,0,4,6,"2019","033"
"27874","GHISALBA",2,852,0,854,"2019","113"
"27875","GHISLARENGO",26,0,0,26,"2019","062"
"27876","GIAGLIONE",16,0,0,16,"2019","114"
"27877","GIANICO",115,126,145,386,"2019","079"
"27878","GIAVENO",170,398,159,727,"2019","115"
"27879","GIAVERA DEL MONTELLO",744,151,0,895,"2019","032"
"27880","GIGNESE",6,0,5,11,"2019","034"
"27881","GIUSSAGO",6,99,3,108,"2019","072"
"27882","GIUSSANO",3,0,0,3,"2019",NA
"27883","GIVOLETTO",23,0,0,23,"2019","116"
"27884","GODEGA DI SANT'URBANO",37,102,0,139,"2019","033"
"27885","GODIASCO",7,0,0,7,"2019","073"
"27886","GOITO",3978,4640,1269,9887,"2019","026"
"27887","GOLASECCA",27,3,0,30,"2019","077"
"27888","GOLFERENZO",0,0,25,25,"2019","074"
"27889","GOMBITO",4,1079,0,1083,"2019","049"
"27890","GONZAGA",17224,3000,4176,24400,"2019","027"
"27891","GORDONA",92,90,45,227,"2019","032"
"27892","GORGO AL MONTICANO",77,259,1,337,"2019","034"
"27893","GORGONZOLA",27,286,0,313,"2019","108"
"27894","GORLA MAGGIORE",3,0,188,191,"2019","078"
"27895","GORLA MINORE",72,0,0,72,"2019","079"
"27896","GORLAGO",71,255,2,328,"2019","114"
"27897","GORLE",2,0,0,2,"2019","115"
"27898","GORNATE-OLONA",12,0,1,13,"2019","080"
"27899","GORNO",23,51,0,74,"2019","116"
"27900","GORZEGNO",32,0,0,32,"2019","097"
"27901","GOSALDO",3,0,0,3,"2019",NA
"27902","GOSSOLENGO",13,630,0,643,"2019","023"
"27903","GOTTASECCA",38,0,0,38,"2019","098"
"27904","GOTTOLENGO",14086,1205,148,15439,"2019","080"
"27905","GOVONE",333,0,0,333,"2019","099"
"27906","GOZZANO",1,0,0,1,"2019","076"
"27907","GRAFFIGNANA",57,236,46,339,"2019","028"
"27908","GRAGLIA",62,18,63,143,"2019","028"
"27909","GRAGNANO TREBBIENSE",7,3100,0,3107,"2019","024"
"27910","GRANA",49,0,0,49,"2019","056"
"27911","GRANAROLO DELL'EMILIA",347,293,0,640,"2019","030"
"27912","GRANDOLA ED UNITI",3,13,33,49,"2019","111"
"27913","GRANOZZO CON MONTICELLO",0,50,0,50,"2019","077"
"27914","GRANTOLA",59,0,0,59,"2019","081"
"27915","GRANTORTO",69,845,2,916,"2019","042"
"27916","GRANZE",778,0,0,778,"2019","043"
"27917","GRASSOBBIO",6,113,0,119,"2019","117"
"27918","GRAVEDONA ED UNITI",8,16,40,64,"2019","249"
"27919","GRAVELLONA LOMELLINA",11,68,0,79,"2019","075"
"27920","GRAVELLONA TOCE",17,0,0,17,"2019","035"
"27921","GRAZZANO BADOGLIO",405,0,0,405,"2019","057"
"27922","GREMIASCO",37,0,0,37,"2019","083"
"27923","GREZZAGO",2,0,0,2,"2019","110"
"27924","GREZZANA",123,524,0,647,"2019","038"
"27925","GRIANTE",4,0,6,10,"2019","113"
"27926","GRIGNASCO",13,12,0,25,"2019","079"
"27927","GRINZANE CAVOUR",12,0,0,12,"2019","100"
"27928","GRISIGNANO DI ZOCCO",28,439,7,474,"2019","046"
"27929","GRIZZANA MORANDI",107,0,0,107,"2019","031"
"27930","GROMO",48,97,0,145,"2019","118"
"27931","GRONDONA",21,0,0,21,"2019","085"
"27932","GRONE",22,25,0,47,"2019","119"
"27933","GRONTARDO",144,1990,90,2224,"2019","050"
"27934","GROPELLO CAIROLI",22,0,0,22,"2019","076"
"27935","GROPPARELLO",93,23,0,116,"2019","025"
"27936","GROSCAVALLO",10,0,0,10,"2019","118"
"27937","GROSIO",21,212,5,238,"2019","033"
"27938","GROSOTTO",9,28,34,71,"2019","034"
"27939","GROSSO",55,0,0,55,"2019","119"
"27940","GRUARO",9,196,0,205,"2019","018"
"27941","GRUGLIASCO",82,8,37,127,"2019","120"
"27942","GRUMELLO CREMONESE ED UNITI",16,1459,323,1798,"2019","051"
"27943","GRUMELLO DEL MONTE",47,111,0,158,"2019","120"
"27944","GRUMOLO DELLE ABBADESSE",43,177,0,220,"2019","047"
"27945","GUALTIERI",1278,490,0,1768,"2019","023"
"27946","GUANZATE",8,3,23,34,"2019","114"
"27947","GUARDA VENETA",632,0,0,632,"2019","028"
"27948","GUARDABOSONE",64,13,0,77,"2019","066"
"27949","GUARDAMIGLIO",10,75,403,488,"2019","029"
"27950","GUARENE",263,0,0,263,"2019","101"
"27951","GUASTALLA",49,1058,0,1107,"2019","024"
"27952","GUDO VISCONTI",15,0,0,15,"2019","112"
"27953","GUIDIZZOLO",1351,870,279,2500,"2019","028"
"27954","GUIGLIA",6,514,0,520,"2019","017"
"27955","GUSSAGO",57,986,105,1148,"2019","081"
"27956","GUSSOLA",1,68,7,76,"2019","052"
"27957","IDRO",0,0,4,4,"2019","082"
"27958","IGLIANO",50,0,24,74,"2019","102"
"27959","ILLASI",0,50,0,50,"2019","039"
"27960","IMBERSAGO",3,0,0,3,"2019","039"
"27961","IMOLA",129,0,0,129,"2019","032"
"27962","INARZO",8,0,0,8,"2019","082"
"27963","INCISA SCAPACCINO",36,0,0,36,"2019","058"
"27964","INCUDINE",1,0,0,1,"2019","083"
"27965","INDUNO OLONA",17,91,0,108,"2019","083"
"27966","INTROBIO",86,12,0,98,"2019","040"
"27967","INVERIGO",100,0,40,140,"2019","118"
"27968","INVERNO E MONTELEONE",65,166,22,253,"2019","077"
"27969","INVERSO PINASCA",36,0,0,36,"2019","122"
"27970","INVERUNO",6,57,0,63,"2019","113"
"27971","INVORIO",24,71,0,95,"2019","082"
"27972","INZAGO",303,711,0,1014,"2019","114"
"27973","IRMA",9,0,0,9,"2019","084"
"27974","ISASCA",9,0,0,9,"2019","103"
"27975","ISEO",32,29,0,61,"2019","085"
"27976","ISOLA D'ASTI",433,0,0,433,"2019","059"
"27977","ISOLA DELLA SCALA",7572,383,0,7955,"2019","040"
"27978","ISOLA DI FONDRA",1,23,0,24,"2019","121"
"27979","ISOLA DOVARESE",0,572,116,688,"2019","053"
"27980","ISOLA RIZZA",2126,380,0,2506,"2019","041"
"27981","ISOLA VICENTINA",1976,717,31,2724,"2019","048"
"27982","ISOLABELLA",25,0,517,542,"2019","123"
"27983","ISORELLA",11805,392,0,12197,"2019","086"
"27984","ISPRA",46,180,0,226,"2019","084"
"27985","ISSIGLIO",80,18,14,112,"2019","124"
"27986","ISSO",7,1143,0,1150,"2019","122"
"27987","ISTRANA",3429,370,45,3844,"2019","035"
"27988","IVREA",237,254,0,491,"2019","125"
"27989","IZANO",6,1020,0,1026,"2019","054"
"27990","JERAGO CON ORAGO",1,0,0,1,"2019","085"
"27991","JESOLO",4,71,0,75,"2019",NA
"27992","JOLANDA DI SAVOIA",4010,0,0,4010,"2019","010"
"27993","LA CASSA",1,316,0,317,"2019","126"
"27994","LA LOGGIA",135,0,116,251,"2019","127"
"27995","LA MORRA",53,0,0,53,"2019","105"
"27996","LA VALLE AGORDINA",4,25,4,33,"2019","027"
"27997","LA VALLETTA BRIANZA",10,10,6,26,"2019",NA
"27998","LACCHIARELLA",182,22,0,204,"2019","115"
"27999","LAGNASCO",24,0,37,61,"2019","104"
"28000","LAGOSANTO",48,0,0,48,"2019","011"
"28001","LAINATE",13,0,0,13,"2019","116"
"28002","LAINO",4,2,0,6,"2019","120"
"28003","LAMA MOCOGNO",66,371,0,437,"2019","018"
"28004","LAMBRUGO",0,132,0,132,"2019","121"
"28005","LAMON",5,32,0,37,"2019","026"
"28006","LAMPORO",33,0,0,33,"2019","067"
"28007","LANDRIANO",13,230,0,243,"2019","078"
"28008","LANGHIRANO",0,861,0,861,"2019","018"
"28009","LANGOSCO",8,0,0,8,"2019","079"
"28010","LANZADA",22,80,0,102,"2019","036"
"28011","LANZO TORINESE",151,0,11,162,"2019","128"
"28012","LARDIRAGO",0,0,2,2,"2019",NA
"28013","LASNIGO",0,27,0,27,"2019","123"
"28014","LAURIANO",18,0,0,18,"2019","129"
"28015","LAVAGNO",1,0,0,1,"2019",NA
"28016","LAVENA PONTE TRESA",7,0,0,7,"2019","086"
"28017","LAVENO-MOMBELLO",1,0,0,1,"2019","087"
"28018","LAVENONE",27,0,1,28,"2019","087"
"28019","LAZISE",22,60,0,82,"2019","043"
"28020","LAZZATE",27,0,0,27,"2019",NA
"28021","LECCO",12,31,1,44,"2019","042"
"28022","LEFFE",10,91,0,101,"2019","124"
"28023","LEGGIUNO",2,0,0,2,"2019","088"
"28024","LEGNAGO",42,34,50,126,"2019","044"
"28025","LEGNANO",0,103,0,103,"2019","118"
"28026","LEGNARO",114,17,24,155,"2019","044"
"28027","LEINI'",712,575,96,1383,"2019","130"
"28028","LEMIE",9,0,0,9,"2019","131"
"28029","LENDINARA",645,125,0,770,"2019","029"
"28030","LENNA",2,8,0,10,"2019","125"
"28031","LENO",5891,7026,1060,13977,"2019","088"
"28032","LENTA",1,18,0,19,"2019","068"
"28033","LENTATE SUL SEVESO",1,190,16,207,"2019",NA
"28034","LEQUIO BERRIA",21,0,0,21,"2019","106"
"28035","LEQUIO TANARO",2116,0,0,2116,"2019","107"
"28036","LERMA",9,0,0,9,"2019","088"
"28037","LESA",5,0,0,5,"2019","084"
"28038","LESEGNO",836,0,0,836,"2019","108"
"28039","LESIGNANO DE' BAGNI",36,1441,0,1477,"2019","019"
"28040","LESMO",0,176,0,176,"2019",NA
"28041","LESSOLO",189,7,0,196,"2019","132"
"28042","LESSONA",6,8,0,14,"2019","029"
"28043","LEVICE",67,0,0,67,"2019","109"
"28044","LEZZENO",0,0,2,2,"2019","126"
"28045","LIERNA",7,3,0,10,"2019","043"
"28046","LIMANA",73,103,0,176,"2019","029"
"28047","LIMENA",803,649,50,1502,"2019","045"
"28048","LIMIDO COMASCO",4,32,0,36,"2019","128"
"28049","LIMONE PIEMONTE",52,0,0,52,"2019","110"
"28050","LINAROLO",14,340,0,354,"2019","081"
"28051","LIRIO",35,0,0,35,"2019","082"
"28052","LISCATE",12,0,0,12,"2019","122"
"28053","LISIO",53,0,0,53,"2019","111"
"28054","LISSONE",315,0,0,315,"2019",NA
"28055","LIVIGNO",56,300,4,360,"2019","037"
"28056","LIVINALLONGO DEL COL DI LANA",4,67,0,71,"2019","030"
"28057","LIVO",6,10,0,16,"2019","130"
"28058","LIVORNO FERRARIS",1,58,0,59,"2019","071"
"28059","LIVRAGA",37,1068,2,1107,"2019","030"
"28060","LIZZANO IN BELVEDERE",21,107,36,164,"2019","033"
"28061","LOAZZOLO",26,0,2,28,"2019","060"
"28062","LOCANA",113,47,0,160,"2019","134"
"28063","LOCATE DI TRIULZI",27,1016,0,1043,"2019","125"
"28064","LOCATE VARESINO",12,0,0,12,"2019","131"
"28065","LOCATELLO",30,17,0,47,"2019","127"
"28066","LODI",569,1081,67,1717,"2019","031"
"28067","LODI VECCHIO",1,1289,0,1290,"2019","032"
"28068","LODRINO",14,7,0,21,"2019","090"
"28069","LOGRATO",821,810,0,1631,"2019","091"
"28070","LOIANO",68,244,0,312,"2019","034"
"28071","LOMBARDORE",16,10,0,26,"2019","135"
"28072","LOMBRIASCO",91,133,0,224,"2019","136"
"28073","LOMELLO",1,154,0,155,"2019","083"
"28074","LONATE CEPPINO",0,274,0,274,"2019","089"
"28075","LONATE POZZOLO",9,0,9,18,"2019","090"
"28076","LONATO DEL GARDA",2489,4854,893,8236,"2019",NA
"28077","LONGARE",85,174,0,259,"2019","051"
"28078","LONGARONE",2,0,0,2,"2019","031"
"28079","LONGHENA",0,395,0,395,"2019","093"
"28080","LONGIANO",15,0,0,15,"2019","018"
"28081","LONIGO",5161,520,0,5681,"2019","052"
"28082","LORANZE'",32,0,0,32,"2019","137"
"28083","LOREGGIA",234,423,4,661,"2019","046"
"28084","LOREGLIA",5,0,0,5,"2019","038"
"28085","LORENZAGO DI CADORE",0,3,0,3,"2019","032"
"28086","LOREO",984,63,0,1047,"2019","030"
"28087","LORIA",6177,30,2,6209,"2019","036"
"28088","LOSINE",0,7,0,7,"2019","094"
"28089","LOVERE",6,35,0,41,"2019","128"
"28090","LOVERO",4,9,0,13,"2019","038"
"28091","LOZIO",0,4,0,4,"2019","095"
"28092","LOZZA",0,128,0,128,"2019","091"
"28093","LOZZO ATESTINO",1465,4,0,1469,"2019","047"
"28094","LU E CUCCARO MONFERRATO",79,0,0,79,"2019",NA
"28095","LUGAGNANO VAL D'ARDA",45,198,0,243,"2019","026"
"28096","LUGO",34,68,0,102,"2019","012"
"28097","LUGO DI VICENZA",19,128,0,147,"2019","053"
"28098","LUINO",4,14,0,18,"2019","092"
"28099","LUISAGO",9,0,0,9,"2019","135"
"28100","LUMEZZANE",16,0,0,16,"2019","096"
"28101","LURAGO D'ERBA",8,0,10,18,"2019","136"
"28102","LURAGO MARINONE",0,144,0,144,"2019","137"
"28103","LURANO",44,0,0,44,"2019","129"
"28104","LURATE CACCIVIO",35,0,94,129,"2019","138"
"28105","LUSERNA SAN GIOVANNI",437,55,59,551,"2019","139"
"28106","LUSERNETTA",95,0,0,95,"2019","140"
"28107","LUSIA",22,0,0,22,"2019","031"
"28108","LUSIANA CONCO",30,245,20,295,"2019",NA
"28109","LUSIGLIE'",124,0,0,124,"2019","141"
"28110","LUZZANA",21,0,0,21,"2019","130"
"28111","LUZZARA",1750,1300,0,3050,"2019","026"
"28112","MACCAGNO CON PINO E VEDDASCA",1,12,0,13,"2019",NA
"28113","MACCASTORNA",535,75,0,610,"2019","033"
"28114","MACELLO",1332,183,279,1794,"2019","142"
"28115","MACLODIO",26,305,0,331,"2019","097"
"28116","MACRA",4,0,0,4,"2019",NA
"28117","MACUGNAGA",0,11,0,11,"2019","039"
"28118","MADESIMO",0,9,0,9,"2019","035"
"28119","MADIGNANO",68,704,0,772,"2019","055"
"28120","MADONE",14,0,0,14,"2019","131"
"28121","MADONNA DEL SASSO",23,0,0,23,"2019","040"
"28122","MAGASA",9,16,0,25,"2019","098"
"28123","MAGENTA",18,771,24,813,"2019","130"
"28124","MAGGIORA",99,64,0,163,"2019","088"
"28125","MAGHERNO",0,103,0,103,"2019","085"
"28126","MAGLIANO ALFIERI",374,0,0,374,"2019","113"
"28127","MAGLIANO ALPI",545,95,0,640,"2019","114"
"28128","MAGNACAVALLO",65,231,503,799,"2019","029"
"28129","MAGNAGO",58,0,0,58,"2019","131"
"28130","MAGNANO",22,12,0,34,"2019","030"
"28131","MAIOLO",115,0,0,115,"2019","022"
"28132","MAIRAGO",0,343,0,343,"2019","034"
"28133","MAIRANO",323,606,0,929,"2019","099"
"28134","MALAGNINO",239,657,0,896,"2019","056"
"28135","MALCESINE",10,85,0,95,"2019","045"
"28136","MALEGNO",9,31,4,44,"2019","100"
"28137","MALEO",227,1181,0,1408,"2019","035"
"28138","MALESCO",14,0,6,20,"2019","041"
"28139","MALGESSO",90,0,0,90,"2019","095"
"28140","MALNATE",37,46,0,83,"2019","096"
"28141","MALO",2274,288,0,2562,"2019","055"
"28142","MALONNO",13,214,26,253,"2019","101"
"28143","MALVICINO",8,4,0,12,"2019","090"
"28144","MANDELLO DEL LARIO",13,0,2,15,"2019","046"
"28145","MANDELLO VITTA",1,0,0,1,"2019","090"
"28146","MANERBA DEL GARDA",15,0,17,32,"2019","102"
"28147","MANERBIO",427,1469,0,1896,"2019","103"
"28148","MANGO",19,0,0,19,"2019","115"
"28149","MANSUE'",39,253,13,305,"2019","037"
"28150","MANTELLO",3,100,0,103,"2019","039"
"28151","MANTOVA",650,780,91,1521,"2019","030"
"28152","MAPELLO",5,0,28,33,"2019","132"
"28153","MARANELLO",16,557,0,573,"2019","019"
"28154","MARANO DI VALPOLICELLA",9,50,14,73,"2019","046"
"28155","MARANO SUL PANARO",49,632,0,681,"2019","020"
"28156","MARANO TICINO",0,251,0,251,"2019","091"
"28157","MARANO VICENTINO",219,316,35,570,"2019","056"
"28158","MARCALLO CON CASONE",1,298,0,299,"2019","134"
"28159","MARCARIA",3345,3140,859,7344,"2019","031"
"28160","MARCHENO",6,10,6,22,"2019","104"
"28161","MARCHIROLO",1,0,0,1,"2019","097"
"28162","MARCON",365,99,0,464,"2019","020"
"28163","MARENE",3316,2323,84,5723,"2019","117"
"28164","MARENO DI PIAVE",1322,129,7,1458,"2019","038"
"28165","MARENTINO",109,0,0,109,"2019","144"
"28166","MARETTO",124,0,0,124,"2019","062"
"28167","MARGARITA",877,0,0,877,"2019","118"
"28168","MARGNO",3,7,0,10,"2019","047"
"28169","MARIANA MANTOVANA",64,359,46,469,"2019","032"
"28170","MARIANO COMENSE",675,55,2,732,"2019","143"
"28171","MARMENTINO",16,9,10,35,"2019","105"
"28172","MARMIROLO",3587,2222,3216,9025,"2019","033"
"28173","MARMORA",20,0,97,117,"2019","119"
"28174","MARNATE",1,0,0,1,"2019",NA
"28175","MARONE",26,0,36,62,"2019","106"
"28176","MAROSTICA",136,633,0,769,"2019","057"
"28177","MARSAGLIA",138,0,16,154,"2019","120"
"28178","MARTELLAGO",34,22,0,56,"2019","021"
"28179","MARTINENGO",311,2573,0,2884,"2019","133"
"28180","MARTINIANA PO",84,53,41,178,"2019","121"
"28181","MARUDO",0,317,0,317,"2019","036"
"28182","MARZABOTTO",12,100,0,112,"2019","036"
"28183","MARZANO",153,350,3,506,"2019","087"
"28184","MARZIO",2,0,1,3,"2019","099"
"28185","MASATE",0,0,152,152,"2019","136"
"28186","MASCIAGO PRIMO",41,0,0,41,"2019","100"
"28187","MASER",4330,11,0,4341,"2019","039"
"28188","MASERA",11,31,2,44,"2019","042"
"28189","MASERA' DI PADOVA",225,179,44,448,"2019","048"
"28190","MASERADA SUL PIAVE",2109,95,6,2210,"2019","040"
"28191","MASI",81,0,0,81,"2019","049"
"28192","MASI TORELLO",7,55,0,62,"2019","012"
"28193","MASIO",393,0,0,393,"2019","091"
"28194","MASSA LOMBARDA",5,0,0,5,"2019","013"
"28195","MASSALENGO",0,111,0,111,"2019","037"
"28196","MASSANZAGO",361,153,0,514,"2019","050"
"28197","MASSAZZA",40,0,0,40,"2019","031"
"28198","MASSELLO",7,0,0,7,"2019","145"
"28199","MASSERANO",43,0,0,43,"2019","032"
"28200","MASSINO VISCONTI",6,1,43,50,"2019","093"
"28201","MASSIOLA",4,0,0,4,"2019","043"
"28202","MATHI",131,0,96,227,"2019","146"
"28203","MATTIE",18,0,0,18,"2019","147"
"28204","MAZZANO",58,465,228,751,"2019","107"
"28205","MAZZE'",949,0,0,949,"2019","148"
"28206","MAZZO DI VALTELLINA",12,21,5,38,"2019","040"
"28207","MEDE",22,61,0,83,"2019","088"
"28208","MEDESANO",83,1494,0,1577,"2019","020"
"28209","MEDICINA",37,119,1,157,"2019","037"
"28210","MEDIGLIA",4,1363,0,1367,"2019","139"
"28211","MEDOLAGO",9,0,0,9,"2019","250"
"28212","MEDOLE",502,624,632,1758,"2019","034"
"28213","MEDOLLA",0,504,0,504,"2019","021"
"28214","MEDUNA DI LIVENZA",15,17,0,32,"2019","041"
"28215","MEGLIADINO SAN VITALE",2554,0,0,2554,"2019","052"
"28216","MEINA",1,0,0,1,"2019","095"
"28217","MELAZZO",171,0,0,171,"2019","092"
"28218","MELDOLA",157,0,0,157,"2019","019"
"28219","MELEGNANO",0,223,0,223,"2019","140"
"28220","MELETI",22,323,3,348,"2019","038"
"28221","MELLE",252,0,38,290,"2019","122"
"28222","MELLO",28,39,2,69,"2019","041"
"28223","MELZO",170,212,0,382,"2019","142"
"28224","MENCONICO",13,0,0,13,"2019","089"
"28225","MEOLO",428,175,0,603,"2019","022"
"28226","MERANA",34,0,0,34,"2019","093"
"28227","MERATE",14,199,80,293,"2019","048"
"28228","MERCALLO",3,0,0,3,"2019",NA
"28229","MERCATO SARACENO",187,24,0,211,"2019","020"
"28230","MERCENASCO",327,0,0,327,"2019","150"
"28231","MERGOZZO",30,0,0,30,"2019","044"
"28232","MERLARA",685,5,0,690,"2019","053"
"28233","MERLINO",0,1097,63,1160,"2019","039"
"28234","MERONE",41,61,0,102,"2019","147"
"28235","MESE",8,37,20,65,"2019","043"
"28236","MESENZANA",2,35,0,37,"2019","102"
"28237","MESERO",0,65,0,65,"2019","144"
"28238","MESOLA",1142,226,0,1368,"2019","014"
"28239","MESTRINO",156,96,0,252,"2019","054"
"28240","MEZZANA BIGLI",88,0,0,88,"2019","090"
"28241","MEZZANE DI SOTTO",1,18,0,19,"2019","047"
"28242","MEZZENILE",18,0,0,18,"2019","152"
"28243","MEZZOLDO",1,30,0,31,"2019","134"
"28244","MEZZOMERICO",4,0,0,4,"2019","097"
"28245","MIAGLIANO",1,0,0,1,"2019","034"
"28246","MIANE",4,8,0,12,"2019","042"
"28247","MIASINO",0,0,40,40,"2019","098"
"28248","MILANO",431,83,0,514,"2019","146"
"28249","MILZANO",1,1062,0,1063,"2019","108"
"28250","MINERBE",2306,253,0,2559,"2019","048"
"28251","MINERBIO",104,0,0,104,"2019","038"
"28252","MIRA",2073,283,22,2378,"2019","023"
"28253","MIRABELLO MONFERRATO",72,0,0,72,"2019","094"
"28254","MIRADOLO TERME",23,4,50,77,"2019","093"
"28255","MIRANDOLA",443,1421,0,1864,"2019","022"
"28256","MIRANO",1102,664,1,1767,"2019","024"
"28257","MISANO ADRIATICO",12,0,0,12,"2019","005"
"28258","MISANO DI GERA D'ADDA",6,221,7,234,"2019","135"
"28259","MISSAGLIA",18,250,214,482,"2019","049"
"28260","MODENA",78,2090,0,2168,"2019","023"
"28261","MODIGLIANA",82,0,0,82,"2019","022"
"28262","MOGLIA",6287,854,1278,8419,"2019","035"
"28263","MOGLIANO VENETO",1317,370,174,1861,"2019","043"
"28264","MOIO DE' CALVI",3,12,0,15,"2019","136"
"28265","MOIOLA",12,0,24,36,"2019","123"
"28266","MOLARE",2,0,0,2,"2019","095"
"28267","MOLINELLA",2096,195,0,2291,"2019","039"
"28268","MOLLIA",6,0,0,6,"2019","078"
"28269","MOLTENO",12,41,0,53,"2019","051"
"28270","MOMBALDONE",38,0,1,39,"2019","064"
"28271","MOMBARCARO",120,0,0,120,"2019","124"
"28272","MOMBARUZZO",2,0,0,2,"2019","065"
"28273","MOMBASIGLIO",105,0,0,105,"2019","125"
"28274","MOMBELLO DI TORINO",42,0,0,42,"2019","153"
"28275","MOMBELLO MONFERRATO",10,0,0,10,"2019","097"
"28276","MOMBERCELLI",27,0,0,27,"2019","066"
"28277","MOMO",171,514,0,685,"2019","100"
"28278","MONALE",29,0,0,29,"2019","067"
"28279","MONASTERO BORMIDA",388,0,0,388,"2019","068"
"28280","MONASTERO DI LANZO",5,0,0,5,"2019","155"
"28281","MONASTERO DI VASCO",455,0,62,517,"2019","126"
"28282","MONASTEROLO CASOTTO",34,0,0,34,"2019","127"
"28283","MONASTEROLO DEL CASTELLO",18,12,0,30,"2019","137"
"28284","MONASTEROLO DI SAVIGLIANO",610,286,147,1043,"2019","128"
"28285","MONASTIER DI TREVISO",2625,52,61,2738,"2019","044"
"28286","MONCALIERI",150,426,0,576,"2019","156"
"28287","MONCALVO",114,0,0,114,"2019","069"
"28288","MONCENISIO",4,0,0,4,"2019","157"
"28289","MONCESTINO",4,0,0,4,"2019","099"
"28290","MONCHIERO",227,0,0,227,"2019","129"
"28291","MONCHIO DELLE CORTI",28,167,0,195,"2019","022"
"28292","MONCRIVELLO",80,232,0,312,"2019","079"
"28293","MONCUCCO TORINESE",38,0,0,38,"2019","070"
"28294","MONDAINO",1,0,0,1,"2019","006"
"28295","MONDOVI'",5553,13,336,5902,"2019","130"
"28296","MONESIGLIO",75,0,0,75,"2019","131"
"28297","MONFORTE D'ALBA",275,0,0,275,"2019","132"
"28298","MONFUMO",35,194,0,229,"2019","045"
"28299","MONGARDINO",21,0,0,21,"2019","071"
"28300","MONGHIDORO",37,75,0,112,"2019","040"
"28301","MONGIARDINO LIGURE",22,0,18,40,"2019","100"
"28302","MONGRANDO",96,94,9,199,"2019","035"
"28303","MONGUZZO",13,0,0,13,"2019","153"
"28304","MONNO",3,41,6,50,"2019","110"
"28305","MONSELICE",403,70,0,473,"2019","055"
"28306","MONTA'",183,0,0,183,"2019","133"
"28307","MONTABONE",67,0,0,67,"2019","072"
"28308","MONTACUTO",6,0,0,6,"2019","102"
"28309","MONTAFIA",26,0,0,26,"2019","073"
"28310","MONTAGNA IN VALTELLINA",13,68,0,81,"2019","044"
"28311","MONTAGNANA",1412,4,20,1436,"2019","056"
"28312","MONTALDO DI MONDOVI'",123,0,15,138,"2019","134"
"28313","MONTALDO SCARAMPI",23,0,0,23,"2019","074"
"28314","MONTALDO TORINESE",585,0,0,585,"2019","158"
"28315","MONTALENGHE",3,0,0,3,"2019","159"
"28316","MONTALTO DORA",39,0,0,39,"2019","160"
"28317","MONTALTO PAVESE",59,0,0,59,"2019","094"
"28318","MONTANARO",191,121,0,312,"2019","161"
"28319","MONTANASO LOMBARDO",89,442,0,531,"2019","040"
"28320","MONTANERA",1712,1108,115,2935,"2019","136"
"28321","MONTANO LUCINO",2,0,30,32,"2019","154"
"28322","MONTE CREMASCO",352,84,31,467,"2019","058"
"28323","MONTE DI MALO",639,136,0,775,"2019","063"
"28324","MONTE ISOLA",17,0,0,17,"2019","111"
"28325","MONTE MARENZO",10,0,0,10,"2019","052"
"28326","MONTE SAN PIETRO",133,192,0,325,"2019","042"
"28327","MONTEBELLO DELLA BATTAGLIA",0,28,0,28,"2019","095"
"28328","MONTEBELLO VICENTINO",85,0,247,332,"2019","060"
"28329","MONTEBELLUNA",3450,525,29,4004,"2019","046"
"28330","MONTECALVO VERSIGGIA",4,0,0,4,"2019",NA
"28331","MONTECASTELLO",62,0,0,62,"2019","105"
"28332","MONTECCHIA DI CROSARA",108,5,0,113,"2019","049"
"28333","MONTECCHIO EMILIA",4,1667,0,1671,"2019","027"
"28334","MONTECCHIO MAGGIORE",217,42,0,259,"2019","061"
"28335","MONTECCHIO PRECALCINO",152,165,83,400,"2019","062"
"28336","MONTECHIARO D'ACQUI",75,0,0,75,"2019","106"
"28337","MONTECHIARO D'ASTI",365,0,0,365,"2019","075"
"28338","MONTECHIARUGOLO",28,3157,0,3185,"2019","023"
"28339","MONTECRESTESE",38,22,10,70,"2019","046"
"28340","MONTECRETO",9,435,0,444,"2019","024"
"28341","MONTEFIORE CONCA",25,4,0,29,"2019","008"
"28342","MONTEFIORINO",88,367,0,455,"2019","025"
"28343","MONTEFORTE D'ALPONE",790,5,0,795,"2019","050"
"28344","MONTEGALDA",32,266,0,298,"2019","064"
"28345","MONTEGALDELLA",36,320,0,356,"2019","065"
"28346","MONTEGIOCO",28,0,0,28,"2019","107"
"28347","MONTEGRIDOLFO",3,0,0,3,"2019","009"
"28348","MONTEGRINO VALTRAVAGLIA",14,0,0,14,"2019","103"
"28349","MONTEGROSSO D'ASTI",27,0,0,27,"2019","076"
"28350","MONTEGROTTO TERME",3,37,6,46,"2019","057"
"28351","MONTELUPO ALBESE",96,0,0,96,"2019","137"
"28352","MONTEMAGNO",85,0,0,85,"2019","077"
"28353","MONTEMALE DI CUNEO",118,0,0,118,"2019","138"
"28354","MONTEMEZZO",0,0,1,1,"2019","155"
"28355","MONTERENZIO",575,176,0,751,"2019","041"
"28356","MONTEROSSO GRANA",5,197,0,202,"2019","139"
"28357","MONTESCANO",1,0,0,1,"2019","097"
"28358","MONTESCUDO-MONTE COLOMBO",178,0,0,178,"2019",NA
"28359","MONTESE",77,1298,0,1375,"2019","026"
"28360","MONTESEGALE",5,0,0,5,"2019","098"
"28361","MONTEU DA PO",124,0,0,124,"2019","162"
"28362","MONTEU ROERO",461,0,0,461,"2019","140"
"28363","MONTEVECCHIA",1,0,1,2,"2019","053"
"28364","MONTEVIALE",55,0,1,56,"2019","066"
"28365","MONTEZEMOLO",55,0,0,55,"2019","141"
"28366","MONTICELLI BRUSATI",7,197,0,204,"2019","112"
"28367","MONTICELLI D'ONGINA",287,853,0,1140,"2019","027"
"28368","MONTICELLI PAVESE",1409,408,0,1817,"2019","099"
"28369","MONTICELLO BRIANZA",14,0,284,298,"2019","054"
"28370","MONTICELLO CONTE OTTO",173,835,0,1008,"2019","067"
"28371","MONTICELLO D'ALBA",73,0,0,73,"2019","142"
"28372","MONTICHIARI",8653,7456,56,16165,"2019","113"
"28373","MONTIGLIO MONFERRATO",201,0,0,201,"2019","121"
"28374","MONTIRONE",3952,426,0,4378,"2019","114"
"28375","MONTODINE",58,1127,0,1185,"2019","059"
"28376","MONTORSO VICENTINO",708,102,0,810,"2019","068"
"28377","MONTU' BECCARIA",2,0,0,2,"2019","100"
"28378","MONVALLE",7,0,1,8,"2019","104"
"28379","MONZA",36,61,0,97,"2019",NA
"28380","MONZAMBANO",1317,612,699,2628,"2019","036"
"28381","MONZUNO",83,50,0,133,"2019","044"
"28382","MORANO SUL PO",1,0,0,1,"2019","109"
"28383","MORANSENGO",149,0,0,149,"2019","079"
"28384","MORAZZONE",6,101,27,134,"2019","105"
"28385","MORBEGNO",13,83,2,98,"2019","045"
"28386","MORDANO",1,0,0,1,"2019","045"
"28387","MORENGO",67,72,0,139,"2019","140"
"28388","MORETTA",1490,430,223,2143,"2019","143"
"28389","MORFASSO",110,9,0,119,"2019","028"
"28390","MORGANO",1890,3,0,1893,"2019","047"
"28391","MORIAGO DELLA BATTAGLIA",2171,61,0,2232,"2019","048"
"28392","MORIMONDO",41,1543,0,1584,"2019","150"
"28393","MORIONDO TORINESE",357,0,0,357,"2019","163"
"28394","MORNAGO",22,0,0,22,"2019","106"
"28395","MORNESE",30,0,0,30,"2019","111"
"28396","MORNICO AL SERIO",426,595,5,1026,"2019","141"
"28397","MORNICO LOSANA",22,0,0,22,"2019","101"
"28398","MOROZZO",2440,577,392,3409,"2019","144"
"28399","MORSASCO",120,0,0,120,"2019","112"
"28400","MORTARA",45,0,0,45,"2019","102"
"28401","MORTERONE",14,0,24,38,"2019","055"
"28402","MOSCAZZANO",1,1338,174,1513,"2019","060"
"28403","MOTTA BALUFFI",1,75,0,76,"2019","061"
"28404","MOTTA DI LIVENZA",22,25,0,47,"2019","049"
"28405","MOTTA VISCONTI",3,0,0,3,"2019","151"
"28406","MOTTALCIATA",60,84,0,144,"2019","037"
"28407","MOTTEGGIANA",690,923,985,2598,"2019","037"
"28408","MOZZANICA",200,637,0,837,"2019","142"
"28409","MOZZATE",6,101,0,107,"2019","159"
"28410","MOZZECANE",3349,1090,0,4439,"2019","051"
"28411","MUGGIÒ",3,0,0,3,"2019",NA
"28412","MULAZZANO",11,1239,0,1250,"2019","041"
"28413","MURA",9,7,25,41,"2019","115"
"28414","MURAZZANO",288,0,20,308,"2019","145"
"28415","MURELLO",474,1312,214,2000,"2019","146"
"28416","MURISENGO",344,0,0,344,"2019","113"
"28417","MUSCOLINE",134,625,17,776,"2019","116"
"28418","MUSILE DI PIAVE",19,14,0,33,"2019","025"
"28419","MUSSO",4,0,6,10,"2019","160"
"28420","MUSSOLENTE",204,270,0,474,"2019","070"
"28421","MUZZANO",32,0,0,32,"2019","038"
"28422","NANTO",294,249,0,543,"2019","071"
"28423","NARZOLE",1800,166,0,1966,"2019","147"
"28424","NAVE",20,172,22,214,"2019","117"
"28425","NEBBIUNO",27,0,25,52,"2019","103"
"28426","NEGRAR",6,86,0,92,"2019","052"
"28427","NEIVE",20,0,0,20,"2019","148"
"28428","NEMBRO",36,3,0,39,"2019","144"
"28429","NERVESA DELLA BATTAGLIA",383,197,0,580,"2019","050"
"28430","NERVIANO",21,114,0,135,"2019","154"
"28431","NESSO",0,8,0,8,"2019","161"
"28432","NETRO",95,54,10,159,"2019","039"
"28433","NEVIANO DEGLI ARDUINI",40,1829,0,1869,"2019","024"
"28434","NIARDO",0,125,24,149,"2019","118"
"28435","NICHELINO",28,0,16,44,"2019","164"
"28436","NICORVO",2,0,0,2,"2019","103"
"28437","NIELLA BELBO",103,0,0,103,"2019","150"
"28438","NIELLA TANARO",577,0,0,577,"2019","151"
"28439","NIZZA MONFERRATO",53,1,0,54,"2019","080"
"28440","NOALE",307,66,7,380,"2019","026"
"28441","NOASCA",0,0,43,43,"2019","165"
"28442","NOCETO",16,3515,0,3531,"2019","025"
"28443","NOGARA",2631,425,0,3056,"2019","053"
"28444","NOGAROLE ROCCA",287,334,0,621,"2019","054"
"28445","NOGAROLE VICENTINO",10,15,0,25,"2019","072"
"28446","NOLE",207,42,135,384,"2019","166"
"28447","NONANTOLA",13,116,0,129,"2019","027"
"28448","NONE",712,1104,407,2223,"2019","168"
"28449","NONIO",1,0,0,1,"2019",NA
"28450","NOSATE",2,0,0,2,"2019","155"
"28451","NOVA MILANESE",0,72,0,72,"2019",NA
"28452","NOVAFELTRIA",1070,206,0,1276,"2019","023"
"28453","NOVALESA",41,18,5,64,"2019","169"
"28454","NOVARA",48,339,0,387,"2019","106"
"28455","NOVATE MEZZOLA",0,0,21,21,"2019","046"
"28456","NOVATE MILANESE",1,0,0,1,"2019",NA
"28457","NOVE",18,256,0,274,"2019","073"
"28458","NOVEDRATE",1095,0,0,1095,"2019","163"
"28459","NOVELLARA",3726,2368,0,6094,"2019","028"
"28460","NOVELLO",935,0,0,935,"2019","152"
"28461","NOVENTA DI PIAVE",6,8,0,14,"2019","027"
"28462","NOVENTA PADOVANA",16,0,0,16,"2019","058"
"28463","NOVENTA VICENTINA",4081,0,0,4081,"2019","074"
"28464","NOVI DI MODENA",1123,665,0,1788,"2019","028"
"28465","NOVI LIGURE",506,0,0,506,"2019","114"
"28466","NOVIGLIO",5,463,0,468,"2019","158"
"28467","NUVOLENTO",7,986,4,997,"2019","119"
"28468","NUVOLERA",1086,351,0,1437,"2019","120"
"28469","OCCHIEPPO INFERIORE",27,112,0,139,"2019","040"
"28470","OCCHIEPPO SUPERIORE",39,42,38,119,"2019","041"
"28471","OCCHIOBELLO",8,62,0,70,"2019","033"
"28472","OCCIMIANO",29,0,0,29,"2019","115"
"28473","ODALENGO GRANDE",59,0,0,59,"2019","116"
"28474","ODERZO",52,331,0,383,"2019","051"
"28475","ODOLO",8,0,1,9,"2019","121"
"28476","OFFANENGO",250,571,4,825,"2019","062"
"28477","OFFLAGA",61,3576,107,3744,"2019","122"
"28478","OGGEBBIO",5,0,0,5,"2019","049"
"28479","OGGIONA CON SANTO STEFANO",0,16,0,16,"2019","107"
"28480","OGGIONO",46,34,5,85,"2019","057"
"28481","OGLIANICO",81,278,0,359,"2019","170"
"28482","OLEGGIO",271,931,0,1202,"2019","108"
"28483","OLGIATE COMASCO",29,29,26,84,"2019","165"
"28484","OLGIATE MOLGORA",18,75,0,93,"2019","058"
"28485","OLGIATE OLONA",2,0,0,2,"2019","108"
"28486","OLGINATE",15,0,0,15,"2019","059"
"28487","OLIVA GESSI",8,0,0,8,"2019",NA
"28488","OLIVETO LARIO",14,0,0,14,"2019","060"
"28489","OLMENETA",8,381,127,516,"2019","063"
"28490","OLMO AL BREMBO",1,3,0,4,"2019","145"
"28491","OLMO GENTILE",33,0,11,44,"2019","081"
"28492","OLTRE IL COLLE",15,86,0,101,"2019","146"
"28493","OLTRESSENDA ALTA",3,42,0,45,"2019","147"
"28494","OLTRONA DI SAN MAMETTE",17,0,0,17,"2019","169"
"28495","OME",17,19,0,36,"2019","123"
"28496","OMEGNA",53,0,0,53,"2019","050"
"28497","ONCINO",0,0,123,123,"2019","154"
"28498","ONETA",6,35,0,41,"2019","148"
"28499","ONO SAN PIETRO",1,17,0,18,"2019","124"
"28500","ONORE",8,18,0,26,"2019","149"
"28501","OPERA",0,67,0,67,"2019","159"
"28502","OPPEANO",5391,790,0,6181,"2019","055"
"28503","ORBASSANO",526,0,3,529,"2019","171"
"28504","ORGIANO",506,15,0,521,"2019","075"
"28505","ORIGGIO",78,0,15,93,"2019","109"
"28506","ORINO",1,0,0,1,"2019","110"
"28507","ORIO CANAVESE",0,66,0,66,"2019","172"
"28508","ORIO LITTA",0,76,15,91,"2019","042"
"28509","ORMEA",138,0,13,151,"2019","155"
"28510","ORMELLE",7,131,0,138,"2019","052"
"28511","ORNAGO",33,61,0,94,"2019",NA
"28512","ORNAVASSO",10,0,0,10,"2019","051"
"28513","ORNICA",2,0,0,2,"2019","151"
"28514","ORSAGO",7,76,0,83,"2019","053"
"28515","ORSARA BORMIDA",14,0,0,14,"2019","119"
"28516","ORSENIGO",3,40,10,53,"2019","170"
"28517","ORTA SAN GIULIO",1,0,0,1,"2019","112"
"28518","ORZINUOVI",436,4901,31,5368,"2019","125"
"28519","ORZIVECCHI",10,773,0,783,"2019","126"
"28520","OSASCO",358,0,98,456,"2019","173"
"28521","OSASIO",230,141,109,480,"2019","174"
"28522","OSIO SOPRA",36,576,0,612,"2019","152"
"28523","OSIO SOTTO",1,0,0,1,"2019","153"
"28524","OSNAGO",0,80,185,265,"2019","061"
"28525","OSPEDALETTO EUGANEO",588,2,0,590,"2019","059"
"28526","OSPEDALETTO LODIGIANO",0,850,0,850,"2019","043"
"28527","OSPITALETTO",199,198,0,397,"2019","127"
"28528","OSSAGO LODIGIANO",32,1534,12,1578,"2019","044"
"28529","OSSIMO",3,8,3,14,"2019","128"
"28530","OSSONA",32,0,0,32,"2019","164"
"28531","OSTELLATO",3534,0,0,3534,"2019","017"
"28532","OSTIANO",93,1322,0,1415,"2019","064"
"28533","OSTIGLIA",22,34,47,103,"2019","038"
"28534","OTTIGLIO",110,0,0,110,"2019","120"
"28535","OTTOBIANO",0,23,0,23,"2019","106"
"28536","OTTONE",109,0,0,109,"2019","030"
"28537","OULX",43,0,0,43,"2019","175"
"28538","OVADA",34,0,0,34,"2019","121"
"28539","OVIGLIO",13,16,0,29,"2019","122"
"28540","OZEGNA",248,1,0,249,"2019","176"
"28541","OZZANO DELL'EMILIA",256,287,0,543,"2019","046"
"28542","OZZANO MONFERRATO",65,0,0,65,"2019","123"
"28543","OZZERO",9,247,0,256,"2019","165"
"28544","PADENGHE SUL GARDA",56,0,2,58,"2019","129"
"28545","PADERNO D'ADDA",0,18,0,18,"2019","062"
"28546","PADERNO DUGNANO",29,0,0,29,"2019","166"
"28547","PADERNO FRANCIACORTA",2,108,226,336,"2019","130"
"28548","PADERNO PONCHIELLI",170,2368,125,2663,"2019","065"
"28549","PADOVA",555,340,47,942,"2019","060"
"28550","PAESANA",761,10,0,771,"2019","157"
"28551","PAESE",2189,603,0,2792,"2019","055"
"28552","PAGNO",51,0,0,51,"2019","158"
"28553","PAGNONA",0,3,2,5,"2019","063"
"28554","PAISCO LOVENO",0,5,6,11,"2019","131"
"28555","PAITONE",13,42,3,58,"2019","132"
"28556","PALADINA",6,0,0,6,"2019","155"
"28557","PALAGANO",39,643,0,682,"2019","029"
"28558","PALANZANO",10,430,0,440,"2019","026"
"28559","PALAZZAGO",128,59,0,187,"2019","156"
"28560","PALAZZO CANAVESE",17,0,0,17,"2019","177"
"28561","PALAZZO PIGNANO",3,820,0,823,"2019","066"
"28562","PALAZZOLO SULL'OGLIO",1342,1434,109,2885,"2019","133"
"28563","PALAZZOLO VERCELLESE",12,0,0,12,"2019","090"
"28564","PALESTRO",2,0,18,20,"2019","107"
"28565","PALLANZENO",49,0,0,49,"2019","052"
"28566","PALOSCO",426,410,0,836,"2019","157"
"28567","PALU'",93,0,0,93,"2019","056"
"28568","PAMPARATO",49,0,0,49,"2019","159"
"28569","PANCALIERI",159,105,0,264,"2019","178"
"28570","PANDINO",128,3529,11,3668,"2019","067"
"28571","PANTIGLIATE",2,0,0,2,"2019","167"
"28572","PAPOZZE",158,55,0,213,"2019","034"
"28573","PARABIAGO",60,50,0,110,"2019","168"
"28574","PARATICO",4,43,0,47,"2019","134"
"28575","PARETO",55,2,0,57,"2019","125"
"28576","PARLASCO",1,0,0,1,"2019","064"
"28577","PARMA",385,9988,0,10373,"2019","027"
"28578","PARODI LIGURE",53,0,29,82,"2019","126"
"28579","PAROLDO",31,0,0,31,"2019","160"
"28580","PARONA",5,0,0,5,"2019","109"
"28581","PARRE",26,89,0,115,"2019","158"
"28582","PARUZZARO",43,30,0,73,"2019","114"
"28583","PARZANICA",4,6,0,10,"2019","159"
"28584","PASPARDO",0,3,3,6,"2019","135"
"28585","PASSERANO MARMORITO",120,0,0,120,"2019","082"
"28586","PASSIRANO",54,114,81,249,"2019","136"
"28587","PASTRENGO",0,153,0,153,"2019","057"
"28588","PASTURO",70,116,51,237,"2019","065"
"28589","PAULLO",0,527,0,527,"2019","169"
"28590","PAVAROLO",64,0,0,64,"2019","180"
"28591","PAVIA",61,254,12,327,"2019","110"
"28592","PAVONE CANAVESE",144,0,0,144,"2019","181"
"28593","PAVONE DEL MELLA",1742,293,10,2045,"2019","137"
"28594","PAVULLO NEL FRIGNANO",160,3862,0,4022,"2019","030"
"28595","PECETTO DI VALENZA",8,0,0,8,"2019","128"
"28596","PECETTO TORINESE",88,0,0,88,"2019","183"
"28597","PEDAVENA",3,116,0,119,"2019","036"
"28598","PEDEMONTE",0,4,4,8,"2019","076"
"28599","PEDEROBBA",68,148,11,227,"2019","056"
"28600","PEDRENGO",14,216,24,254,"2019","160"
"28601","PEGLIO",2,0,12,14,"2019","178"
"28602","PEGOGNAGA",1420,1834,2213,5467,"2019","039"
"28603","PEIA",2,9,0,11,"2019","161"
"28604","PELLEGRINO PARMENSE",26,770,0,796,"2019","028"
"28605","PENANGO",59,0,0,59,"2019","083"
"28606","PENNABILLI",287,13,0,300,"2019","024"
"28607","PERLEDO",1,0,0,1,"2019","067"
"28608","PERLETTO",204,0,0,204,"2019","161"
"28609","PERLO",46,0,0,46,"2019","162"
"28610","PERNUMIA",342,146,0,488,"2019","061"
"28611","PERO",2,0,0,2,"2019",NA
"28612","PEROSA ARGENTINA",55,14,0,69,"2019","184"
"28613","PEROSA CANAVESE",101,167,0,268,"2019","185"
"28614","PERRERO",18,0,0,18,"2019","186"
"28615","PERSICO DOSIMO",1,2016,0,2017,"2019","068"
"28616","PERTENGO",2,0,0,2,"2019","091"
"28617","PERTICA ALTA",6,7,8,21,"2019","139"
"28618","PERTICA BASSA",31,40,30,101,"2019","140"
"28619","PERTUSIO",66,0,0,66,"2019","187"
"28620","PESCANTINA",75,66,0,141,"2019","058"
"28621","PESCAROLO ED UNITI",50,1005,0,1055,"2019","069"
"28622","PESCHIERA BORROMEO",27,401,0,428,"2019","171"
"28623","PESSANO CON BORNAGO",60,158,0,218,"2019","172"
"28624","PESSINA CREMONESE",513,3108,0,3621,"2019","070"
"28625","PESSINETTO",1,0,0,1,"2019","188"
"28626","PETTENASCO",8,0,0,8,"2019","116"
"28627","PETTINENGO",2,25,0,27,"2019","042"
"28628","PETTORAZZA GRIMANI",284,163,0,447,"2019","035"
"28629","PEVERAGNO",1243,507,31,1781,"2019","163"
"28630","PEZZAZE",24,33,0,57,"2019","141"
"28631","PEZZOLO VALLE UZZONE",52,0,0,52,"2019","164"
"28632","PIACENZA",526,1318,0,1844,"2019","032"
"28633","PIACENZA D'ADIGE",730,0,0,730,"2019","062"
"28634","PIADENA DRIZZONA",28,846,63,937,"2019",NA
"28635","PIAN CAMUNO",0,287,1,288,"2019","142"
"28636","PIANCOGNO",9,76,3,88,"2019","206"
"28637","PIANELLO DEL LARIO",7,0,8,15,"2019","183"
"28638","PIANELLO VAL TIDONE",388,141,0,529,"2019","033"
"28639","PIANENGO",0,317,0,317,"2019","072"
"28640","PIANEZZA",317,400,118,835,"2019","189"
"28641","PIANEZZE",160,113,0,273,"2019","077"
"28642","PIANFEI",817,56,16,889,"2019","165"
"28643","PIANICO",7,72,0,79,"2019","162"
"28644","PIANIGA",41,49,2,92,"2019","028"
"28645","PIANORO",256,152,0,408,"2019","047"
"28646","PIANTEDO",7,271,6,284,"2019","048"
"28647","PIARIO",21,0,0,21,"2019","163"
"28648","PIASCO",273,252,43,568,"2019","166"
"28649","PIATEDA",23,79,0,102,"2019","049"
"28650","PIATTO",28,0,0,28,"2019","043"
"28651","PIAZZA BREMBANA",2,0,0,2,"2019","164"
"28652","PIAZZATORRE",0,3,0,3,"2019","165"
"28653","PIAZZOLA SUL BRENTA",2768,1060,0,3828,"2019","063"
"28654","PIAZZOLO",0,0,3,3,"2019","166"
"28655","PIEA",64,0,0,64,"2019","084"
"28656","PIEDIMULERA",0,19,0,19,"2019","053"
"28657","PIERANICA",52,23,0,75,"2019","073"
"28658","PIETRA DE' GIORGI",17,0,0,17,"2019","111"
"28659","PIEVE D'OLMI",0,1481,643,2124,"2019","074"
"28660","PIEVE DEL CAIRO",5,83,0,88,"2019","113"
"28661","PIEVE DEL GRAPPA",1158,826,0,1984,"2019",NA
"28662","PIEVE DI CADORE",3,11,0,14,"2019","039"
"28663","PIEVE DI SOLIGO",24,135,0,159,"2019","057"
"28664","PIEVE EMANUELE",0,439,151,590,"2019","173"
"28665","PIEVE FISSIRAGA",81,1229,0,1310,"2019","045"
"28666","PIEVE PORTO MORONE",124,0,0,124,"2019","114"
"28667","PIEVE SAN GIACOMO",0,1948,0,1948,"2019","075"
"28668","PIEVE VERGONTE",31,6,50,87,"2019","054"
"28669","PIEVEPELAGO",29,65,0,94,"2019","031"
"28670","PINAROLO PO",2012,0,0,2012,"2019","115"
"28671","PINASCA",93,0,44,137,"2019","190"
"28672","PINCARA",479,0,0,479,"2019","036"
"28673","PINEROLO",2010,187,88,2285,"2019","191"
"28674","PINO TORINESE",491,0,66,557,"2019","192"
"28675","PIOBESI TORINESE",377,983,309,1669,"2019","193"
"28676","PIODE",0,8,20,28,"2019","097"
"28677","PIOLTELLO",2,0,0,2,"2019","175"
"28678","PIOMBINO DESE",5417,437,0,5854,"2019","064"
"28679","PIOSSASCO",477,771,117,1365,"2019","194"
"28680","PIOVA' MASSAIA",218,0,0,218,"2019","086"
"28681","PIOVE DI SACCO",3710,168,0,3878,"2019","065"
"28682","PIOVENE ROCCHETTE",1951,117,0,2068,"2019","078"
"28683","PIOZZANO",169,0,0,169,"2019","034"
"28684","PIOZZO",292,0,0,292,"2019","169"
"28685","PISCINA",1701,0,0,1701,"2019","195"
"28686","PISOGNE",6,201,17,224,"2019","143"
"28687","PIUBEGA",3586,955,83,4624,"2019","041"
"28688","PIURO",13,164,7,184,"2019","050"
"28689","PIVERONE",145,52,0,197,"2019","196"
"28690","PIZZIGHETTONE",62,3017,0,3079,"2019","076"
"28691","POCAPAGLIA",219,33,0,252,"2019","170"
"28692","PODENZANO",74,665,0,739,"2019","035"
"28693","POGGIO RENATICO",9,432,0,441,"2019","018"
"28694","POGGIO RUSCO",283,478,440,1201,"2019","042"
"28695","POGGIO TORRIANA",556,0,0,556,"2019",NA
"28696","POGGIRIDENTI",4,0,0,4,"2019","051"
"28697","POGNANO",4,418,40,462,"2019","167"
"28698","POGNO",1,0,0,1,"2019",NA
"28699","POIRINO",3545,609,0,4154,"2019","197"
"28700","POJANA MAGGIORE",1314,21,0,1335,"2019","079"
"28701","POLAVENO",44,4,0,48,"2019","144"
"28702","POLESINE ZIBELLO",18,1589,0,1607,"2019",NA
"28703","POLINAGO",52,737,0,789,"2019","032"
"28704","POLLONE",166,58,0,224,"2019","046"
"28705","POLONGHERA",182,130,45,357,"2019","171"
"28706","POLPENAZZE DEL GARDA",14,121,0,135,"2019","145"
"28707","POLVERARA",6,56,0,62,"2019","066"
"28708","POMARETTO",48,0,7,55,"2019","198"
"28709","POMARO MONFERRATO",1,0,240,241,"2019","131"
"28710","POMBIA",2,70,0,72,"2019","121"
"28711","POMPIANO",21,1426,0,1447,"2019","146"
"28712","POMPONESCO",0,459,0,459,"2019","043"
"28713","PONCARALE",432,746,199,1377,"2019","147"
"28714","PONDERANO",51,40,44,135,"2019","047"
"28715","PONNA",2,0,8,10,"2019","187"
"28716","PONSO",38,0,0,38,"2019","067"
"28717","PONT-CANAVESE",40,41,0,81,"2019","199"
"28718","PONTE DELL'OLIO",131,102,0,233,"2019","036"
"28719","PONTE DI LEGNO",3,2,0,5,"2019","148"
"28720","PONTE DI PIAVE",60,31,5,96,"2019","058"
"28721","PONTE IN VALTELLINA",15,10,0,25,"2019","052"
"28722","PONTE LAMBRO",3,11,0,14,"2019","188"
"28723","PONTE NELLE ALPI",17,121,0,138,"2019","040"
"28724","PONTE NIZZA",138,31,0,169,"2019","117"
"28725","PONTE NOSSA",0,31,0,31,"2019","168"
"28726","PONTE SAN NICOLO'",180,40,0,220,"2019","069"
"28727","PONTE SAN PIETRO",5,0,0,5,"2019","170"
"28728","PONTECCHIO POLESINE",1282,0,0,1282,"2019","038"
"28729","PONTECHIANALE",203,0,0,203,"2019","172"
"28730","PONTECURONE",3,0,0,3,"2019","132"
"28731","PONTELONGO",273,0,0,273,"2019","068"
"28732","PONTENURE",45,163,0,208,"2019","037"
"28733","PONTERANICA",1,0,0,1,"2019","169"
"28734","PONTESTURA",7,0,0,7,"2019","133"
"28735","PONTEVICO",281,3564,485,4330,"2019","149"
"28736","PONTI",81,0,7,88,"2019","134"
"28737","PONTI SUL MINCIO",201,381,38,620,"2019","044"
"28738","PONTIDA",20,0,0,20,"2019","171"
"28739","PONTIROLO NUOVO",247,410,52,709,"2019","172"
"28740","PONTOGLIO",634,1413,152,2199,"2019","150"
"28741","PONZANO MONFERRATO",46,0,0,46,"2019","135"
"28742","PONZANO VENETO",321,153,0,474,"2019","059"
"28743","PONZONE",29,0,17,46,"2019","136"
"28744","PORLEZZA",2,39,17,58,"2019","189"
"28745","PORTACOMARO",44,0,0,44,"2019","087"
"28746","PORTE",18,0,0,18,"2019","200"
"28747","PORTICO E SAN BENEDETTO",50,0,0,50,"2019","031"
"28748","PORTO MANTOVANO",1755,414,1992,4161,"2019","045"
"28749","PORTO TOLLE",13,0,0,13,"2019","039"
"28750","PORTO VALTRAVAGLIA",23,0,8,31,"2019","114"
"28751","PORTO VIRO",4445,0,0,4445,"2019","052"
"28752","PORTOBUFFOLE'",2,0,3,5,"2019","060"
"28753","PORTOGRUARO",1361,67,0,1428,"2019","029"
"28754","PORTOMAGGIORE",839,434,0,1273,"2019","019"
"28755","PORTULA",2,0,0,2,"2019","048"
"28756","POSINA",1,11,0,12,"2019","080"
"28757","POSSAGNO",10,10,0,20,"2019","061"
"28758","POSTALESIO",1,0,0,1,"2019","053"
"28759","POSTUA",1,4,0,5,"2019","102"
"28760","POVE DEL GRAPPA",8,0,0,8,"2019","081"
"28761","POVEGLIANO",133,142,6,281,"2019","062"
"28762","POVEGLIANO VERONESE",2767,520,0,3287,"2019","060"
"28763","POVIGLIO",10,1208,0,1218,"2019","029"
"28764","POZZAGLIO ED UNITI",29,2285,242,2556,"2019","077"
"28765","POZZO D'ADDA",233,0,0,233,"2019","177"
"28766","POZZOL GROPPO",40,0,0,40,"2019","137"
"28767","POZZOLENGO",531,376,31,938,"2019","151"
"28768","POZZOLEONE",101,2202,3,2306,"2019","082"
"28769","POZZOLO FORMIGARO",24,257,0,281,"2019","138"
"28770","POZZONOVO",1763,0,0,1763,"2019","070"
"28771","POZZUOLO MARTESANA",12,191,7,210,"2019","178"
"28772","PRADALUNGA",29,0,0,29,"2019","173"
"28773","PRADLEVES",2,9,1,12,"2019","173"
"28774","PRAGELATO",9,0,4,13,"2019","201"
"28775","PRALBOINO",1603,788,22,2413,"2019","152"
"28776","PRALI",55,0,0,55,"2019","202"
"28777","PRALORMO",1280,342,0,1622,"2019","203"
"28778","PRALUNGO",100,3,32,135,"2019","049"
"28779","PRAMAGGIORE",6,9,0,15,"2019","030"
"28780","PRAMOLLO",9,0,0,9,"2019","204"
"28781","PRAROSTINO",25,8,0,33,"2019","205"
"28782","PRASCO",18,0,0,18,"2019","139"
"28783","PRASCORSANO",4,0,0,4,"2019","206"
"28784","PRATA CAMPORTACCIO",6,122,59,187,"2019","054"
"28785","PRATIGLIONE",5,0,0,5,"2019","207"
"28786","PRATO SESIA",2,14,0,16,"2019","122"
"28787","PRAY",64,0,0,64,"2019","050"
"28788","PRAZZO",219,19,40,278,"2019","174"
"28789","PREDAPPIO",111,18,0,129,"2019","032"
"28790","PREDORE",31,0,0,31,"2019","174"
"28791","PREDOSA",151,111,0,262,"2019","140"
"28792","PREGANZIOL",23,170,0,193,"2019","063"
"28793","PREGNANA MILANESE",5,125,0,130,"2019","179"
"28794","PREMANA",1,7,1,9,"2019","069"
"28795","PREMENO",2,0,0,2,"2019","055"
"28796","PREMIA",28,208,7,243,"2019","056"
"28797","PREMILCUORE",269,0,33,302,"2019","033"
"28798","PREMOLO",13,14,0,27,"2019","175"
"28799","PREMOSELLO-CHIOVENDA",15,0,0,15,"2019","057"
"28800","PRESEGLIE",59,0,0,59,"2019","153"
"28801","PRESEZZO",2,0,0,2,"2019",NA
"28802","PRESSANA",4747,46,0,4793,"2019","061"
"28803","PREVALLE",36,555,24,615,"2019","155"
"28804","PRIERO",30,0,0,30,"2019","175"
"28805","PRIGNANO SULLA SECCHIA",108,1245,0,1353,"2019","033"
"28806","PRIMALUNA",16,56,3,75,"2019","070"
"28807","PRIOCCA",571,0,0,571,"2019","176"
"28808","PRIOLA",76,0,0,76,"2019","177"
"28809","PROSERPIO",6,4,0,10,"2019","192"
"28810","PROVAGLIO D'ISEO",122,190,8,320,"2019","156"
"28811","PROVAGLIO VAL SABBIA",22,0,5,27,"2019","157"
"28812","PRUNETTO",69,0,0,69,"2019","178"
"28813","PUEGNAGO SUL GARDA",11,120,0,131,"2019","158"
"28814","PUMENENGO",1636,836,209,2681,"2019","177"
"28815","PUSIANO",0,0,1,1,"2019","193"
"28816","QUAREGNA CERRETO",110,0,0,110,"2019",NA
"28817","QUARGNENTO",758,0,0,758,"2019","141"
"28818","QUARNA SOPRA",2,0,0,2,"2019","058"
"28819","QUARNA SOTTO",11,0,0,11,"2019","059"
"28820","QUARONA",12,5,0,17,"2019","107"
"28821","QUARTO D'ALTINO",4,27,0,31,"2019","031"
"28822","QUASSOLO",36,22,0,58,"2019","209"
"28823","QUATTORDIO",574,0,0,574,"2019","142"
"28824","QUATTRO CASTELLA",16,1364,0,1380,"2019","030"
"28825","QUERO VAS",23,77,10,110,"2019",NA
"28826","QUINCINETTO",26,38,0,64,"2019","210"
"28827","QUINGENTOLE",1091,68,69,1228,"2019","046"
"28828","QUINTANO",1,363,0,364,"2019","078"
"28829","QUINTO DI TREVISO",150,164,25,339,"2019","064"
"28830","QUINTO VERCELLESE",49,0,0,49,"2019","108"
"28831","QUINTO VICENTINO",47,747,0,794,"2019","083"
"28832","QUINZANO D'OGLIO",326,2926,0,3252,"2019","159"
"28833","QUISTELLO",214,1258,835,2307,"2019","047"
"28834","RACCONIGI",2381,1979,135,4495,"2019","179"
"28835","RANCIO VALCUVIA",4,0,0,4,"2019","115"
"28836","RANCO",0,0,31,31,"2019","116"
"28837","RANICA",45,16,0,61,"2019","178"
"28838","RANZANICO",8,17,0,25,"2019","179"
"28839","RAVENNA",1118,1234,0,2352,"2019","014"
"28840","RE",19,0,0,19,"2019","060"
"28841","REANO",25,0,4,29,"2019","211"
"28842","RECOARO TERME",75,81,0,156,"2019","084"
"28843","REDAVALLE",32,0,0,32,"2019","120"
"28844","REDONDESCO",355,592,757,1704,"2019","048"
"28845","REFRANCORE",34,0,0,34,"2019","089"
"28846","REFRONTOLO",9,24,1,34,"2019","065"
"28847","REGGIO NELL'EMILIA",67,10654,0,10721,"2019","033"
"28848","REGGIOLO",1208,2530,0,3738,"2019","032"
"28849","REMEDELLO",6919,2401,159,9479,"2019","160"
"28850","RENATE",4,0,1,5,"2019",NA
"28851","RESANA",1938,60,5,2003,"2019","066"
"28852","REVELLO",6442,1848,286,8576,"2019","180"
"28853","REVIGLIASCO D'ASTI",293,0,0,293,"2019","090"
"28854","REVINE LAGO",19,1,0,20,"2019","067"
"28855","REZZATO",497,688,0,1185,"2019","161"
"28856","RHO",15,438,0,453,"2019","182"
"28857","RIBORDONE",7,0,0,7,"2019","212"
"28858","RICCIONE",2,0,0,2,"2019","013"
"28859","RICENGO",18,2278,124,2420,"2019","079"
"28860","RIESE PIO X",8367,403,34,8804,"2019","068"
"28861","RIFREDDO",1141,12,50,1203,"2019","181"
"28862","RIMELLA",3,7,12,22,"2019","113"
"28863","RIMINI",109,141,0,250,"2019","014"
"28864","RIO SALICETO",952,350,0,1302,"2019","034"
"28865","RIOLO TERME",317,0,0,317,"2019","015"
"28866","RIOLUNATO",45,25,0,70,"2019","035"
"28867","RIPALTA ARPINA",0,332,60,392,"2019","080"
"28868","RIPALTA CREMASCA",4,272,0,276,"2019","081"
"28869","RIPALTA GUERINA",0,543,45,588,"2019","082"
"28870","RIVA DEL PO",1599,77,0,1676,"2019",NA
"28871","RIVA DI SOLTO",5,0,0,5,"2019","180"
"28872","RIVA PRESSO CHIERI",3037,129,172,3338,"2019","215"
"28873","RIVALBA",70,0,0,70,"2019","213"
"28874","RIVALTA DI TORINO",103,0,0,103,"2019","214"
"28875","RIVAMONTE AGORDINO",0,14,0,14,"2019","043"
"28876","RIVANAZZANO",117,0,0,117,"2019","122"
"28877","RIVARA",132,122,0,254,"2019","216"
"28878","RIVAROLO CANAVESE",1112,552,491,2155,"2019","217"
"28879","RIVAROLO DEL RE ED UNITI",3544,396,0,3940,"2019","083"
"28880","RIVAROLO MANTOVANO",54,1101,273,1428,"2019","050"
"28881","RIVAROSSA",10,141,0,151,"2019","218"
"28882","RIVERGARO",83,1136,0,1219,"2019","038"
"28883","RIVOLI",1472,27,105,1604,"2019","219"
"28884","RIVOLI VERONESE",169,0,9,178,"2019","062"
"28885","RIVOLTA D'ADDA",1958,2563,39,4560,"2019","084"
"28886","ROANA",49,330,7,386,"2019","085"
"28887","ROASCIO",11,0,0,11,"2019","184"
"28888","ROASIO",5,0,0,5,"2019","116"
"28889","ROATTO",116,0,0,116,"2019","091"
"28890","ROBASSOMERO",65,103,0,168,"2019","220"
"28891","ROBBIO",2,179,0,181,"2019","123"
"28892","ROBECCHETTO CON INDUNO",257,208,8,473,"2019","183"
"28893","ROBECCO D'OGLIO",0,2970,0,2970,"2019","085"
"28894","ROBECCO PAVESE",7,0,0,7,"2019","124"
"28895","ROBECCO SUL NAVIGLIO",92,620,19,731,"2019","184"
"28896","ROBELLA",421,0,0,421,"2019","092"
"28897","ROBILANTE",255,0,0,255,"2019","185"
"28898","ROBURENT",24,0,0,24,"2019","186"
"28899","ROCCA CANAVESE",122,0,0,122,"2019","221"
"28900","ROCCA CIGLIE'",5,0,0,5,"2019","188"
"28901","ROCCA D'ARAZZO",361,0,0,361,"2019","093"
"28902","ROCCA DE' BALDI",2787,926,681,4394,"2019","189"
"28903","ROCCA GRIMALDA",12,0,0,12,"2019","147"
"28904","ROCCA PIETORE",0,10,0,10,"2019","044"
"28905","ROCCA SAN CASCIANO",80,0,0,80,"2019","036"
"28906","ROCCA SUSELLA",1,0,0,1,"2019",NA
"28907","ROCCABIANCA",0,980,0,980,"2019","030"
"28908","ROCCABRUNA",41,51,70,162,"2019","187"
"28909","ROCCAFORTE LIGURE",26,0,0,26,"2019","146"
"28910","ROCCAFORTE MONDOVI'",1175,0,6,1181,"2019","190"
"28911","ROCCAFRANCA",1728,1588,20,3336,"2019","162"
"28912","ROCCASPARVERA",556,0,0,556,"2019","191"
"28913","ROCCAVERANO",130,0,0,130,"2019","094"
"28914","ROCCAVIONE",32,0,0,32,"2019","192"
"28915","ROCCHETTA LIGURE",21,0,0,21,"2019","148"
"28916","ROCCHETTA PALAFEA",19,0,0,19,"2019","095"
"28917","ROCCHETTA TANARO",418,0,0,418,"2019","096"
"28918","RODANO",63,123,0,186,"2019","185"
"28919","RODDI",64,32,0,96,"2019","194"
"28920","RODDINO",81,0,0,81,"2019","195"
"28921","RODELLO",103,0,0,103,"2019","196"
"28922","RODENGO-SAIANO",15,243,104,362,"2019","163"
"28923","RODERO",7,11,0,18,"2019",NA
"28924","RODIGO",928,696,1828,3452,"2019","051"
"28925","ROE' VOLCIANO",6,0,0,6,"2019","164"
"28926","ROGENO",13,242,40,295,"2019","072"
"28927","ROGNANO",14,0,0,14,"2019","127"
"28928","ROGNO",14,81,0,95,"2019","182"
"28929","ROGOLO",2,20,0,22,"2019","056"
"28930","ROLETTO",197,85,0,282,"2019","222"
"28931","ROLO",34,297,0,331,"2019","035"
"28932","ROMAGNANO SESIA",31,0,0,31,"2019","130"
"28933","ROMAGNESE",125,0,0,125,"2019","128"
"28934","ROMANENGO",0,2083,53,2136,"2019","086"
"28935","ROMANO CANAVESE",36,0,0,36,"2019","223"
"28936","ROMANO D'EZZELINO",262,457,0,719,"2019","086"
"28937","ROMANO DI LOMBARDIA",169,3306,12,3487,"2019","183"
"28938","ROMENTINO",11,0,0,11,"2019","131"
"28939","RONAGO",5,0,28,33,"2019","199"
"28940","RONCA'",7,0,0,7,"2019","063"
"28941","RONCADE",2221,120,0,2341,"2019","069"
"28942","RONCADELLE",251,681,0,932,"2019","165"
"28943","RONCARO",3,0,0,3,"2019","129"
"28944","RONCO ALL'ADIGE",5860,0,0,5860,"2019","064"
"28945","RONCO BIELLESE",4,51,0,55,"2019","053"
"28946","RONCO BRIANTINO",0,170,0,170,"2019",NA
"28947","RONCOFERRARO",3127,434,629,4190,"2019","052"
"28948","RONCOFREDDO",18,38,0,56,"2019","037"
"28949","RONCOLA",26,34,0,60,"2019","185"
"28950","RONSECCO",6,0,0,6,"2019",NA
"28951","ROPPOLO",5,0,0,5,"2019","054"
"28952","RORA'",23,0,0,23,"2019","226"
"28953","ROSA'",65,734,0,799,"2019","087"
"28954","ROSATE",4152,478,0,4630,"2019","188"
"28955","ROSIGNANO MONFERRATO",104,0,0,104,"2019","149"
"28956","ROSOLINA",4,0,0,4,"2019","040"
"28957","ROSSA",6,24,0,30,"2019","121"
"28958","ROSSANA",85,126,0,211,"2019","197"
"28959","ROSSANO VENETO",322,174,11,507,"2019","088"
"28960","ROSTA",32,0,83,115,"2019","228"
"28961","ROTA D'IMAGNA",8,42,0,50,"2019","186"
"28962","ROTTOFRENO",538,996,0,1534,"2019","039"
"28963","ROTZO",107,0,0,107,"2019","089"
"28964","ROURE",16,0,0,16,"2019","227"
"28965","ROVASENDA",6,0,0,6,"2019","122"
"28966","ROVATO",1463,2296,3,3762,"2019","166"
"28967","ROVELLASCA",6,60,0,66,"2019","201"
"28968","ROVERBELLA",13311,460,308,14079,"2019","053"
"28969","ROVERCHIARA",4355,2,124,4481,"2019","065"
"28970","ROVERE' VERONESE",256,1199,0,1455,"2019","067"
"28971","ROVEREDO DI GUA'",1772,76,20,1868,"2019","066"
"28972","ROVESCALA",12,0,0,12,"2019","131"
"28973","ROVETTA",33,130,0,163,"2019","187"
"28974","ROVIGO",1565,2,0,1567,"2019","041"
"28975","ROVOLON",190,25,47,262,"2019","071"
"28976","RUBANO",25,26,41,92,"2019","072"
"28977","RUBIANA",5,0,1,6,"2019","229"
"28978","RUBIERA",8,420,0,428,"2019","036"
"28979","RUDIANO",343,1191,56,1590,"2019","167"
"28980","RUEGLIO",95,0,0,95,"2019","230"
"28981","RUFFIA",366,211,65,642,"2019","198"
"28982","RUSSI",7,0,0,7,"2019","016"
"28983","SABBIO CHIESE",15,64,8,87,"2019","168"
"28984","SABBIONETA",4,58,10,72,"2019","054"
"28985","SACCOLONGO",63,514,5,582,"2019","073"
"28986","SAGLIANO MICCA",40,0,0,40,"2019","056"
"28987","SALA BAGANZA",10,117,32,159,"2019","031"
"28988","SALA BIELLESE",1,0,0,1,"2019","057"
"28989","SALA BOLOGNESE",363,0,0,363,"2019","050"
"28990","SALA COMACINA",1,0,0,1,"2019","203"
"28991","SALA MONFERRATO",89,0,0,89,"2019","150"
"28992","SALARA",2,0,0,2,"2019","042"
"28993","SALASSA",24,0,0,24,"2019","231"
"28994","SALBERTRAND",56,0,0,56,"2019","232"
"28995","SALCEDO",682,58,0,740,"2019","090"
"28996","SALE DELLE LANGHE",159,0,0,159,"2019","199"
"28997","SALE MARASINO",34,8,29,71,"2019","169"
"28998","SALE SAN GIOVANNI",68,0,0,68,"2019","200"
"28999","SALERANO CANAVESE",4,0,0,4,"2019",NA
"29000","SALERANO SUL LAMBRO",2,317,0,319,"2019","046"
"29001","SALGAREDA",1763,187,6,1956,"2019","070"
"29002","SALICETO",55,0,0,55,"2019","201"
"29003","SALIZZOLE",2301,406,26,2733,"2019","068"
"29004","SALMOUR",264,0,0,264,"2019","202"
"29005","SALO'",0,34,2,36,"2019","170"
"29006","SALSOMAGGIORE TERME",12,1015,0,1027,"2019","032"
"29007","SALTRIO",47,0,0,47,"2019","117"
"29008","SALUDECIO",64,0,0,64,"2019","015"
"29009","SALUGGIA",522,133,0,655,"2019","128"
"29010","SALUSSOLA",498,121,0,619,"2019","058"
"29011","SALUZZO",3762,3547,565,7874,"2019","203"
"29012","SALVIROLA",688,81,2,771,"2019","087"
"29013","SALZA DI PINEROLO",3,0,0,3,"2019",NA
"29014","SALZANO",280,25,1,306,"2019","032"
"29015","SAMARATE",42,0,0,42,"2019","118"
"29016","SAMBUCO",38,0,0,38,"2019","204"
"29017","SAMOLACO",168,653,42,863,"2019","057"
"29018","SAMONE",3,0,0,3,"2019","235"
"29019","SAMPEYRE",307,79,0,386,"2019","205"
"29020","SAN BARTOLOMEO VAL CAVARGNA",1,0,1,2,"2019","204"
"29021","SAN BASSANO",8,1674,0,1682,"2019","088"
"29022","SAN BELLINO",1257,0,0,1257,"2019","043"
"29023","SAN BENEDETTO BELBO",59,0,0,59,"2019","206"
"29024","SAN BENEDETTO PO",967,1685,1011,3663,"2019","055"
"29025","SAN BENEDETTO VAL DI SAMBRO",392,64,1,457,"2019","051"
"29026","SAN BENIGNO CANAVESE",234,0,16,250,"2019","236"
"29027","SAN BERNARDINO VERBANO",4,0,0,4,"2019","061"
"29028","SAN BIAGIO DI CALLALTA",239,11,0,250,"2019","071"
"29029","SAN BONIFACIO",2114,0,0,2114,"2019","069"
"29030","SAN CARLO CANAVESE",185,155,114,454,"2019","237"
"29031","SAN CESARIO SUL PANARO",35,687,0,722,"2019","036"
"29032","SAN CLEMENTE",12,0,0,12,"2019","016"
"29033","SAN COLOMBANO AL LAMBRO",26,283,0,309,"2019","191"
"29034","SAN COLOMBANO BELMONTE",2,13,0,15,"2019","238"
"29035","SAN DAMIANO D'ASTI",4123,0,0,4123,"2019","097"
"29036","SAN DAMIANO MACRA",47,0,0,47,"2019","207"
"29037","SAN DANIELE PO",18,1521,22,1561,"2019","089"
"29038","SAN DIDERO",0,2,0,2,"2019","239"
"29039","SAN DONA' DI PIAVE",285,323,11,619,"2019","033"
"29040","SAN DONATO MILANESE",2,0,0,2,"2019","192"
"29041","SAN FELICE DEL BENACO",4,0,0,4,"2019","171"
"29042","SAN FELICE SUL PANARO",0,855,0,855,"2019","037"
"29043","SAN FERMO DELLA BATTAGLIA",28,0,24,52,"2019","206"
"29044","SAN FIOR",25,11,10,46,"2019","072"
"29045","SAN FIORANO",0,178,0,178,"2019","047"
"29046","SAN FRANCESCO AL CAMPO",596,330,0,926,"2019","240"
"29047","SAN GENESIO ED UNITI",5,544,1,550,"2019","135"
"29048","SAN GERMANO CHISONE",65,16,2,83,"2019","242"
"29049","SAN GERMANO VERCELLESE",4,0,0,4,"2019","131"
"29050","SAN GERVASIO BRESCIANO",0,180,0,180,"2019","172"
"29051","SAN GIACOMO DELLE SEGNATE",414,191,124,729,"2019","056"
"29052","SAN GIACOMO VERCELLESE",1876,0,0,1876,"2019","035"
"29053","SAN GILLIO",102,63,12,177,"2019","243"
"29054","SAN GIORGIO BIGARELLO",1837,344,641,2822,"2019",NA
"29055","SAN GIORGIO CANAVESE",164,15,0,179,"2019","244"
"29056","SAN GIORGIO DELLE PERTICHE",278,73,0,351,"2019","075"
"29057","SAN GIORGIO DI LOMELLINA",3,0,0,3,"2019","136"
"29058","SAN GIORGIO DI PIANO",34,0,0,34,"2019","052"
"29059","SAN GIORGIO IN BOSCO",255,814,11,1080,"2019","076"
"29060","SAN GIORGIO MONFERRATO",16,0,0,16,"2019","153"
"29061","SAN GIORGIO PIACENTINO",179,711,0,890,"2019","040"
"29062","SAN GIORGIO SCARAMPI",77,0,0,77,"2019","098"
"29063","SAN GIORIO DI SUSA",1,19,0,20,"2019","245"
"29064","SAN GIOVANNI BIANCO",40,19,0,59,"2019","188"
"29065","SAN GIOVANNI DEL DOSSO",0,295,99,394,"2019","058"
"29066","SAN GIOVANNI ILARIONE",647,4,0,651,"2019","070"
"29067","SAN GIOVANNI IN CROCE",0,492,0,492,"2019","090"
"29068","SAN GIOVANNI IN MARIGNANO",5,0,0,5,"2019","017"
"29069","SAN GIOVANNI IN PERSICETO",31,785,0,816,"2019","053"
"29070","SAN GIOVANNI LUPATOTO",721,71,0,792,"2019","071"
"29071","SAN GIULIANO MILANESE",32,435,130,597,"2019","195"
"29072","SAN GIUSTO CANAVESE",113,17,0,130,"2019","246"
"29073","SAN GREGORIO NELLE ALPI",9,50,0,59,"2019","045"
"29074","SAN LAZZARO DI SAVENA",3,0,0,3,"2019","054"
"29075","SAN LEO",275,355,0,630,"2019","025"
"29076","SAN MARTINO ALFIERI",13,0,0,13,"2019","099"
"29077","SAN MARTINO BUON ALBERGO",160,1006,0,1166,"2019","073"
"29078","SAN MARTINO CANAVESE",56,0,0,56,"2019","247"
"29079","SAN MARTINO DALL'ARGINE",326,935,118,1379,"2019","059"
"29080","SAN MARTINO DEL LAGO",13,0,0,13,"2019","091"
"29081","SAN MARTINO DI LUPARI",3253,368,0,3621,"2019","077"
"29082","SAN MARTINO IN RIO",0,942,0,942,"2019","037"
"29083","SAN MARTINO IN STRADA",0,901,0,901,"2019","048"
"29084","SAN MARTINO SICCOMARIO",0,3,0,3,"2019","137"
"29085","SAN MARZANO OLIVETO",25,0,0,25,"2019","100"
"29086","SAN MAURIZIO CANAVESE",143,302,245,690,"2019","248"
"29087","SAN MAURIZIO D'OPAGLIO",9,0,0,9,"2019","133"
"29088","SAN MAURO DI SALINE",41,336,29,406,"2019","074"
"29089","SAN MAURO TORINESE",7,0,0,7,"2019","249"
"29090","SAN MICHELE AL TAGLIAMENTO",3015,45,0,3060,"2019","034"
"29091","SAN MICHELE MONDOVI'",174,0,0,174,"2019","210"
"29092","SAN NAZZARO SESIA",120,0,0,120,"2019","134"
"29093","SAN NAZZARO VAL CAVARGNA",3,0,5,8,"2019","207"
"29094","SAN NICOLO' DI COMELICO",6,16,0,22,"2019","046"
"29095","SAN PAOLO",366,2589,27,2982,"2019","138"
"29096","SAN PAOLO D'ARGON",27,7,0,34,"2019","189"
"29097","SAN PAOLO SOLBRITO",22,0,0,22,"2019","101"
"29098","SAN PELLEGRINO TERME",56,36,0,92,"2019","190"
"29099","SAN PIETRO DI CADORE",0,79,0,79,"2019","047"
"29100","SAN PIETRO DI FELETTO",16,12,0,28,"2019","073"
"29101","SAN PIETRO DI MORUBIO",2,0,0,2,"2019","075"
"29102","SAN PIETRO IN CASALE",18,427,0,445,"2019","055"
"29103","SAN PIETRO IN CERRO",94,993,0,1087,"2019","041"
"29104","SAN PIETRO IN GU",719,3188,0,3907,"2019","078"
"29105","SAN PIETRO MOSEZZO",7,0,0,7,"2019","135"
"29106","SAN PIETRO MUSSOLINO",7,0,0,7,"2019","094"
"29107","SAN PIETRO VAL LEMINA",6,0,0,6,"2019","250"
"29108","SAN PIETRO VIMINARIO",139,23,0,162,"2019","079"
"29109","SAN POLO D'ENZA",0,578,0,578,"2019","038"
"29110","SAN POLO DI PIAVE",886,57,0,943,"2019","074"
"29111","SAN PONSO",2,35,0,37,"2019","251"
"29112","SAN POSSIDONIO",0,404,0,404,"2019","038"
"29113","SAN PROSPERO",0,329,0,329,"2019","039"
"29114","SAN RAFFAELE CIMENA",49,0,0,49,"2019","252"
"29115","SAN ROCCO AL PORTO",179,724,0,903,"2019","049"
"29116","SAN SALVATORE MONFERRATO",178,0,0,178,"2019","154"
"29117","SAN SEBASTIANO CURONE",11,0,0,11,"2019","155"
"29118","SAN SEBASTIANO DA PO",282,0,0,282,"2019","253"
"29119","SAN SECONDO DI PINEROLO",528,26,70,624,"2019","254"
"29120","SAN SECONDO PARMENSE",0,1457,0,1457,"2019","033"
"29121","SAN SIRO",0,0,7,7,"2019","248"
"29122","SAN VENDEMIANO",62,121,0,183,"2019","076"
"29123","SAN VITO DI CADORE",1,0,0,1,"2019","051"
"29124","SAN VITO DI LEGUZZANO",201,150,0,351,"2019","096"
"29125","SAN VITTORE OLONA",18,41,0,59,"2019","201"
"29126","SAN ZENO DI MONTAGNA",170,158,34,362,"2019","079"
"29127","SAN ZENO NAVIGLIO",0,500,0,500,"2019","173"
"29128","SAN ZENONE AL LAMBRO",0,807,0,807,"2019","202"
"29129","SAN ZENONE DEGLI EZZELINI",2734,432,9,3175,"2019","077"
"29130","SANDIGLIANO",61,97,0,158,"2019","059"
"29131","SANDRIGO",1422,1684,0,3106,"2019","091"
"29132","SANFRE'",637,0,7,644,"2019","208"
"29133","SANFRONT",2247,138,58,2443,"2019","209"
"29134","SANGANO",51,0,18,69,"2019","241"
"29135","SANGIANO",0,37,0,37,"2019","141"
"29136","SANGUINETTO",4,212,0,216,"2019","072"
"29137","SANNAZZARO DE' BURGONDI",20,51,0,71,"2019","138"
"29138","SANT'AGATA BOLOGNESE",4,707,0,711,"2019","056"
"29139","SANT'AGATA FELTRIA",210,40,0,250,"2019","026"
"29140","SANT'AGATA FOSSILI",80,0,0,80,"2019","156"
"29141","SANT'AGATA SUL SANTERNO",16,0,0,16,"2019","017"
"29142","SANT'ALBANO STURA",4566,822,20,5408,"2019","211"
"29143","SANT'AMBROGIO DI TORINO",54,15,23,92,"2019","255"
"29144","SANT'AMBROGIO DI VALPOLICELLA",3,52,0,55,"2019","077"
"29145","SANT'ANGELO DI PIOVE DI SACCO",321,50,0,371,"2019","082"
"29146","SANT'ANGELO LODIGIANO",61,327,0,388,"2019","050"
"29147","SANT'ANGELO LOMELLINA",0,428,0,428,"2019","144"
"29148","SANT'ANNA D'ALFAEDO",210,1292,128,1630,"2019","078"
"29149","SANT'ANTONINO DI SUSA",11,43,25,79,"2019","256"
"29150","SANT'ELENA",57,0,0,57,"2019","083"
"29151","SANT'ILARIO D'ENZA",2,693,0,695,"2019","039"
"29152","SANT'OMOBONO TERME",89,43,0,132,"2019","192"
"29153","SANT'URBANO",735,0,0,735,"2019","084"
"29154","SANTA BRIGIDA",10,28,0,38,"2019","191"
"29155","SANTA CRISTINA E BISSONE",25,145,0,170,"2019","139"
"29156","SANTA GIULETTA",10,0,0,10,"2019","140"
"29157","SANTA GIUSTINA",128,115,0,243,"2019","048"
"29158","SANTA GIUSTINA IN COLLE",1497,295,2,1794,"2019","080"
"29159","SANTA LUCIA DI PIAVE",23,51,9,83,"2019","075"
"29160","SANTA MARGHERITA DI STAFFORA",23,0,34,57,"2019","142"
"29161","SANTA MARIA DELLA VERSA",1,0,0,1,"2019","143"
"29162","SANTA MARIA DI SALA",64,172,15,251,"2019","035"
"29163","SANTA MARIA HOE'",8,0,0,8,"2019","074"
"29164","SANTA MARIA MAGGIORE",15,0,27,42,"2019","062"
"29165","SANTA SOFIA",255,0,0,255,"2019","043"
"29166","SANTA VITTORIA D'ALBA",51,0,0,51,"2019","212"
"29167","SANTARCANGELO DI ROMAGNA",35,0,0,35,"2019","018"
"29168","SANTENA",437,0,0,437,"2019","257"
"29169","SANTHIA'",310,28,0,338,"2019","133"
"29170","SANTO STEFANO BELBO",5,0,0,5,"2019","213"
"29171","SANTO STEFANO DI CADORE",3,11,0,14,"2019","050"
"29172","SANTO STEFANO LODIGIANO",77,355,0,432,"2019","051"
"29173","SANTO STEFANO ROERO",61,0,0,61,"2019","214"
"29174","SANTO STEFANO TICINO",0,25,0,25,"2019","200"
"29175","SANTO STINO DI LIVENZA",3975,82,1,4058,"2019","036"
"29176","SANTORSO",435,172,0,607,"2019","095"
"29177","SAONARA",260,0,0,260,"2019","085"
"29178","SARCEDO",1586,351,0,1937,"2019","097"
"29179","SARDIGLIANO",1,0,0,1,"2019","157"
"29180","SAREGO",344,24,0,368,"2019","098"
"29181","SAREZZO",8,26,0,34,"2019","174"
"29182","SARMATO",1,288,0,289,"2019","042"
"29183","SARMEDE",40,14,36,90,"2019","078"
"29184","SARNICO",5,0,0,5,"2019","193"
"29185","SARONNO",0,0,3,3,"2019","119"
"29186","SARSINA",202,3,0,205,"2019","044"
"29187","SASSO MARCONI",52,26,0,78,"2019","057"
"29188","SASSUOLO",28,392,0,420,"2019","040"
"29189","SAUZE D'OULX",69,0,0,69,"2019","259"
"29190","SAUZE DI CESANA",18,0,0,18,"2019","258"
"29191","SAVIGLIANO",11201,4958,182,16341,"2019","215"
"29192","SAVIGNANO SUL PANARO",38,73,0,111,"2019","041"
"29193","SAVIGNANO SUL RUBICONE",42,0,0,42,"2019","045"
"29194","SAVIORE DELL'ADAMELLO",2,36,5,43,"2019","175"
"29195","SCAGNELLO",197,0,0,197,"2019","216"
"29196","SCALDASOLE",8,20,0,28,"2019","147"
"29197","SCALENGHE",1797,2101,237,4135,"2019","260"
"29198","SCANDIANO",10,1196,0,1206,"2019","040"
"29199","SCANDOLARA RAVARA",0,821,0,821,"2019","092"
"29200","SCANDOLARA RIPA D'OGLIO",29,656,14,699,"2019","093"
"29201","SCANZOROSCIATE",31,0,0,31,"2019","194"
"29202","SCARMAGNO",6,0,0,6,"2019","261"
"29203","SCARNAFIGI",1181,1675,46,2902,"2019","217"
"29204","SCHIAVON",1362,1748,0,3110,"2019","099"
"29205","SCHIGNANO",18,3,4,25,"2019","211"
"29206","SCHILPARIO",0,66,0,66,"2019","195"
"29207","SCHIO",351,265,3,619,"2019","100"
"29208","SCIOLZE",169,0,0,169,"2019","262"
"29209","SCOPELLO",36,7,0,43,"2019","135"
"29210","SCORZE'",4242,40,0,4282,"2019","037"
"29211","SECUGNAGO",0,1235,0,1235,"2019","052"
"29212","SEDICO",1416,110,0,1526,"2019","053"
"29213","SEDRIANO",13,813,0,826,"2019","204"
"29214","SEDRINA",29,16,0,45,"2019","196"
"29215","SEGRATE",9,0,0,9,"2019","205"
"29216","SEGUSINO",8,70,0,78,"2019","079"
"29217","SELLERO",3,25,8,36,"2019","176"
"29218","SELVA DI CADORE",0,4,0,4,"2019","054"
"29219","SELVA DI PROGNO",35,509,81,625,"2019","080"
"29220","SELVAZZANO DENTRO",3,0,53,56,"2019","086"
"29221","SELVINO",2,0,0,2,"2019","197"
"29222","SEMIANA",1,0,0,1,"2019","148"
"29223","SENIGA",1453,2073,0,3526,"2019","177"
"29224","SENNA COMASCO",3,0,19,22,"2019","212"
"29225","SENNA LODIGIANA",5,991,0,996,"2019","053"
"29226","SEREGNO",7,0,0,7,"2019",NA
"29227","SEREN DEL GRAPPA",91,54,181,326,"2019","055"
"29228","SERGNANO",0,1616,13,1629,"2019","094"
"29229","SERIATE",110,90,3,203,"2019","198"
"29230","SERINA",19,97,0,116,"2019","199"
"29231","SERLE",13,40,25,78,"2019","178"
"29232","SERMIDE E FELONICA",1,183,134,318,"2019",NA
"29233","SERNAGLIA DELLA BATTAGLIA",943,0,5,948,"2019","080"
"29234","SERNIO",2,0,0,2,"2019","059"
"29235","SEROLE",71,0,4,75,"2019","104"
"29236","SERRALUNGA D'ALBA",18,0,0,18,"2019","218"
"29237","SERRALUNGA DI CREA",19,0,0,19,"2019","159"
"29238","SERRAMAZZONI",19,1605,0,1624,"2019","042"
"29239","SERRAVALLE A PO",79,0,206,285,"2019","062"
"29240","SERRAVALLE LANGHE",108,0,0,108,"2019","219"
"29241","SERRAVALLE SCRIVIA",13,0,0,13,"2019","160"
"29242","SERRAVALLE SESIA",1,0,0,1,"2019","137"
"29243","SESTO CALENDE",23,0,1,24,"2019","120"
"29244","SESTO ED UNITI",6,1754,341,2101,"2019","095"
"29245","SESTOLA",68,359,0,427,"2019","043"
"29246","SETTALA",39,268,66,373,"2019","210"
"29247","SETTIME",162,0,0,162,"2019","106"
"29248","SETTIMO MILANESE",0,302,6,308,"2019","211"
"29249","SETTIMO ROTTARO",1,34,0,35,"2019","264"
"29250","SETTIMO TORINESE",395,285,147,827,"2019","265"
"29251","SETTIMO VITTONE",151,138,4,293,"2019","266"
"29252","SEVESO",1,0,0,1,"2019",NA
"29253","SEZZADIO",71,0,0,71,"2019","161"
"29254","SILEA",4,96,0,100,"2019","081"
"29255","SILLAVENGO",27,113,0,140,"2019","138"
"29256","SILVANO D'ORBA",6,0,0,6,"2019","162"
"29257","SILVANO PIETRA",1,0,0,1,"2019",NA
"29258","SINIO",11,4,0,15,"2019","220"
"29259","SIRONE",6,108,1,115,"2019","075"
"29260","SIRTORI",5,0,0,5,"2019","076"
"29261","SISSA TRECASALI",18,933,0,951,"2019",NA
"29262","SIZIANO",57,69,0,126,"2019","150"
"29263","SIZZANO",208,1,100,309,"2019","139"
"29264","SOAVE",93,0,0,93,"2019","081"
"29265","SOGLIANO AL RUBICONE",202,53,0,255,"2019","046"
"29266","SOIANO DEL LAGO",0,0,7,7,"2019","180"
"29267","SOLAGNA",0,11,0,11,"2019","101"
"29268","SOLARO",0,19,0,19,"2019","213"
"29269","SOLAROLO RAINERIO",13,276,0,289,"2019","096"
"29270","SOLBIATE CON CAGNO",5,138,0,143,"2019",NA
"29271","SOLERO",274,0,0,274,"2019","163"
"29272","SOLFERINO",592,224,218,1034,"2019","063"
"29273","SOLIERA",28,1113,0,1141,"2019","044"
"29274","SOLIGNANO",11,214,0,225,"2019","035"
"29275","SOLONGHELLO",107,0,0,107,"2019","164"
"29276","SOLTO COLLINA",17,0,0,17,"2019","200"
"29277","SOMAGLIA",0,1264,0,1264,"2019","054"
"29278","SOMANO",73,0,0,73,"2019","221"
"29279","SOMMA LOMBARDO",25,11,30,66,"2019","123"
"29280","SOMMACAMPAGNA",1673,426,42,2141,"2019","082"
"29281","SOMMARIVA DEL BOSCO",1245,560,163,1968,"2019","222"
"29282","SOMMARIVA PERNO",21,0,0,21,"2019","223"
"29283","SOMMO",15,0,0,15,"2019","151"
"29284","SONA",2628,628,11,3267,"2019","083"
"29285","SONCINO",640,4700,539,5879,"2019","097"
"29286","SONDALO",23,74,11,108,"2019","060"
"29287","SONDRIO",17,35,0,52,"2019","061"
"29288","SONGAVAZZO",1,0,0,1,"2019","201"
"29289","SONICO",2,86,13,101,"2019","181"
"29290","SORAGNA",4,1507,0,1511,"2019","036"
"29291","SORBOLO MEZZANI",1,1776,0,1777,"2019",NA
"29292","SORDEVOLO",87,29,0,116,"2019","063"
"29293","SORDIO",0,258,0,258,"2019","055"
"29294","SORESINA",51,1271,40,1362,"2019","098"
"29295","SORGA'",1729,44,0,1773,"2019","084"
"29296","SORICO",4,16,91,111,"2019","216"
"29297","SORISO",12,0,0,12,"2019","140"
"29298","SORISOLE",48,60,0,108,"2019","202"
"29299","SORMANO",22,0,0,22,"2019","217"
"29300","SOSPIRO",76,375,0,451,"2019","099"
"29301","SOSPIROLO",8,92,0,100,"2019","056"
"29302","SOSSANO",20,351,0,371,"2019","102"
"29303","SOSTEGNO",3,24,0,27,"2019","064"
"29304","SOTTO IL MONTE GIOVANNI XXIII",44,0,1,45,"2019","203"
"29305","SOVERE",54,31,0,85,"2019","204"
"29306","SOVERZENE",4,0,0,4,"2019","057"
"29307","SOVICO",1,0,0,1,"2019",NA
"29308","SOVIZZO",439,102,0,541,"2019","103"
"29309","SOVRAMONTE",7,67,0,74,"2019","058"
"29310","SOZZAGO",1,0,0,1,"2019","141"
"29311","SPARONE",30,52,3,85,"2019","267"
"29312","SPESSA",6,0,0,6,"2019","152"
"29313","SPIGNO MONFERRATO",142,13,60,215,"2019","165"
"29314","SPILAMBERTO",1951,1370,0,3321,"2019","045"
"29315","SPINEA",25,99,0,124,"2019","038"
"29316","SPINEDA",8,661,0,669,"2019","101"
"29317","SPINETO SCRIVIA",126,0,0,126,"2019","166"
"29318","SPINO D'ADDA",799,2208,0,3007,"2019","102"
"29319","SPINONE AL LAGO",3,1,0,4,"2019","205"
"29320","SPIRANO",12,1122,0,1134,"2019","206"
"29321","SPRESIANO",30,198,0,228,"2019","082"
"29322","STAGNO LOMBARDO",3,6572,92,6667,"2019","103"
"29323","STANGHELLA",352,0,0,352,"2019","088"
"29324","STAZZANO",23,0,0,23,"2019","167"
"29325","STAZZONA",6,6,2,14,"2019","218"
"29326","STEZZANO",182,332,202,716,"2019","207"
"29327","STIENTA",68,0,2,70,"2019","045"
"29328","STRA",1,0,0,1,"2019","039"
"29329","STRADELLA",10,36,0,46,"2019","153"
"29330","STRAMBINELLO",20,0,0,20,"2019",NA
"29331","STRAMBINO",181,0,0,181,"2019","269"
"29332","STRESA",72,0,0,72,"2019","064"
"29333","STREVI",26,0,0,26,"2019","168"
"29334","STROPPO",6,0,0,6,"2019","224"
"29335","STROZZA",8,0,0,8,"2019","208"
"29336","SUARDI",4,0,0,4,"2019","154"
"29337","SUEGLIO",1,0,0,1,"2019","077"
"29338","SUELLO",4,0,8,12,"2019","078"
"29339","SUISIO",2,109,0,111,"2019","209"
"29340","SULBIATE",46,0,0,46,"2019",NA
"29341","SULZANO",36,251,4,291,"2019","182"
"29342","SUMIRAGO",51,87,0,138,"2019","124"
"29343","SUNO",55,432,0,487,"2019","143"
"29344","SUSA",165,26,0,191,"2019","270"
"29345","SUSEGANA",772,53,0,825,"2019","083"
"29346","SUSTINENTE",645,586,257,1488,"2019","064"
"29347","SUZZARA",1897,1153,2075,5125,"2019","065"
"29348","TACENO",20,0,6,26,"2019","079"
"29349","TAGLIO DI PO",7693,0,0,7693,"2019","046"
"29350","TAGLIOLO MONFERRATO",57,0,0,57,"2019","169"
"29351","TAIBON AGORDINO",0,28,0,28,"2019","059"
"29352","TAINO",32,131,0,163,"2019","125"
"29353","TALAMELLO",1,0,0,1,"2019","027"
"29354","TALAMONA",5,152,25,182,"2019","063"
"29355","TALEGGIO",96,19,0,115,"2019","210"
"29356","TAMBRE",16,116,0,132,"2019","060"
"29357","TARANTASCA",1831,675,0,2506,"2019","225"
"29358","TARTANO",20,13,0,33,"2019","064"
"29359","TARZO",14,13,0,27,"2019","084"
"29360","TAVAGNASCO",125,6,0,131,"2019","271"
"29361","TAVAZZANO CON VILLAVESCO",0,1138,100,1238,"2019","056"
"29362","TAVERNERIO",1,0,0,1,"2019","222"
"29363","TAVERNOLA BERGAMASCA",5,4,0,9,"2019","211"
"29364","TAVERNOLE SUL MELLA",9,40,10,59,"2019","183"
"29365","TAVIGLIANO",59,0,0,59,"2019","066"
"29366","TEGLIO",45,198,39,282,"2019","065"
"29367","TELGATE",1706,169,0,1875,"2019","212"
"29368","TEMU'",2,6,3,11,"2019","184"
"29369","TEOLO",43,28,0,71,"2019","089"
"29370","TERDOBBIATE",3,135,0,138,"2019","144"
"29371","TERENZO",55,695,0,750,"2019","038"
"29372","TERNO D'ISOLA",8,25,0,33,"2019","213"
"29373","TERRANOVA DEI PASSERINI",28,305,255,588,"2019","057"
"29374","TERRASSA PADOVANA",1661,0,0,1661,"2019","090"
"29375","TERRAZZO",0,20,0,20,"2019","085"
"29376","TERRUGGIA",26,0,0,26,"2019","171"
"29377","TERZO",24,0,0,24,"2019","172"
"29378","TEZZE SUL BRENTA",69,196,0,265,"2019","104"
"29379","THIENE",279,386,0,665,"2019","105"
"29380","TICENGO",0,405,0,405,"2019","104"
"29381","TIGLIOLE",952,0,0,952,"2019","108"
"29382","TIGNALE",6,0,4,10,"2019","185"
"29383","TIRANO",5,0,16,21,"2019","066"
"29384","TIZZANO VAL PARMA",2,709,0,711,"2019","039"
"29385","TOANO",50,1857,0,1907,"2019","041"
"29386","TOCENO",34,7,7,48,"2019","065"
"29387","TOLLEGNO",24,0,0,24,"2019","068"
"29388","TOMBOLO",840,16,0,856,"2019","091"
"29389","TONCO",730,0,0,730,"2019","109"
"29390","TONENGO",87,0,0,87,"2019","110"
"29391","TONEZZA DEL CIMONE",2,0,0,2,"2019","106"
"29392","TORBOLE CASAGLIA",8,857,0,865,"2019","186"
"29393","TORINO",154,0,24,178,"2019","272"
"29394","TORLINO VIMERCATI",5,321,0,326,"2019","105"
"29395","TORNACO",0,87,0,87,"2019",NA
"29396","TORNATA",0,171,0,171,"2019","106"
"29397","TORNOLO",62,4,0,66,"2019","040"
"29398","TORRAZZA COSTE",5,0,0,5,"2019","155"
"29399","TORRAZZA PIEMONTE",158,0,0,158,"2019","273"
"29400","TORRAZZO",7,0,0,7,"2019","069"
"29401","TORRE BERETTI E CASTELLARO",15,359,0,374,"2019","156"
"29402","TORRE BOLDONE",4,0,0,4,"2019","214"
"29403","TORRE BORMIDA",7,0,3,10,"2019","226"
"29404","TORRE D'ISOLA",0,636,0,636,"2019","159"
"29405","TORRE DE' BUSI",9,0,0,9,"2019","080"
"29406","TORRE DE' NEGRI",18,45,263,326,"2019","158"
"29407","TORRE DE' PICENARDI",109,2807,85,3001,"2019","107"
"29408","TORRE DE' ROVERI",16,0,0,16,"2019","216"
"29409","TORRE DI MOSTO",9,534,0,543,"2019","041"
"29410","TORRE DI SANTA MARIA",13,8,7,28,"2019","067"
"29411","TORRE PALLAVICINA",246,294,0,540,"2019","217"
"29412","TORRE PELLICE",90,0,0,90,"2019","275"
"29413","TORRE SAN GIORGIO",89,7,21,117,"2019","228"
"29414","TORREBELVICINO",982,8,0,990,"2019","107"
"29415","TORREGLIA",2,0,0,2,"2019","092"
"29416","TORRESINA",3,0,0,3,"2019","229"
"29417","TORREVECCHIA PIA",66,11,18,95,"2019","160"
"29418","TORRI DEL BENACO",5,0,0,5,"2019",NA
"29419","TORRI DI QUARTESOLO",40,153,0,193,"2019","108"
"29420","TORRICELLA VERZATE",2,0,0,2,"2019",NA
"29421","TORRILE",0,2592,0,2592,"2019","041"
"29422","TORTONA",2529,307,0,2836,"2019","174"
"29423","TOSCOLANO-MADERNO",5,0,0,5,"2019","187"
"29424","TOVO DI SANT'AGATA",3,66,0,69,"2019","068"
"29425","TRADATE",26,0,0,26,"2019","127"
"29426","TRANA",48,2,18,68,"2019","276"
"29427","TRAONA",56,80,97,233,"2019","069"
"29428","TRAREGO VIGGIONA",4,0,0,4,"2019","066"
"29429","TRASQUERA",15,0,7,22,"2019","067"
"29430","TRAVAGLIATO",482,514,0,996,"2019","188"
"29431","TRAVEDONA-MONATE",7,0,12,19,"2019","128"
"29432","TRAVERSELLA",54,22,5,81,"2019","278"
"29433","TRAVERSETOLO",57,1109,0,1166,"2019","042"
"29434","TRAVES",4,0,0,4,"2019","279"
"29435","TRAVO",48,23,0,71,"2019","043"
"29436","TREBASELEGHE",8217,97,0,8314,"2019","093"
"29437","TRECATE",3,228,0,231,"2019","149"
"29438","TRECENTA",3,141,0,144,"2019","047"
"29439","TREDOZIO",116,0,0,116,"2019","049"
"29440","TREGNAGO",372,130,0,502,"2019","087"
"29441","TREMEZZINA",20,13,39,72,"2019",NA
"29442","TREMOSINE",17,417,52,486,"2019","189"
"29443","TRENZANO",854,1399,138,2391,"2019","190"
"29444","TRESCORE BALNEARIO",46,64,14,124,"2019","218"
"29445","TRESCORE CREMASCO",30,414,249,693,"2019","109"
"29446","TRESIGNANA",1,0,0,1,"2019",NA
"29447","TRESIVIO",10,9,0,19,"2019","070"
"29448","TREVENZUOLO",247,1081,0,1328,"2019","088"
"29449","TREVIGLIO",1058,1610,6,2674,"2019","219"
"29450","TREVIGNANO",2119,145,9,2273,"2019","085"
"29451","TREVILLE",17,0,0,17,"2019","175"
"29452","TREVIOLO",111,116,0,227,"2019","220"
"29453","TREVISO",446,110,19,575,"2019","086"
"29454","TREVISO BRESCIANO",3,43,5,51,"2019","191"
"29455","TREZZO SULL'ADDA",0,449,0,449,"2019","221"
"29456","TREZZO TINELLA",13,0,0,13,"2019","231"
"29457","TREZZONE",1,0,3,4,"2019","226"
"29458","TRIBANO",3,0,0,3,"2019","094"
"29459","TRIBIANO",0,46,0,46,"2019","222"
"29460","TRIGOLO",0,1450,0,1450,"2019","110"
"29461","TRINITA'",2574,460,382,3416,"2019","232"
"29462","TRINO",5,178,0,183,"2019","148"
"29463","TRISOBBIO",60,0,0,60,"2019","176"
"29464","TRISSINO",82,278,0,360,"2019","110"
"29465","TRIUGGIO",29,286,0,315,"2019",NA
"29466","TROFARELLO",602,57,0,659,"2019","280"
"29467","TROMELLO",18,229,244,491,"2019","164"
"29468","TRONTANO",14,26,0,40,"2019","068"
"29469","TRONZANO VERCELLESE",159,0,0,159,"2019","150"
"29470","TROVO",6,44,0,50,"2019","165"
"29471","TRUCCAZZANO",72,1944,0,2016,"2019","224"
"29472","TURANO LODIGIANO",58,2049,0,2107,"2019","058"
"29473","TURBIGO",0,48,0,48,"2019","226"
"29474","UBIALE CLANEZZO",7,0,0,7,"2019","221"
"29475","UBOLDO",5,0,0,5,"2019","130"
"29476","UGGIATE-TREVANO",19,65,10,94,"2019","228"
"29477","URAGO D'OGLIO",409,1084,0,1493,"2019","192"
"29478","URBANA",719,0,0,719,"2019","095"
"29479","URGNANO",147,198,0,345,"2019","222"
"29480","USMATE VELATE",6,36,1,43,"2019",NA
"29481","USSEAUX",20,33,37,90,"2019","281"
"29482","USSEGLIO",2,0,0,2,"2019","282"
"29483","VAIANO CREMASCO",9,479,167,655,"2019","111"
"29484","VAIE",0,9,53,62,"2019","283"
"29485","VAILATE",10,286,2,298,"2019","112"
"29486","VAL BREMBILLA",73,45,8,126,"2019",NA
"29487","VAL DELLA TORRE",264,0,19,283,"2019","284"
"29488","VAL DI CHY",28,0,0,28,"2019",NA
"29489","VAL DI NIZZA",1,0,0,1,"2019","166"
"29490","VAL DI ZOLDO",22,6,0,28,"2019",NA
"29491","VAL LIONA",361,247,0,608,"2019",NA
"29492","VAL MASINO",1,5,0,6,"2019","074"
"29493","VAL REZZO",15,0,10,25,"2019","233"
"29494","VALBONDIONE",1,16,0,17,"2019","223"
"29495","VALBREMBO",84,0,0,84,"2019","224"
"29496","VALBRENTA",40,34,2,76,"2019",NA
"29497","VALBRONA",3,0,6,9,"2019","229"
"29498","VALCHIUSA",140,139,3,282,"2019",NA
"29499","VALDAGNO",38,154,0,192,"2019","111"
"29500","VALDASTICO",819,15,0,834,"2019","112"
"29501","VALDENGO",9,49,0,58,"2019","071"
"29502","VALDIDENTRO",27,116,33,176,"2019","071"
"29503","VALDIERI",6,0,0,6,"2019","233"
"29504","VALDILANA",60,57,18,135,"2019",NA
"29505","VALDISOTTO",24,122,14,160,"2019","072"
"29506","VALDOBBIADENE",95,290,2,387,"2019","087"
"29507","VALDUGGIA",9,0,0,9,"2019","152"
"29508","VALEGGIO",32,0,0,32,"2019","167"
"29509","VALEGGIO SUL MINCIO",2228,2358,51,4637,"2019","089"
"29510","VALENZA",85,0,0,85,"2019","177"
"29511","VALERA FRATTA",208,282,0,490,"2019","059"
"29512","VALFENERA",979,108,234,1321,"2019","112"
"29513","VALFURVA",15,98,9,122,"2019","073"
"29514","VALGANNA",25,0,0,25,"2019","131"
"29515","VALGOGLIO",14,42,0,56,"2019","225"
"29516","VALGRANA",367,0,0,367,"2019","234"
"29517","VALGREGHENTINO",4,0,0,4,"2019","082"
"29518","VALLADA AGORDINA",0,4,0,4,"2019","062"
"29519","VALLE LOMELLINA",14,806,0,820,"2019","168"
"29520","VALLE SALIMBENE",0,24,0,24,"2019","169"
"29521","VALLE SAN NICOLAO",6,0,0,6,"2019","074"
"29522","VALLEVE",0,6,0,6,"2019","226"
"29523","VALLI DEL PASUBIO",0,7,2,9,"2019","113"
"29524","VALLIO TERME",7,0,0,7,"2019","193"
"29525","VALLO TORINESE",15,0,0,15,"2019","286"
"29526","VALMADRERA",19,0,2,21,"2019","083"
"29527","VALMOREA",1,30,0,31,"2019","232"
"29528","VALMOZZOLA",45,25,0,70,"2019","044"
"29529","VALPERGA",175,133,14,322,"2019","287"
"29530","VALSAMOGGIA",315,854,0,1169,"2019",NA
"29531","VALSOLDA",4,4,2,10,"2019","234"
"29532","VALSTRONA",14,0,0,14,"2019","069"
"29533","VALTORTA",0,36,0,36,"2019","229"
"29534","VALVARRONE",0,0,1,1,"2019",NA
"29535","VALVESTINO",4,6,0,10,"2019","194"
"29536","VANZAGO",44,0,0,44,"2019","229"
"29537","VAPRIO D'ADDA",16,378,0,394,"2019","230"
"29538","VARALLO",20,54,0,74,"2019","156"
"29539","VARANO DE' MELEGARI",50,361,0,411,"2019","045"
"29540","VARESE",75,107,0,182,"2019","133"
"29541","VARISELLA",132,0,0,132,"2019","289"
"29542","VARSI",12,397,0,409,"2019","046"
"29543","VARZI",84,1,0,85,"2019","171"
"29544","VARZO",8,11,6,25,"2019","071"
"29545","VAUDA CANAVESE",53,0,0,53,"2019","290"
"29546","VAZZOLA",1305,88,3,1396,"2019","088"
"29547","VEDANO OLONA",3,211,0,214,"2019","134"
"29548","VEDELAGO",19144,414,111,19669,"2019","089"
"29549","VEDESETA",6,101,0,107,"2019","230"
"29550","VEGGIANO",302,88,32,422,"2019","096"
"29551","VEGLIO",16,3,0,19,"2019","075"
"29552","VELESO",0,0,13,13,"2019","236"
"29553","VELLEZZO BELLINI",23,522,0,545,"2019","173"
"29554","VELO D'ASTICO",754,17,0,771,"2019","115"
"29555","VELO VERONESE",431,1475,42,1948,"2019","090"
"29556","VENARIA REALE",40,20,251,311,"2019","292"
"29557","VENASCA",51,0,0,51,"2019","237"
"29558","VENAUS",37,28,6,71,"2019","291"
"29559","VENDROGNO",8,1,1,10,"2019","085"
"29560","VENEGONO INFERIORE",0,82,0,82,"2019","136"
"29561","VENEGONO SUPERIORE",17,3,0,20,"2019","137"
"29562","VENEZIA",1568,175,0,1743,"2019","042"
"29563","VENIANO",50,74,0,124,"2019","238"
"29564","VENTASSO",78,301,0,379,"2019",NA
"29565","VERANO BRIANZA",1,0,0,1,"2019",NA
"29566","VERBANIA",79,0,3,82,"2019","072"
"29567","VERCANA",7,7,0,14,"2019","239"
"29568","VERCEIA",7,0,6,13,"2019","075"
"29569","VERCELLI",82,218,0,300,"2019","158"
"29570","VERDELLINO",0,78,0,78,"2019","232"
"29571","VERDELLO",241,43,0,284,"2019","233"
"29572","VERDERIO",2,0,53,55,"2019",NA
"29573","VERDUNO",104,0,0,104,"2019","238"
"29574","VERGATO",60,0,0,60,"2019","059"
"29575","VERGHERETO",559,0,0,559,"2019","050"
"29576","VERGIATE",19,0,0,19,"2019","138"
"29577","VERMEZZO CON ZELO",9,597,0,606,"2019",NA
"29578","VERNANTE",167,41,0,208,"2019","239"
"29579","VERNASCA",38,61,0,99,"2019","044"
"29580","VERNATE",7,79,0,86,"2019","236"
"29581","VEROLANUOVA",1272,2227,104,3603,"2019","195"
"29582","VEROLAVECCHIA",20,3280,601,3901,"2019","196"
"29583","VEROLENGO",390,136,0,526,"2019","293"
"29584","VERONA",3601,852,0,4453,"2019","091"
"29585","VERONELLA",5050,280,0,5330,"2019","092"
"29586","VERRETTO",3,0,0,3,"2019","174"
"29587","VERRONE",20,0,0,20,"2019","076"
"29588","VERRUA SAVOIA",542,0,0,542,"2019","294"
"29589","VERTEMATE CON MINOPRIO",3,0,0,3,"2019","242"
"29590","VERTOVA",15,38,0,53,"2019","234"
"29591","VERUCCHIO",171,0,0,171,"2019","020"
"29592","VERVIO",18,1,0,19,"2019","076"
"29593","VERZUOLO",1,0,0,1,"2019","240"
"29594","VESCOVANA",5,0,0,5,"2019","097"
"29595","VESCOVATO",144,668,558,1370,"2019","113"
"29596","VESIME",555,0,0,555,"2019","113"
"29597","VESPOLATE",25,91,0,116,"2019","158"
"29598","VESTENANOVA",555,198,0,753,"2019","093"
"29599","VESTIGNE'",6,99,0,105,"2019","295"
"29600","VESTONE",6,0,0,6,"2019","197"
"29601","VETTO",19,406,0,425,"2019","042"
"29602","VEZZA D'OGLIO",3,176,24,203,"2019","198"
"29603","VEZZANO SUL CROSTOLO",17,130,0,147,"2019","043"
"29604","VIADANA",27,1251,14,1292,"2019","066"
"29605","VIADANICA",24,32,0,56,"2019","235"
"29606","VIALE",297,0,0,297,"2019","114"
"29607","VIALFRE'",15,0,0,15,"2019","296"
"29608","VIANO",1,759,0,760,"2019","044"
"29609","VIARIGI",8,0,0,8,"2019","115"
"29610","VICENZA",190,812,0,1002,"2019","116"
"29611","VICOFORTE",492,0,0,492,"2019","242"
"29612","VIDIGULFO",2,321,0,323,"2019","176"
"29613","VIDOR",23,319,0,342,"2019","090"
"29614","VIDRACCO",3,0,0,3,"2019","298"
"29615","VIGANO SAN MARTINO",5,0,0,5,"2019","236"
"29616","VIGASIO",1009,494,0,1503,"2019","094"
"29617","VIGEVANO",51,43,12,106,"2019","177"
"29618","VIGGIU'",24,0,0,24,"2019","139"
"29619","VIGHIZZOLO D'ESTE",109,23,0,132,"2019","098"
"29620","VIGLIANO BIELLESE",3,1,0,4,"2019","077"
"29621","VIGLIANO D'ASTI",52,0,0,52,"2019","116"
"29622","VIGNALE MONFERRATO",240,0,0,240,"2019","179"
"29623","VIGNATE",0,329,0,329,"2019","237"
"29624","VIGNOLA",0,92,0,92,"2019","046"
"29625","VIGNOLE BORBERA",13,0,0,13,"2019","180"
"29626","VIGNOLO",1171,0,0,1171,"2019","243"
"29627","VIGNONE",1,0,0,1,"2019","074"
"29628","VIGO DI CADORE",3,13,0,16,"2019","065"
"29629","VIGODARZERE",304,82,0,386,"2019","099"
"29630","VIGOLO",12,182,0,194,"2019","237"
"29631","VIGOLZONE",54,446,0,500,"2019","045"
"29632","VIGONE",2931,1215,182,4328,"2019","299"
"29633","VIGONOVO",2,0,0,2,"2019","043"
"29634","VIGONZA",682,187,0,869,"2019","100"
"29635","VILLA BARTOLOMEA",160,0,0,160,"2019","095"
"29636","VILLA CARCINA",2,0,0,2,"2019","199"
"29637","VILLA CORTESE",121,0,0,121,"2019","248"
"29638","VILLA D'ADDA",10,0,0,10,"2019","238"
"29639","VILLA D'ALME'",81,17,0,98,"2019","239"
"29640","VILLA D'OGNA",1,50,0,51,"2019","241"
"29641","VILLA DEL BOSCO",1,0,0,1,"2019","078"
"29642","VILLA DEL CONTE",670,736,4,1410,"2019","101"
"29643","VILLA DI CHIAVENNA",1,19,0,20,"2019","077"
"29644","VILLA DI SERIO",7,0,0,7,"2019","240"
"29645","VILLA DI TIRANO",5,122,70,197,"2019","078"
"29646","VILLA ESTENSE",311,0,0,311,"2019","102"
"29647","VILLA GUARDIA",160,0,0,160,"2019","245"
"29648","VILLA MINOZZO",39,809,0,848,"2019","045"
"29649","VILLA SAN SECONDO",6,0,0,6,"2019","119"
"29650","VILLACHIARA",551,1945,962,3458,"2019","200"
"29651","VILLADEATI",16,0,0,16,"2019","182"
"29652","VILLADOSE",210,2,89,301,"2019","048"
"29653","VILLADOSSOLA",15,0,0,15,"2019","075"
"29654","VILLAFALLETTO",2253,736,274,3263,"2019","244"
"29655","VILLAFRANCA D'ASTI",253,0,0,253,"2019","117"
"29656","VILLAFRANCA DI VERONA",8365,3384,103,11852,"2019","096"
"29657","VILLAFRANCA PADOVANA",716,1921,27,2664,"2019","103"
"29658","VILLAFRANCA PIEMONTE",2220,1898,394,4512,"2019","300"
"29659","VILLAGA",192,193,25,410,"2019","117"
"29660","VILLALVERNIA",2,0,0,2,"2019",NA
"29661","VILLAMARZANA",991,98,0,1089,"2019","049"
"29662","VILLAMIROGLIO",2,0,0,2,"2019","184"
"29663","VILLANOVA BIELLESE",478,0,0,478,"2019","079"
"29664","VILLANOVA CANAVESE",35,8,7,50,"2019","301"
"29665","VILLANOVA D'ARDENGHI",1,0,0,1,"2019","179"
"29666","VILLANOVA D'ASTI",3903,71,0,3974,"2019","118"
"29667","VILLANOVA DEL GHEBBO",32,0,0,32,"2019","050"
"29668","VILLANOVA DEL SILLARO",0,987,6,993,"2019","060"
"29669","VILLANOVA DI CAMPOSAMPIERO",24,9,9,42,"2019","104"
"29670","VILLANOVA MARCHESANA",0,64,0,64,"2019","051"
"29671","VILLANOVA MONDOVI'",1879,452,133,2464,"2019","245"
"29672","VILLANOVA MONFERRATO",0,93,0,93,"2019","185"
"29673","VILLANOVA SOLARO",260,571,7,838,"2019","246"
"29674","VILLANOVA SULL'ARDA",1,1571,0,1572,"2019","046"
"29675","VILLANTERIO",0,0,211,211,"2019","180"
"29676","VILLANUOVA SUL CLISI",4,0,0,4,"2019","201"
"29677","VILLAR DORA",69,0,18,87,"2019","303"
"29678","VILLAR FOCCHIARDO",10,26,68,104,"2019","305"
"29679","VILLAR PELLICE",209,45,14,268,"2019","306"
"29680","VILLAR PEROSA",9,0,7,16,"2019","307"
"29681","VILLAR SAN COSTANZO",307,204,6,517,"2019","247"
"29682","VILLARBASSE",255,18,0,273,"2019","302"
"29683","VILLARBOIT",2,0,0,2,"2019","163"
"29684","VILLAREGGIA",92,2,0,94,"2019","304"
"29685","VILLAROMAGNANO",42,0,0,42,"2019","186"
"29686","VILLASTELLONE",730,553,77,1360,"2019","308"
"29687","VILLATA",13,37,0,50,"2019","164"
"29688","VILLAVERLA",98,1295,0,1393,"2019","118"
"29689","VILLETTE",22,0,43,65,"2019","076"
"29690","VILLIMPENTA",652,0,90,742,"2019","068"
"29691","VILLONGO",7,0,0,7,"2019","242"
"29692","VILLORBA",118,0,6,124,"2019","091"
"29693","VILMINORE DI SCALVE",10,156,0,166,"2019","243"
"29694","VIMERCATE",3,55,0,58,"2019",NA
"29695","VINADIO",230,0,0,230,"2019","248"
"29696","VINCHIO",3,0,0,3,"2019","120"
"29697","VINOVO",444,179,31,654,"2019","309"
"29698","VINZAGLIO",10,45,0,55,"2019","164"
"29699","VIOLA",103,0,0,103,"2019","249"
"29700","VIONE",4,31,3,38,"2019","202"
"29701","VIRLE PIEMONTE",268,246,159,673,"2019","310"
"29702","VISANO",2323,420,26,2769,"2019","203"
"29703","VISCHE",10,0,0,10,"2019","311"
"29704","VISONE",48,0,0,48,"2019","187"
"29705","VISTARINO",27,0,0,27,"2019","181"
"29706","VISTRORIO",0,0,16,16,"2019","312"
"29707","VITTORIO VENETO",205,100,14,319,"2019","092"
"29708","VITTUONE",1,194,0,195,"2019","243"
"29709","VIU'",36,0,7,43,"2019","313"
"29710","VIVERONE",55,0,0,55,"2019","080"
"29711","VIZZOLO PREDABISSI",22,0,0,22,"2019","244"
"29712","VO'",79,73,0,152,"2019","105"
"29713","VOBARNO",39,70,6,115,"2019","204"
"29714","VOCCA",0,29,0,29,"2019","166"
"29715","VODO CADORE",0,0,21,21,"2019","066"
"29716","VOGHERA",47,0,0,47,"2019","182"
"29717","VOGHIERA",3,0,0,3,"2019","023"
"29718","VOGOGNA",13,6,0,19,"2019","077"
"29719","VOLONGO",40,0,0,40,"2019","114"
"29720","VOLPAGO DEL MONTELLO",1076,584,20,1680,"2019","093"
"29721","VOLPEDO",2,0,0,2,"2019","188"
"29722","VOLPIANO",282,167,39,488,"2019","314"
"29723","VOLTA MANTOVANA",3328,1118,1032,5478,"2019","070"
"29724","VOLTAGGIO",16,0,59,75,"2019","190"
"29725","VOLTIDO",0,356,0,356,"2019","115"
"29726","VOLVERA",1286,320,0,1606,"2019","315"
"29727","VOTTIGNASCO",1806,108,78,1992,"2019","250"
"29728","ZANDOBBIO",14,0,0,14,"2019","244"
"29729","ZANE'",273,157,0,430,"2019","119"
"29730","ZANICA",227,1260,0,1487,"2019","245"
"29731","ZAVATTARELLO",81,0,0,81,"2019","184"
"29732","ZECCONE",7,292,0,299,"2019","185"
"29733","ZELBIO",0,0,8,8,"2019","246"
"29734","ZELO BUON PERSICO",0,1185,0,1185,"2019","061"
"29735","ZEME",47,42,0,89,"2019","186"
"29736","ZENSON DI PIAVE",8,0,0,8,"2019","094"
"29737","ZERBOLO'",0,84,0,84,"2019","189"
"29738","ZERMEGHEDO",0,53,0,53,"2019","120"
"29739","ZERO BRANCO",342,147,9,498,"2019","095"
"29740","ZEVIO",4199,671,95,4965,"2019","097"
"29741","ZIANO PIACENTINO",87,0,0,87,"2019","048"
"29742","ZIBIDO SAN GIACOMO",47,402,56,505,"2019","247"
"29743","ZIMELLA",8764,589,0,9353,"2019","098"
"29744","ZIMONE",9,0,0,9,"2019",NA
"29745","ZINASCO",25,0,0,25,"2019","190"
"29746","ZOCCA",39,780,0,819,"2019","047"
"29747","ZOGNO",78,47,0,125,"2019","246"
"29748","ZOLA PREDOSA",16,226,0,242,"2019","060"
"29749","ZONE",4,29,0,33,"2019","205"
"29750","ZOPPE' DI CADORE",0,1,0,1,"2019",NA
"29751","ZOVENCEDO",7,0,0,7,"2019","121"
"29752","ZUBIENA",45,0,24,69,"2019","082"
"29753","ZUGLIANO",544,131,9,684,"2019","122"
"29754","ZUMAGLIA",28,0,0,28,"2019","083"
"29755","ABANO TERME",53,162,0,215,"2020","001"
"29756","ABBADIA CERRETO",0,1263,0,1263,"2020","001"
"29757","ABBADIA LARIANA",4,25,5,34,"2020","001"
"29758","ABBIATEGRASSO",55,1398,13,1466,"2020","002"
"29759","ACCEGLIO",138,0,0,138,"2020","001"
"29760","ACQUAFREDDA",1442,94,0,1536,"2020","001"
"29761","ACQUANEGRA CREMONESE",2,830,0,832,"2020","001"
"29762","ACQUANEGRA SUL CHIESE",1490,265,575,2330,"2020","001"
"29763","ACQUI TERME",202,0,0,202,"2020","001"
"29764","ADRARA SAN MARTINO",40,23,2,65,"2020","001"
"29765","ADRARA SAN ROCCO",12,0,0,12,"2020","002"
"29766","ADRIA",2718,254,0,2972,"2020","001"
"29767","ADRO",473,19,0,492,"2020","002"
"29768","AGAZZANO",76,430,0,506,"2020","001"
"29769","AGLIANO TERME",40,0,0,40,"2020","001"
"29770","AGLIE'",387,47,25,459,"2020","001"
"29771","AGNA",326,0,0,326,"2020","002"
"29772","AGNADELLO",0,1699,17,1716,"2020","002"
"29773","AGNOSINE",2,56,7,65,"2020","003"
"29774","AGORDO",7,10,0,17,"2020","001"
"29775","AGRATE CONTURBIA",47,0,0,47,"2020","001"
"29776","AGUGLIARO",352,1,0,353,"2020","001"
"29777","AICURZIO",8,46,0,54,"2020",NA
"29778","AILOCHE",0,5,0,5,"2020","001"
"29779","AIRASCA",790,610,0,1400,"2020","002"
"29780","AIRUNO",0,0,2,2,"2020","002"
"29781","AISONE",15,0,0,15,"2020","002"
"29782","ALA DI STURA",25,0,0,25,"2020","003"
"29783","ALAGNA VALSESIA",22,21,0,43,"2020","002"
"29784","ALANO DI PIAVE",410,60,0,470,"2020","002"
"29785","ALBA",747,0,0,747,"2020","003"
"29786","ALBAIRATE",27,586,0,613,"2020","005"
"29787","ALBANO SANT'ALESSANDRO",5,0,0,5,"2020","003"
"29788","ALBAREDO D'ADIGE",11426,178,0,11604,"2020","002"
"29789","ALBAREDO PER SAN MARCO",4,21,0,25,"2020","001"
"29790","ALBARETO",116,58,0,174,"2020","001"
"29791","ALBARETTO DELLA TORRE",29,0,0,29,"2020","004"
"29792","ALBAVILLA",2,0,0,2,"2020","003"
"29793","ALBERA LIGURE",31,0,0,31,"2020","002"
"29794","ALBESE CON CASSANO",0,0,3,3,"2020","004"
"29795","ALBETTONE",2151,625,34,2810,"2020","002"
"29796","ALBIANO D'IVREA",137,42,0,179,"2020","004"
"29797","ALBIATE",318,0,0,318,"2020",NA
"29798","ALBIGNASEGO",130,198,1,329,"2020","003"
"29799","ALBINEA",24,1058,0,1082,"2020","001"
"29800","ALBINO",69,48,19,136,"2020","004"
"29801","ALBIOLO",0,5,2,7,"2020","005"
"29802","ALBIZZATE",5,0,0,5,"2020","002"
"29803","ALBOSAGGIA",38,55,56,149,"2020","002"
"29804","ALBUGNANO",60,0,0,60,"2020","002"
"29805","ALBUZZANO",33,0,0,33,"2020","004"
"29806","ALESSANDRIA",10055,2272,0,12327,"2020","003"
"29807","ALFIANELLO",0,531,0,531,"2020","004"
"29808","ALFIANO NATTA",33,0,0,33,"2020","004"
"29809","ALFONSINE",50,0,0,50,"2020","001"
"29810","ALGUA",4,3,0,7,"2020","248"
"29811","ALICE BEL COLLE",1,0,0,1,"2020","005"
"29812","ALICE CASTELLO",896,28,0,924,"2020","004"
"29813","ALLEGHE",2,0,0,2,"2020","003"
"29814","ALLUVIONI PIOVERA",138,151,0,289,"2020",NA
"29815","ALME'",1,0,0,1,"2020","005"
"29816","ALMENNO SAN BARTOLOMEO",37,3,1,41,"2020","006"
"29817","ALMENNO SAN SALVATORE",4,0,0,4,"2020","007"
"29818","ALMESE",53,29,0,82,"2020","006"
"29819","ALONTE",765,14,0,779,"2020","003"
"29820","ALPAGO",21,206,0,227,"2020",NA
"29821","ALPIGNANO",360,62,54,476,"2020","008"
"29822","ALSENO",94,849,0,943,"2020","002"
"29823","ALSERIO",4,0,0,4,"2020","006"
"29824","ALTA VAL TIDONE",558,195,0,753,"2020",NA
"29825","ALTA VALLE INTELVI",44,36,6,86,"2020",NA
"29826","ALTAVILLA MONFERRATO",90,0,0,90,"2020","007"
"29827","ALTAVILLA VICENTINA",134,0,0,134,"2020","004"
"29828","ALTISSIMO",23,52,0,75,"2020","005"
"29829","ALTIVOLE",11566,36,1,11603,"2020","001"
"29830","ALTO RENO TERME",54,0,0,54,"2020",NA
"29831","ALTO SERMENZA",12,23,0,35,"2020",NA
"29832","ALZANO LOMBARDO",8,34,0,42,"2020","008"
"29833","ALZANO SCRIVIA",3,0,0,3,"2020","008"
"29834","ALZATE BRIANZA",9,184,0,193,"2020","007"
"29835","AMBIVERE",1,0,0,1,"2020","009"
"29836","AMENO",10,7,28,45,"2020","002"
"29837","ANDALO VALTELLINO",9,0,0,9,"2020",NA
"29838","ANDEZENO",321,0,0,321,"2020","009"
"29839","ANDORNO MICCA",22,0,53,75,"2020","002"
"29840","ANDRATE",33,0,0,33,"2020","010"
"29841","ANFO",0,15,0,15,"2020","005"
"29842","ANGERA",64,139,22,225,"2020","003"
"29843","ANGOLO TERME",4,43,3,50,"2020","006"
"29844","ANGROGNA",120,0,40,160,"2020","011"
"29845","ANGUILLARA VENETA",3,0,0,3,"2020","004"
"29846","ANNICCO",7,894,256,1157,"2020","003"
"29847","ANNONE DI BRIANZA",23,6,0,29,"2020","003"
"29848","ANNONE VENETO",38,5,0,43,"2020","001"
"29849","ANTEGNATE",611,1568,0,2179,"2020","010"
"29850","ANTIGNANO",44,0,0,44,"2020","003"
"29851","ANTRONA SCHIERANCO",7,0,0,7,"2020","001"
"29852","ANZANO DEL PARCO",2,71,58,131,"2020","009"
"29853","ANZOLA D'OSSOLA",2,245,0,247,"2020","002"
"29854","ANZOLA DELL'EMILIA",43,532,0,575,"2020","001"
"29855","APPIANO GENTILE",59,215,33,307,"2020","010"
"29856","APRICA",0,1,0,1,"2020","004"
"29857","ARAMENGO",228,0,0,228,"2020","004"
"29858","ARCADE",936,48,0,984,"2020","002"
"29859","ARCENE",3,437,0,440,"2020","011"
"29860","ARCISATE",56,584,320,960,"2020","004"
"29861","ARCOLE",1239,91,0,1330,"2020","004"
"29862","ARCONATE",37,91,0,128,"2020","007"
"29863","ARCORE",100,0,0,100,"2020",NA
"29864","ARCUGNANO",97,2,0,99,"2020","006"
"29865","ARDENNO",46,20,40,106,"2020","005"
"29866","ARDESIO",79,52,0,131,"2020","012"
"29867","ARENA PO",37,610,25,672,"2020","005"
"29868","ARESE",0,124,0,124,"2020","009"
"29869","ARGEGNO",2,0,0,2,"2020","011"
"29870","ARGELATO",65,88,0,153,"2020","002"
"29871","ARGENTA",1413,3,0,1416,"2020","001"
"29872","ARGUELLO",88,0,0,88,"2020","007"
"29873","ARIANO NEL POLESINE",828,164,0,992,"2020","002"
"29874","ARIGNANO",518,0,0,518,"2020","012"
"29875","ARLUNO",68,278,3,349,"2020","010"
"29876","ARMENO",96,80,0,176,"2020","006"
"29877","AROLA",5,0,5,10,"2020","004"
"29878","ARONA",2,0,0,2,"2020","008"
"29879","AROSIO",0,0,2,2,"2020","012"
"29880","ARQUA' PETRARCA",154,0,0,154,"2020","005"
"29881","ARQUA' POLESINE",880,0,0,880,"2020","003"
"29882","ARQUATA SCRIVIA",10,0,0,10,"2020","009"
"29883","ARRE",4,13,0,17,"2020","006"
"29884","ARSAGO SEPRIO",6,0,0,6,"2020","005"
"29885","ARSIE'",19,6,412,437,"2020","004"
"29886","ARSIERO",6,19,4,29,"2020","007"
"29887","ARTOGNE",7,277,38,322,"2020","007"
"29888","ARZAGO D'ADDA",313,1034,0,1347,"2020","013"
"29889","ARZERGRANDE",287,143,0,430,"2020","007"
"29890","ARZIGNANO",131,321,1,453,"2020","008"
"29891","ASIAGO",69,1221,30,1320,"2020","009"
"29892","ASIGLIANO VENETO",186,0,0,186,"2020","010"
"29893","ASIGLIANO VERCELLESE",13,0,0,13,"2020","007"
"29894","ASOLA",9364,1884,1185,12433,"2020","002"
"29895","ASOLO",9006,527,40,9573,"2020","003"
"29896","ASSAGO",2,0,0,2,"2020","011"
"29897","ASSO",8,0,14,22,"2020","013"
"29898","ASTI",2393,0,0,2393,"2020","005"
"29899","AURANO",8,0,0,8,"2020","005"
"29900","AURONZO DI CADORE",18,8,0,26,"2020","005"
"29901","AVIATICO",3,14,0,17,"2020","015"
"29902","AVIGLIANA",150,46,11,207,"2020","013"
"29903","AVOLASCA",248,0,0,248,"2020","010"
"29904","AZEGLIO",93,13,62,168,"2020","014"
"29905","AZZANELLO",0,229,0,229,"2020","004"
"29906","AZZANO D'ASTI",1,0,0,1,"2020",NA
"29907","AZZANO MELLA",130,958,1,1089,"2020","008"
"29908","AZZANO SAN PAOLO",31,148,0,179,"2020","016"
"29909","AZZATE",13,0,9,22,"2020","006"
"29910","AZZIO",4,118,0,122,"2020","007"
"29911","AZZONE",0,1,0,1,"2020","017"
"29912","BACENO",4,27,0,31,"2020","006"
"29913","BADIA CALAVENA",1102,256,0,1358,"2020","005"
"29914","BADIA PAVESE",188,0,0,188,"2020","006"
"29915","BADIA POLESINE",197,0,0,197,"2020","004"
"29916","BAGNACAVALLO",32,0,0,32,"2020","002"
"29917","BAGNARA DI ROMAGNA",5,0,0,5,"2020","003"
"29918","BAGNARIA",23,0,0,23,"2020","007"
"29919","BAGNASCO",136,0,0,136,"2020","008"
"29920","BAGNATICA",2,121,0,123,"2020","018"
"29921","BAGNO DI ROMAGNA",746,21,0,767,"2020","001"
"29922","BAGNOLI DI SOPRA",967,7,0,974,"2020","008"
"29923","BAGNOLO CREMASCO",2,1857,0,1859,"2020","005"
"29924","BAGNOLO IN PIANO",2,565,0,567,"2020","002"
"29925","BAGNOLO MELLA",304,3068,412,3784,"2020","009"
"29926","BAGNOLO PIEMONTE",862,0,139,1001,"2020","009"
"29927","BAGNOLO SAN VITO",195,2775,882,3852,"2020","003"
"29928","BAGOLINO",6,275,4,285,"2020","010"
"29929","BAIRO",86,81,2,169,"2020","015"
"29930","BAISO",8,884,0,892,"2020","003"
"29931","BALANGERO",193,12,103,308,"2020","016"
"29932","BALDICHIERI D'ASTI",39,0,0,39,"2020","007"
"29933","BALDISSERO CANAVESE",0,67,0,67,"2020","017"
"29934","BALDISSERO D'ALBA",695,0,0,695,"2020","010"
"29935","BALDISSERO TORINESE",184,0,0,184,"2020","018"
"29936","BALLABIO",21,73,9,103,"2020","004"
"29937","BALME",9,0,0,9,"2020","019"
"29938","BALOCCO",89,0,25,114,"2020","009"
"29939","BANCHETTE",3,0,1,4,"2020","020"
"29940","BANNIO ANZINO",97,0,7,104,"2020","007"
"29941","BAONE",5,0,0,5,"2020","009"
"29942","BARBANIA",44,159,102,305,"2020","021"
"29943","BARBARANO MOSSANO",743,348,0,1091,"2020",NA
"29944","BARBARESCO",23,0,0,23,"2020","011"
"29945","BARBARIGA",1065,1535,0,2600,"2020","011"
"29946","BARBATA",0,819,0,819,"2020","019"
"29947","BARBIANELLO",125,9,0,134,"2020","008"
"29948","BARBONA",278,3,0,281,"2020","010"
"29949","BARDELLO",8,0,0,8,"2020","009"
"29950","BARDI",72,603,0,675,"2020","002"
"29951","BARDOLINO",24,106,0,130,"2020","006"
"29952","BARDONECCHIA",27,0,0,27,"2020","022"
"29953","BAREGGIO",9,129,9,147,"2020","012"
"29954","BARENGO",1,149,0,150,"2020","012"
"29955","BARGE",4901,1578,847,7326,"2020","012"
"29956","BARGHE",4,11,0,15,"2020","012"
"29957","BARIANO",8,324,0,332,"2020","020"
"29958","BARNI",4,5,0,9,"2020","015"
"29959","BAROLO",33,0,0,33,"2020","013"
"29960","BARONE CANAVESE",153,53,0,206,"2020","023"
"29961","BARZAGO",229,11,0,240,"2020","005"
"29962","BARZANO'",2,0,8,10,"2020","006"
"29963","BARZIO",26,47,54,127,"2020","007"
"29964","BASALUZZO",259,0,0,259,"2020","012"
"29965","BASCAPE'",0,870,0,870,"2020","009"
"29966","BASIGLIO",0,88,0,88,"2020","015"
"29967","BASSANO BRESCIANO",0,128,0,128,"2020","013"
"29968","BASSANO DEL GRAPPA",137,201,7,345,"2020","012"
"29969","BASSIGNANA",3,0,0,3,"2020","013"
"29970","BASTIA MONDOVI'",798,0,0,798,"2020","014"
"29971","BASTIGLIA",108,0,0,108,"2020","001"
"29972","BATTAGLIA TERME",4,0,0,4,"2020","011"
"29973","BEDERO VALCUVIA",13,0,0,13,"2020","010"
"29974","BEDIZZOLE",4042,1354,17,5413,"2020","014"
"29975","BEDONIA",227,124,0,351,"2020","003"
"29976","BEDULITA",4,0,0,4,"2020","022"
"29977","BEE",7,0,0,7,"2020","009"
"29978","BEINASCO",14,0,0,14,"2020","024"
"29979","BEINETTE",823,356,0,1179,"2020","016"
"29980","BELFIORE",2753,0,0,2753,"2020","007"
"29981","BELGIOIOSO",0,153,0,153,"2020","013"
"29982","BELLAGIO",1,53,31,85,"2020","019"
"29983","BELLANO",17,2,8,27,"2020","008"
"29984","BELLARIA-IGEA MARINA",6,0,0,6,"2020","001"
"29985","BELLINO",137,0,0,137,"2020","017"
"29986","BELLINZAGO LOMBARDO",92,1463,11,1566,"2020","016"
"29987","BELLINZAGO NOVARESE",461,661,0,1122,"2020","016"
"29988","BELLUNO",519,265,159,943,"2020","006"
"29989","BELVEDERE LANGHE",84,0,89,173,"2020","018"
"29990","BEMA",5,6,0,11,"2020","006"
"29991","BENE LARIO",1,0,45,46,"2020","021"
"29992","BENE VAGIENNA",1719,505,0,2224,"2020","019"
"29993","BENEVELLO",142,0,0,142,"2020","020"
"29994","BENNA",0,37,18,55,"2020","003"
"29995","BENTIVOGLIO",3,107,0,110,"2020","005"
"29996","BERBENNO",9,36,0,45,"2020","023"
"29997","BERBENNO DI VALTELLINA",17,216,0,233,"2020","007"
"29998","BERCETO",30,477,0,507,"2020","004"
"29999","BEREGAZZO CON FIGLIARO",6,0,0,6,"2020","022"
"30000","BEREGUARDO",9,518,81,608,"2020","014"
"30001","BERGAMASCO",63,0,0,63,"2020","015"
"30002","BERGAMO",124,163,0,287,"2020","024"
"30003","BERLINGO",3198,276,67,3541,"2020","015"
"30004","BERNAREGGIO",1,17,0,18,"2020",NA
"30005","BERNATE TICINO",5,117,16,138,"2020","019"
"30006","BERNEZZO",299,35,18,352,"2020","022"
"30007","BERTINORO",61,4,0,65,"2020","003"
"30008","BERTONICO",0,2609,0,2609,"2020","002"
"30009","BERZANO DI SAN PIETRO",6,0,0,6,"2020","009"
"30010","BERZO DEMO",4,44,6,54,"2020","016"
"30011","BERZO INFERIORE",1,150,1,152,"2020","017"
"30012","BERZO SAN FERMO",833,86,29,948,"2020","025"
"30013","BESANA IN BRIANZA",810,50,22,882,"2020",NA
"30014","BESANO",21,0,20,41,"2020","011"
"30015","BESATE",112,0,2,114,"2020","022"
"30016","BESENZONE",104,1787,0,1891,"2020","003"
"30017","BESNATE",3,223,0,226,"2020","012"
"30018","BESOZZO",16,62,0,78,"2020","013"
"30019","BETTOLA",370,102,0,472,"2020","004"
"30020","BEURA-CARDEZZA",34,2,5,41,"2020","011"
"30021","BEVILACQUA",36,39,0,75,"2020","008"
"30022","BIANDRONNO",10,0,3,13,"2020","014"
"30023","BIANZANO",6,7,0,13,"2020","026"
"30024","BIANZE'",83,454,0,537,"2020","011"
"30025","BIANZONE",5,4,0,9,"2020","008"
"30026","BIASSONO",8,0,0,8,"2020",NA
"30027","BIBBIANO",47,2438,0,2485,"2020","004"
"30028","BIBIANA",554,0,0,554,"2020","025"
"30029","BIELLA",140,38,116,294,"2020","004"
"30030","BIENNO",2,157,8,167,"2020","018"
"30031","BINAGO",32,83,90,205,"2020","023"
"30032","BIOGLIO",8,0,0,8,"2020","005"
"30033","BIONE",3,8,1,12,"2020","019"
"30034","BISTAGNO",7,0,0,7,"2020","017"
"30035","BISUSCHIO",3,0,0,3,"2020","015"
"30036","BIZZARONE",0,9,4,13,"2020","024"
"30037","BLELLO",0,56,0,56,"2020","027"
"30038","BLESSAGNO",0,0,5,5,"2020","025"
"30039","BOBBIO",152,65,0,217,"2020","005"
"30040","BOBBIO PELLICE",42,6,140,188,"2020","026"
"30041","BOCCIOLETO",9,0,0,9,"2020","014"
"30042","BOFFALORA D'ADDA",0,258,0,258,"2020","003"
"30043","BOFFALORA SOPRA TICINO",59,85,46,190,"2020","026"
"30044","BOGOGNO",1,0,0,1,"2020",NA
"30045","BOLGARE",47,224,34,305,"2020","028"
"30046","BOLLATE",3,261,11,275,"2020","027"
"30047","BOLLENGO",76,42,0,118,"2020","027"
"30048","BOLOGNA",7,44,0,51,"2020","006"
"30049","BOLTIERE",18,57,0,75,"2020","029"
"30050","BOLZANO NOVARESE",0,8,0,8,"2020","022"
"30051","BOLZANO VICENTINO",210,1146,0,1356,"2020","013"
"30052","BOMPORTO",36,120,0,156,"2020","002"
"30053","BONATE SOPRA",315,0,0,315,"2020","030"
"30054","BONATE SOTTO",66,0,0,66,"2020","031"
"30055","BONAVIGO",3352,31,34,3417,"2020","009"
"30056","BONDENO",602,390,0,992,"2020","003"
"30057","BONEMERSE",19,135,0,154,"2020","006"
"30058","BORDOLANO",23,472,108,603,"2020","007"
"30059","BORE",68,0,0,68,"2020","005"
"30060","BORETTO",0,255,0,255,"2020","005"
"30061","BORGARO TORINESE",82,53,0,135,"2020","028"
"30062","BORGHETTO DI BORBERA",190,0,13,203,"2020","018"
"30063","BORGHETTO LODIGIANO",14,1834,143,1991,"2020","004"
"30064","BORGHI",1334,0,0,1334,"2020","004"
"30065","BORGIALLO",7,22,0,29,"2020","029"
"30066","BORGO D'ALE",297,0,0,297,"2020","015"
"30067","BORGO DI TERZO",4,0,0,4,"2020","032"
"30068","BORGO MANTOVANO",15,854,363,1232,"2020",NA
"30069","BORGO PRIOLO",6,0,0,6,"2020","016"
"30070","BORGO SAN DALMAZZO",521,0,82,603,"2020","025"
"30071","BORGO SAN GIACOMO",1177,4016,130,5323,"2020","020"
"30072","BORGO SAN GIOVANNI",7,1039,0,1046,"2020","005"
"30073","BORGO SAN SIRO",1,866,0,867,"2020","018"
"30074","BORGO TICINO",43,0,0,43,"2020","025"
"30075","BORGO TOSSIGNANO",6,0,0,6,"2020","007"
"30076","BORGO VAL DI TARO",94,235,0,329,"2020","006"
"30077","BORGO VALBELLUNA",155,750,3,908,"2020",NA
"30078","BORGO VENETO",1665,39,0,1704,"2020",NA
"30079","BORGO VERCELLI",3,0,0,3,"2020","017"
"30080","BORGO VIRGILIO",169,3843,2402,6414,"2020",NA
"30081","BORGOCARBONARA",0,481,242,723,"2020",NA
"30082","BORGOFRANCO D'IVREA",216,0,11,227,"2020","030"
"30083","BORGOLAVEZZARO",4,0,0,4,"2020","023"
"30084","BORGOMALE",33,0,0,33,"2020","024"
"30085","BORGOMANERO",112,19,0,131,"2020","024"
"30086","BORGOMASINO",57,0,14,71,"2020","031"
"30087","BORGOMEZZAVALLE",5,0,0,5,"2020",NA
"30088","BORGONE SUSA",30,38,0,68,"2020","032"
"30089","BORGONOVO VAL TIDONE",713,2429,0,3142,"2020","006"
"30090","BORGORATTO ALESSANDRINO",21,0,0,21,"2020","019"
"30091","BORGORATTO MORMOROLO",7,0,0,7,"2020","017"
"30092","BORGORICCO",64,17,0,81,"2020","013"
"30093","BORGOSATOLLO",83,552,74,709,"2020","021"
"30094","BORGOSESIA",34,68,0,102,"2020","016"
"30095","BORMIO",10,342,11,363,"2020","009"
"30096","BORNASCO",154,538,0,692,"2020","019"
"30097","BORNO",1,94,65,160,"2020","022"
"30098","BORRIANA",93,51,0,144,"2020","006"
"30099","BORSO DEL GRAPPA",127,267,13,407,"2020","004"
"30100","BOSCHI SANT'ANNA",92,0,0,92,"2020","010"
"30101","BOSCO CHIESANUOVA",37,1365,24,1426,"2020","011"
"30102","BOSCO MARENGO",63,24,0,87,"2020","021"
"30103","BOSCONERO",54,32,0,86,"2020","033"
"30104","BOSIA",399,0,0,399,"2020","026"
"30105","BOSIO",15,0,3,18,"2020","022"
"30106","BOSISIO PARINI",0,153,0,153,"2020","009"
"30107","BOSSICO",35,53,3,91,"2020","033"
"30108","BOSSOLASCO",37,66,0,103,"2020","027"
"30109","BOTTANUCO",140,402,376,918,"2020","034"
"30110","BOTTICINO",36,0,0,36,"2020","023"
"30111","BOVEGNO",33,70,58,161,"2020","024"
"30112","BOVES",616,762,123,1501,"2020","028"
"30113","BOVOLENTA",4444,263,0,4707,"2020","014"
"30114","BOVOLONE",4105,327,0,4432,"2020","012"
"30115","BOZZOLO",40,1363,21,1424,"2020","007"
"30116","BRA",3338,1418,165,4921,"2020","029"
"30117","BRACCA",5,0,0,5,"2020","035"
"30118","BRALLO DI PREGOLA",10,0,0,10,"2020","021"
"30119","BRANDICO",0,726,0,726,"2020","026"
"30120","BRANDIZZO",0,0,78,78,"2020","034"
"30121","BRANZI",3,26,0,29,"2020","036"
"30122","BRAONE",0,28,3,31,"2020","027"
"30123","BREBBIA",24,0,0,24,"2020","017"
"30124","BREDA DI PIAVE",50,453,3,506,"2020","005"
"30125","BREGANO",9,0,0,9,"2020","018"
"30126","BREGANZE",493,619,111,1223,"2020","014"
"30127","BREGNANO",10,77,0,87,"2020","028"
"30128","BREMBATE",67,0,253,320,"2020","037"
"30129","BREMBATE DI SOPRA",0,225,0,225,"2020","038"
"30130","BREMBIO",184,2388,121,2693,"2020","006"
"30131","BREME",5,0,0,5,"2020","022"
"30132","BRENDOLA",303,111,0,414,"2020","015"
"30133","BRENNA",6,0,0,6,"2020","029"
"30134","BRENO",7,246,9,262,"2020","028"
"30135","BRENTA",3,0,0,3,"2020","019"
"30136","BRENZONE",8,0,0,8,"2020","014"
"30137","BRESCELLO",1,35,0,36,"2020","006"
"30138","BRESCIA",22,555,0,577,"2020","029"
"30139","BRESSANA BOTTARONE",152,0,0,152,"2020","023"
"30140","BRESSANVIDO",20,1280,27,1327,"2020","016"
"30141","BRESSO",0,0,4,4,"2020",NA
"30142","BREZZO DI BEDERO",3,0,0,3,"2020","020"
"30143","BRIAGLIA",83,0,0,83,"2020","030"
"30144","BRICHERASIO",575,75,27,677,"2020","035"
"30145","BRIGA NOVARESE",0,84,0,84,"2020","026"
"30146","BRIGNANO GERA D'ADDA",232,1708,0,1940,"2020","040"
"30147","BRIGNANO-FRASCATA",3,0,0,3,"2020","024"
"30148","BRINZIO",5,0,0,5,"2020","021"
"30149","BRIONA",14,764,0,778,"2020","027"
"30150","BRIONE",12,0,0,12,"2020","030"
"30151","BRIOSCO",10,0,0,10,"2020",NA
"30152","BRISIGHELLA",365,65,1,431,"2020","004"
"30153","BRISSAGO-VALTRAVAGLIA",5,0,0,5,"2020","022"
"30154","BRIVIO",0,63,0,63,"2020","010"
"30155","BROGLIANO",39,44,0,83,"2020","017"
"30156","BRONDELLO",9,0,0,9,"2020","032"
"30157","BRONI",57,0,0,57,"2020","024"
"30158","BROSSASCO",69,0,0,69,"2020","033"
"30159","BROSSO",42,15,11,68,"2020","036"
"30160","BROVELLO-CARPUGNINO",14,0,11,25,"2020","013"
"30161","BROZOLO",18,0,0,18,"2020","037"
"30162","BRUGHERIO",2,254,12,268,"2020",NA
"30163","BRUGINE",3392,60,0,3452,"2020","015"
"30164","BRUINO",105,0,0,105,"2020","038"
"30165","BRUMANO",11,15,0,26,"2020","041"
"30166","BRUNELLO",8,0,0,8,"2020","023"
"30167","BRUNO",14,0,0,14,"2020","010"
"30168","BRUSAPORTO",64,0,24,88,"2020","042"
"30169","BRUSASCO",120,0,0,120,"2020","039"
"30170","BRUSNENGO",7,0,0,7,"2020","007"
"30171","BRUZOLO",38,40,40,118,"2020","040"
"30172","BUBBIANO",0,26,0,26,"2020","035"
"30173","BUBBIO",55,0,0,55,"2020","011"
"30174","BUCCINASCO",12,658,0,670,"2020","036"
"30175","BUDRIO",154,246,0,400,"2020","008"
"30176","BUGLIO IN MONTE",31,325,36,392,"2020","010"
"30177","BULCIAGO",2,0,129,131,"2020","011"
"30178","BULGAROGRASSO",38,295,0,333,"2020","034"
"30179","BURIASCO",1400,736,159,2295,"2020","041"
"30180","BUROLO",10,0,0,10,"2020","042"
"30181","BURONZO",9,15,0,24,"2020","021"
"30182","BUSANO",42,30,0,72,"2020","043"
"30183","BUSCA",4312,1438,465,6215,"2020","034"
"30184","BUSCATE",69,0,0,69,"2020","038"
"30185","BUSNAGO",22,8,0,30,"2020",NA
"30186","BUSSERO",1,336,0,337,"2020","040"
"30187","BUSSETO",1,3660,0,3661,"2020","007"
"30188","BUSSOLENGO",554,115,76,745,"2020","015"
"30189","BUSSOLENO",27,184,47,258,"2020","044"
"30190","BUSTO ARSIZIO",12,183,31,226,"2020","026"
"30191","BUSTO GAROLFO",52,252,0,304,"2020","041"
"30192","BUTTAPIETRA",180,145,0,325,"2020","016"
"30193","BUTTIGLIERA ALTA",101,36,0,137,"2020","045"
"30194","BUTTIGLIERA D'ASTI",2043,97,85,2225,"2020","012"
"30195","CABELLA LIGURE",88,0,0,88,"2020","025"
"30196","CADEGLIANO-VICONAGO",5,0,0,5,"2020","027"
"30197","CADELBOSCO DI SOPRA",8,1688,0,1696,"2020","008"
"30198","CADEO",45,2824,0,2869,"2020","007"
"30199","CADONEGHE",9,5,0,14,"2020","016"
"30200","CADORAGO",1,0,43,44,"2020","036"
"30201","CADREZZATE CON OSMATE",31,0,0,31,"2020",NA
"30202","CAERANO DI SAN MARCO",214,42,0,256,"2020","006"
"30203","CAFASSE",135,63,4,202,"2020","046"
"30204","CAGLIO",63,0,0,63,"2020","037"
"30205","CAINO",5,0,0,5,"2020","031"
"30206","CAIOLO",3,80,0,83,"2020","011"
"30207","CAIRATE",2,0,0,2,"2020","029"
"30208","CALALZO DI CADORE",2,0,0,2,"2020",NA
"30209","CALAMANDRANA",77,0,0,77,"2020","013"
"30210","CALASCA-CASTIGLIONE",9,0,0,9,"2020","014"
"30211","CALCINATE",246,226,43,515,"2020","043"
"30212","CALCINATO",6702,1627,1220,9549,"2020","032"
"30213","CALCIO",244,1457,0,1701,"2020","044"
"30214","CALCO",15,214,0,229,"2020","012"
"30215","CALDERARA DI RENO",37,51,0,88,"2020","009"
"30216","CALDOGNO",112,363,108,583,"2020","018"
"30217","CALENDASCO",129,328,0,457,"2020","008"
"30218","CALESTANO",43,294,0,337,"2020","008"
"30219","CALLABIANA",32,0,0,32,"2020","008"
"30220","CALLIANO",232,0,0,232,"2020","014"
"30221","CALOLZIOCORTE",4,0,13,17,"2020","013"
"30222","CALOSSO",3,0,0,3,"2020","015"
"30223","CALTIGNAGA",1238,142,0,1380,"2020","030"
"30224","CALTO",31,0,0,31,"2020","008"
"30225","CALTRANO",1652,2,0,1654,"2020","019"
"30226","CALUSCO D'ADDA",14,0,0,14,"2020","046"
"30227","CALUSO",1007,186,0,1193,"2020","047"
"30228","CALVAGESE DELLA RIVIERA",119,172,5,296,"2020","033"
"30229","CALVATONE",1,119,0,120,"2020","009"
"30230","CALVENE",10,32,0,42,"2020","020"
"30231","CALVENZANO",26,641,0,667,"2020","047"
"30232","CALVIGNASCO",1,28,0,29,"2020","042"
"30233","CALVISANO",14352,4694,249,19295,"2020","034"
"30234","CAMAGNA MONFERRATO",15,0,0,15,"2020","026"
"30235","CAMANDONA",4,0,0,4,"2020","009"
"30236","CAMBIAGO",19,102,7,128,"2020","044"
"30237","CAMBIANO",279,0,0,279,"2020","048"
"30238","CAMBIASCA",14,0,0,14,"2020","015"
"30239","CAMBURZANO",96,0,12,108,"2020","010"
"30240","CAMERANA",291,0,0,291,"2020","035"
"30241","CAMERANO CASASCO",22,0,0,22,"2020","016"
"30242","CAMERATA CORNELLO",11,82,0,93,"2020","048"
"30243","CAMERI",94,644,0,738,"2020","032"
"30244","CAMISANO",286,2996,0,3282,"2020","010"
"30245","CAMISANO VICENTINO",278,1410,257,1945,"2020","021"
"30246","CAMPAGNA LUPIA",83,90,0,173,"2020","002"
"30247","CAMPAGNOLA CREMASCA",21,649,76,746,"2020","011"
"30248","CAMPAGNOLA EMILIA",1,806,0,807,"2020","009"
"30249","CAMPEGINE",1,1146,0,1147,"2020","010"
"30250","CAMPERTOGNO",0,42,0,42,"2020","025"
"30251","CAMPIGLIA CERVO",4,3,0,7,"2020","011"
"30252","CAMPIGLIA DEI BERICI",561,136,2,699,"2020","022"
"30253","CAMPIGLIONE-FENILE",539,0,18,557,"2020","049"
"30254","CAMPO SAN MARTINO",471,97,0,568,"2020","020"
"30255","CAMPODARSEGO",706,42,7,755,"2020","017"
"30256","CAMPODORO",72,144,0,216,"2020","018"
"30257","CAMPOGALLIANO",1,352,0,353,"2020","003"
"30258","CAMPOLONGO MAGGIORE",17,40,0,57,"2020","003"
"30259","CAMPONOGARA",129,52,0,181,"2020","004"
"30260","CAMPOSAMPIERO",289,91,0,380,"2020","019"
"30261","CAMUGNANO",405,85,0,490,"2020","010"
"30262","CANALE",836,0,0,836,"2020","037"
"30263","CANARO",465,0,0,465,"2020","009"
"30264","CANDELO",86,37,92,215,"2020","012"
"30265","CANDIA CANAVESE",18,0,0,18,"2020","050"
"30266","CANDIANA",10338,213,0,10551,"2020","021"
"30267","CANDIOLO",72,539,162,773,"2020","051"
"30268","CANELLI",5,0,0,5,"2020","017"
"30269","CANISCHIO",14,31,0,45,"2020","052"
"30270","CANNETO SULL'OGLIO",1776,2746,558,5080,"2020","008"
"30271","CANNOBIO",11,6,0,17,"2020","017"
"30272","CANONICA D'ADDA",16,455,0,471,"2020","049"
"30273","CANOSIO",13,0,27,40,"2020","038"
"30274","CANOSSA",17,239,0,256,"2020","018"
"30275","CANTALUPA",37,0,0,37,"2020","053"
"30276","CANTALUPO LIGURE",11,0,0,11,"2020","028"
"30277","CANTARANA",68,0,0,68,"2020","018"
"30278","CANTELLO",117,122,0,239,"2020","030"
"30279","CANTOIRA",80,25,25,130,"2020","054"
"30280","CANTU'",244,255,26,525,"2020","041"
"30281","CANZO",0,0,18,18,"2020","042"
"30282","CAORLE",821,22,49,892,"2020","005"
"30283","CAORSO",6,450,0,456,"2020","010"
"30284","CAPERGNANICA",352,1166,17,1535,"2020","012"
"30285","CAPIAGO INTIMIANO",0,8,3,11,"2020","043"
"30286","CAPIZZONE",17,23,0,40,"2020","050"
"30287","CAPO DI PONTE",40,179,5,224,"2020","035"
"30288","CAPONAGO",35,0,0,35,"2020",NA
"30289","CAPOVALLE",18,0,8,26,"2020","036"
"30290","CAPPELLA CANTONE",0,390,0,390,"2020","013"
"30291","CAPPELLA DE' PICENARDI",7,382,0,389,"2020","014"
"30292","CAPPELLA MAGGIORE",14,13,0,27,"2020","007"
"30293","CAPRALBA",1,1444,0,1445,"2020","015"
"30294","CAPRAUNA",2,0,0,2,"2020","039"
"30295","CAPRIANO DEL COLLE",9,387,0,396,"2020","037"
"30296","CAPRIATA D'ORBA",9,0,0,9,"2020","029"
"30297","CAPRIE",36,0,0,36,"2020","055"
"30298","CAPRIGLIO",1,0,0,1,"2020","019"
"30299","CAPRILE",36,2,0,38,"2020","013"
"30300","CAPRINO BERGAMASCO",22,0,0,22,"2020","052"
"30301","CAPRINO VERONESE",75,690,70,835,"2020","018"
"30302","CAPRIOLO",310,0,51,361,"2020","038"
"30303","CARAGLIO",3296,779,376,4451,"2020","040"
"30304","CARAMAGNA PIEMONTE",2057,651,59,2767,"2020","041"
"30305","CARATE BRIANZA",13,0,0,13,"2020",NA
"30306","CARATE URIO",0,0,5,5,"2020","044"
"30307","CARAVAGGIO",156,3090,0,3246,"2020","053"
"30308","CARAVATE",0,86,0,86,"2020","031"
"30309","CARBONARA AL TICINO",25,336,0,361,"2020","030"
"30310","CARBONARA SCRIVIA",29,0,0,29,"2020","030"
"30311","CARBONATE",109,45,28,182,"2020","045"
"30312","CARBONERA",108,216,14,338,"2020","008"
"30313","CARCERI",1493,0,0,1493,"2020","022"
"30314","CARCOFORO",1,0,5,6,"2020","029"
"30315","CARDE'",2580,1781,89,4450,"2020","042"
"30316","CAREMA",75,0,5,80,"2020","057"
"30317","CARENNO",26,0,16,42,"2020","014"
"30318","CARENTINO",75,611,0,686,"2020","031"
"30319","CARESANA",3,0,0,3,"2020","030"
"30320","CARIGNANO",2692,1579,302,4573,"2020","058"
"30321","CARISIO",51,0,0,51,"2020","032"
"30322","CARLAZZO",50,56,16,122,"2020","047"
"30323","CARMAGNOLA",6708,3303,0,10011,"2020","059"
"30324","CARMIGNANO DI BRENTA",24,1312,0,1336,"2020","023"
"30325","CARNAGO",21,38,0,59,"2020","033"
"30326","CAROBBIO DEGLI ANGELI",97,35,0,132,"2020","055"
"30327","CARONNO PERTUSELLA",5,0,0,5,"2020","034"
"30328","CARONNO VARESINO",40,0,0,40,"2020","035"
"30329","CARPANETO PIACENTINO",54,4256,0,4310,"2020","011"
"30330","CARPENEDOLO",1494,4053,246,5793,"2020","039"
"30331","CARPENETO",112,0,0,112,"2020","033"
"30332","CARPI",2,2113,0,2115,"2020","005"
"30333","CARPIANO",174,1132,276,1582,"2020","050"
"30334","CARPIGNANO SESIA",105,0,0,105,"2020","036"
"30335","CARPINETI",79,1312,0,1391,"2020","011"
"30336","CARRE'",346,103,0,449,"2020","024"
"30337","CARREGA LIGURE",44,0,0,44,"2020","034"
"30338","CARRU'",750,44,70,864,"2020","043"
"30339","CARTIGLIANO",22,11,0,33,"2020","025"
"30340","CARTIGNANO",142,82,0,224,"2020","044"
"30341","CARTOSIO",64,0,0,64,"2020","036"
"30342","CARTURA",414,0,0,414,"2020","026"
"30343","CARUGATE",40,99,0,139,"2020","051"
"30344","CARUGO",5,0,0,5,"2020","048"
"30345","CARVICO",1,0,0,1,"2020","057"
"30346","CASALBELTRAME",0,0,155,155,"2020","037"
"30347","CASALBORGONE",45,0,0,45,"2020","060"
"30348","CASALBUTTANO ED UNITI",5,1866,0,1871,"2020","016"
"30349","CASALE CORTE CERRO",23,0,0,23,"2020","019"
"30350","CASALE CREMASCO-VIDOLASCO",0,2015,0,2015,"2020","017"
"30351","CASALE DI SCODOSIA",555,0,0,555,"2020","027"
"30352","CASALE LITTA",20,160,4,184,"2020","036"
"30353","CASALE MONFERRATO",137,146,0,283,"2020","039"
"30354","CASALE SUL SILE",225,35,43,303,"2020","009"
"30355","CASALEGGIO BOIRO",18,0,0,18,"2020","038"
"30356","CASALEONE",152,0,0,152,"2020","019"
"30357","CASALETTO CEREDANO",15,14,0,29,"2020","018"
"30358","CASALETTO DI SOPRA",15,352,0,367,"2020","019"
"30359","CASALETTO LODIGIANO",49,278,0,327,"2020","008"
"30360","CASALETTO VAPRIO",150,808,0,958,"2020","020"
"30361","CASALFIUMANESE",325,138,0,463,"2020","012"
"30362","CASALGRANDE",32,1216,0,1248,"2020","012"
"30363","CASALGRASSO",347,229,135,711,"2020","045"
"30364","CASALINO",4,155,0,159,"2020","040"
"30365","CASALMAGGIORE",8,678,0,686,"2020","021"
"30366","CASALMAIOCCO",10,513,0,523,"2020","009"
"30367","CASALMORANO",110,2469,0,2579,"2020","022"
"30368","CASALMORO",408,0,470,878,"2020","010"
"30369","CASALNOCETO",35,0,0,35,"2020","040"
"30370","CASALOLDO",851,1106,1030,2987,"2020","011"
"30371","CASALPUSTERLENGO",737,1216,0,1953,"2020","010"
"30372","CASALROMANO",341,298,262,901,"2020","012"
"30373","CASALSERUGO",118,10,0,128,"2020","028"
"30374","CASALVOLONE",3,38,0,41,"2020","041"
"30375","CASALZUIGNO",3,108,0,111,"2020","037"
"30376","CASARGO",3,22,1,26,"2020","015"
"30377","CASARILE",56,0,0,56,"2020","055"
"30378","CASATENOVO",411,0,1,412,"2020","016"
"30379","CASAZZA",6,24,0,30,"2020","058"
"30380","CASCIAGO",18,0,37,55,"2020","038"
"30381","CASEI GEROLA",577,0,0,577,"2020","033"
"30382","CASELETTE",116,335,41,492,"2020","062"
"30383","CASELLE LANDI",226,452,29,707,"2020","011"
"30384","CASELLE LURANI",39,363,0,402,"2020","012"
"30385","CASELLE TORINESE",343,1373,0,1716,"2020","063"
"30386","CASIER",7,78,0,85,"2020","010"
"30387","CASINA",60,947,0,1007,"2020","013"
"30388","CASIRATE D'ADDA",159,369,0,528,"2020","059"
"30389","CASLINO D'ERBA",5,0,12,17,"2020","052"
"30390","CASNATE CON BERNATE",4,0,0,4,"2020","053"
"30391","CASNIGO",39,85,0,124,"2020","060"
"30392","CASOLA VALSENIO",190,17,0,207,"2020","005"
"30393","CASORATE PRIMO",30,98,0,128,"2020","034"
"30394","CASOREZZO",0,305,0,305,"2020","058"
"30395","CASORZO",5,0,0,5,"2020","020"
"30396","CASPOGGIO",2,42,0,44,"2020","013"
"30397","CASSAGO BRIANZA",2,48,6,56,"2020","017"
"30398","CASSANO D'ADDA",236,333,43,612,"2020","059"
"30399","CASSANO MAGNAGO",7,53,25,85,"2020","040"
"30400","CASSANO SPINOLA",257,0,0,257,"2020","042"
"30401","CASSANO VALCUVIA",3,0,0,3,"2020","041"
"30402","CASSINA DE' PECCHI",0,367,0,367,"2020","060"
"30403","CASSINA VALSASSINA",7,30,0,37,"2020","018"
"30404","CASSINASCO",29,22,0,51,"2020","021"
"30405","CASSINE",259,0,0,259,"2020","043"
"30406","CASSINELLE",2,0,0,2,"2020","044"
"30407","CASSINETTA DI LUGAGNANO",0,227,0,227,"2020","061"
"30408","CASSOLA",407,23,0,430,"2020","026"
"30409","CASSOLNOVO",0,31,0,31,"2020","035"
"30410","CASTAGNARO",242,0,0,242,"2020","020"
"30411","CASTAGNETO PO",53,0,0,53,"2020","064"
"30412","CASTAGNITO",107,0,0,107,"2020","046"
"30413","CASTAGNOLE DELLE LANZE",257,0,0,257,"2020","022"
"30414","CASTAGNOLE MONFERRATO",58,0,0,58,"2020","023"
"30415","CASTAGNOLE PIEMONTE",1410,681,77,2168,"2020","065"
"30416","CASTANA",2,0,0,2,"2020","036"
"30417","CASTANO PRIMO",78,0,3,81,"2020","062"
"30418","CASTEGGIO",15,0,0,15,"2020","037"
"30419","CASTEGNATO",28,1086,0,1114,"2020","040"
"30420","CASTEGNERO",20,27,0,47,"2020","027"
"30421","CASTEL BOGLIONE",6,0,0,6,"2020","024"
"30422","CASTEL BOLOGNESE",17,0,0,17,"2020","006"
"30423","CASTEL D'AIANO",26,604,0,630,"2020","013"
"30424","CASTEL D'ARIO",184,64,1132,1380,"2020","014"
"30425","CASTEL D'AZZANO",2016,116,0,2132,"2020","021"
"30426","CASTEL DEL RIO",40,0,0,40,"2020","014"
"30427","CASTEL DI CASIO",43,28,0,71,"2020","015"
"30428","CASTEL GABBIANO",0,1805,0,1805,"2020","024"
"30429","CASTEL GOFFREDO",1791,606,491,2888,"2020","015"
"30430","CASTEL GUELFO DI BOLOGNA",105,244,2,351,"2020","016"
"30431","CASTEL MELLA",3,359,0,362,"2020","042"
"30432","CASTEL ROZZONE",2,25,0,27,"2020","063"
"30433","CASTEL SAN GIOVANNI",62,854,0,916,"2020","013"
"30434","CASTEL SAN PIETRO TERME",483,311,0,794,"2020","020"
"30435","CASTELBELFORTE",1578,0,0,1578,"2020","013"
"30436","CASTELCOVATI",5,383,6,394,"2020","041"
"30437","CASTELCUCCO",64,185,7,256,"2020","011"
"30438","CASTELDELCI",228,0,0,228,"2020","021"
"30439","CASTELDELFINO",72,0,0,72,"2020","047"
"30440","CASTELDIDONE",49,0,0,49,"2020","023"
"30441","CASTELFRANCO EMILIA",2049,2777,0,4826,"2020","006"
"30442","CASTELFRANCO VENETO",5536,160,5,5701,"2020","012"
"30443","CASTELGERUNDO",15,1892,5,1912,"2020",NA
"30444","CASTELGOMBERTO",324,428,0,752,"2020","028"
"30445","CASTELGUGLIELMO",567,0,0,567,"2020","011"
"30446","CASTELL'ALFERO",380,0,0,380,"2020","025"
"30447","CASTELL'ARQUATO",86,765,0,851,"2020","012"
"30448","CASTELLAMONTE",321,367,83,771,"2020","066"
"30449","CASTELLARANO",22,313,0,335,"2020","014"
"30450","CASTELLAZZO BORMIDA",130,97,0,227,"2020","047"
"30451","CASTELLEONE",725,4346,0,5071,"2020","025"
"30452","CASTELLETTO CERVO",34,30,0,64,"2020","015"
"30453","CASTELLETTO D'ORBA",9,0,0,9,"2020","049"
"30454","CASTELLETTO DI BRANDUZZO",6,0,0,6,"2020","038"
"30455","CASTELLETTO MERLI",29,0,0,29,"2020","050"
"30456","CASTELLETTO MONFERRATO",70,0,0,70,"2020","051"
"30457","CASTELLETTO SOPRA TICINO",146,40,0,186,"2020","043"
"30458","CASTELLETTO STURA",1724,51,55,1830,"2020","049"
"30459","CASTELLETTO UZZONE",2,0,0,2,"2020","050"
"30460","CASTELLI CALEPIO",13,288,0,301,"2020","062"
"30461","CASTELLINALDO D'ALBA",955,0,0,955,"2020",NA
"30462","CASTELLINO TANARO",155,0,0,155,"2020","052"
"30463","CASTELLO CABIAGLIO",13,0,0,13,"2020","043"
"30464","CASTELLO D'AGOGNA",6,0,0,6,"2020",NA
"30465","CASTELLO D'ARGILE",28,0,0,28,"2020","017"
"30466","CASTELLO DELL'ACQUA",12,15,0,27,"2020","014"
"30467","CASTELLO DI ANNONE",135,0,0,135,"2020","028"
"30468","CASTELLO DI BRIANZA",1,0,10,11,"2020","019"
"30469","CASTELLO DI GODEGO",6268,169,1,6438,"2020","013"
"30470","CASTELLUCCHIO",873,1878,2039,4790,"2020","016"
"30471","CASTELMAGNO",60,16,8,84,"2020","053"
"30472","CASTELMARTE",12,0,1,13,"2020","058"
"30473","CASTELMASSA",0,92,0,92,"2020","012"
"30474","CASTELNOVO BARIANO",2248,0,0,2248,"2020","013"
"30475","CASTELNOVO DI SOTTO",5,1171,0,1176,"2020","015"
"30476","CASTELNOVO NE' MONTI",65,1501,0,1566,"2020","016"
"30477","CASTELNUOVO BOCCA D'ADDA",2442,361,21,2824,"2020","013"
"30478","CASTELNUOVO BORMIDA",10,0,0,10,"2020","052"
"30479","CASTELNUOVO BOZZENTE",10,7,0,17,"2020","059"
"30480","CASTELNUOVO CALCEA",4,0,0,4,"2020","030"
"30481","CASTELNUOVO DEL GARDA",3162,219,3,3384,"2020","022"
"30482","CASTELNUOVO DON BOSCO",177,0,0,177,"2020","031"
"30483","CASTELNUOVO NIGRA",35,0,0,35,"2020","067"
"30484","CASTELNUOVO RANGONE",0,856,0,856,"2020","007"
"30485","CASTELNUOVO SCRIVIA",0,0,6,6,"2020","053"
"30486","CASTELSEPRIO",2,0,2,4,"2020","044"
"30487","CASTELSPINA",10,0,0,10,"2020","054"
"30488","CASTELVECCANA",5,0,0,5,"2020","045"
"30489","CASTELVERDE",333,3571,0,3904,"2020","026"
"30490","CASTELVETRO DI MODENA",13,995,0,1008,"2020","008"
"30491","CASTELVETRO PIACENTINO",1170,949,0,2119,"2020","014"
"30492","CASTELVISCONTI",11,1380,7,1398,"2020","027"
"30493","CASTENASO",138,108,0,246,"2020","021"
"30494","CASTENEDOLO",954,1134,5,2093,"2020","043"
"30495","CASTIGLIONE D'ADDA",2,294,0,296,"2020","014"
"30496","CASTIGLIONE DEI PEPOLI",133,35,0,168,"2020","022"
"30497","CASTIGLIONE DELLE STIVIERE",4325,1833,1304,7462,"2020","017"
"30498","CASTIGLIONE FALLETTO",26,0,0,26,"2020","055"
"30499","CASTIGLIONE OLONA",2,0,7,9,"2020","046"
"30500","CASTIGLIONE TINELLA",45,0,0,45,"2020","056"
"30501","CASTIGLIONE TORINESE",12,0,0,12,"2020","068"
"30502","CASTINO",122,0,2,124,"2020","057"
"30503","CASTIONE ANDEVENNO",19,42,0,61,"2020","015"
"30504","CASTIONE DELLA PRESOLANA",16,6,0,22,"2020","064"
"30505","CASTIRAGA VIDARDO",12,301,0,313,"2020","015"
"30506","CASTO",23,42,4,69,"2020","044"
"30507","CASTREZZATO",352,1062,114,1528,"2020","045"
"30508","CASTRO",2,0,0,2,"2020","065"
"30509","CASTROCARO TERME E TERRA DEL SOLE",14,1,0,15,"2020","005"
"30510","CASTRONNO",2,0,0,2,"2020","047"
"30511","CAVAGLIA'",1265,139,0,1404,"2020","016"
"30512","CAVAGLIETTO",3,203,0,206,"2020","044"
"30513","CAVAGNOLO",50,0,0,50,"2020","069"
"30514","CAVAION VERONESE",3,0,0,3,"2020","023"
"30515","CAVALLERLEONE",390,1135,91,1616,"2020","058"
"30516","CAVALLERMAGGIORE",2559,2338,37,4934,"2020","059"
"30517","CAVALLINO-TREPORTI",15,0,0,15,"2020","044"
"30518","CAVALLIRIO",5,0,0,5,"2020","047"
"30519","CAVARGNA",1,0,10,11,"2020","062"
"30520","CAVARIA CON PREMEZZO",3,0,0,3,"2020","048"
"30521","CAVARZERE",5796,0,0,5796,"2020","006"
"30522","CAVASO DEL TOMBA",77,68,3,148,"2020","014"
"30523","CAVATORE",5,0,0,5,"2020","055"
"30524","CAVENAGO D'ADDA",13,738,124,875,"2020","017"
"30525","CAVERNAGO",1,0,0,1,"2020","066"
"30526","CAVEZZO",0,416,0,416,"2020","009"
"30527","CAVOUR",4152,331,1107,5590,"2020","070"
"30528","CAVRIAGO",15,637,0,652,"2020","017"
"30529","CAVRIANA",2028,1681,285,3994,"2020","018"
"30530","CAZZAGO BRABBIA",2,0,0,2,"2020",NA
"30531","CAZZAGO SAN MARTINO",3481,156,183,3820,"2020","046"
"30532","CAZZANO DI TRAMIGNA",12,0,0,12,"2020","024"
"30533","CAZZANO SANT'ANDREA",311,10,0,321,"2020","067"
"30534","CECIMA",9,0,0,9,"2020","042"
"30535","CEDEGOLO",5,15,2,22,"2020","047"
"30536","CEDRASCO",0,61,0,61,"2020","016"
"30537","CEGGIA",15,0,0,15,"2020","007"
"30538","CELLA DATI",2286,77,32,2395,"2020","028"
"30539","CELLA MONTE",98,0,0,98,"2020","056"
"30540","CELLARENGO",247,97,160,504,"2020","033"
"30541","CELLATICA",1,57,0,58,"2020","048"
"30542","CELLE DI MACRA",54,0,22,76,"2020","060"
"30543","CELLE ENOMONDO",209,0,0,209,"2020","034"
"30544","CELLIO CON BREIA",15,0,0,15,"2020",NA
"30545","CENATE SOPRA",6,8,0,14,"2020","068"
"30546","CENATE SOTTO",17,0,0,17,"2020","069"
"30547","CENCENIGHE AGORDINO",2,1,0,3,"2020","010"
"30548","CENE",30,65,0,95,"2020","070"
"30549","CENESELLI",0,245,18,263,"2020","014"
"30550","CENTALLO",5490,741,438,6669,"2020","061"
"30551","CENTO",19,0,0,19,"2020","004"
"30552","CENTRO VALLE INTELVI",54,7,9,70,"2020",NA
"30553","CEPPO MORELLI",29,0,0,29,"2020","021"
"30554","CERANO",35,0,0,35,"2020","049"
"30555","CERANO D'INTELVI",6,0,58,64,"2020","063"
"30556","CERANOVA",0,581,0,581,"2020","043"
"30557","CERCENASCO",150,312,0,462,"2020","071"
"30558","CERCINO",66,8,0,74,"2020","017"
"30559","CEREA",1337,195,0,1532,"2020","025"
"30560","CERES",1,0,0,1,"2020","072"
"30561","CERESARA",1069,359,127,1555,"2020","019"
"30562","CERESETO",111,0,0,111,"2020","057"
"30563","CERESOLE ALBA",3568,695,0,4263,"2020","062"
"30564","CERESOLE REALE",0,4,0,4,"2020","073"
"30565","CERETE",5,162,0,167,"2020","071"
"30566","CERIANO LAGHETTO",0,39,0,39,"2020",NA
"30567","CERIGNALE",25,0,0,25,"2020","015"
"30568","CERMENATE",6,151,8,165,"2020","064"
"30569","CERNOBBIO",1,0,0,1,"2020",NA
"30570","CERNUSCO LOMBARDONE",14,0,2,16,"2020","020"
"30571","CERNUSCO SUL NAVIGLIO",16,157,0,173,"2020","070"
"30572","CERRETO GRUE",26,0,0,26,"2020","058"
"30573","CERRETTO LANGHE",9,0,0,9,"2020","063"
"30574","CERRINA MONFERRATO",42,19,17,78,"2020","059"
"30575","CERRIONE",215,117,0,332,"2020","018"
"30576","CERRO AL LAMBRO",2,930,0,932,"2020","071"
"30577","CERRO MAGGIORE",3,75,0,78,"2020","072"
"30578","CERRO TANARO",280,0,0,280,"2020","036"
"30579","CERRO VERONESE",27,178,0,205,"2020","026"
"30580","CERTOSA DI PAVIA",24,0,0,24,"2020","046"
"30581","CERVARESE SANTA CROCE",32,154,0,186,"2020","030"
"30582","CERVASCA",1236,247,2,1485,"2020","064"
"30583","CERVENO",0,16,3,19,"2020","049"
"30584","CERVERE",1929,169,0,2098,"2020","065"
"30585","CERVIGNANO D'ADDA",0,922,0,922,"2020","018"
"30586","CESANA BRIANZA",3,19,2,24,"2020","021"
"30587","CESANA TORINESE",60,0,52,112,"2020","074"
"30588","CESANO BOSCONE",0,91,0,91,"2020","074"
"30589","CESATE",1,0,0,1,"2020","076"
"30590","CESENA",72,14,0,86,"2020","007"
"30591","CESIOMAGGIORE",215,100,3,318,"2020","011"
"30592","CESSALTO",34,109,0,143,"2020","015"
"30593","CESSOLE",175,0,0,175,"2020","037"
"30594","CETO",3,25,44,72,"2020","050"
"30595","CEVA",1376,0,0,1376,"2020","066"
"30596","CEVO",0,16,32,48,"2020","051"
"30597","CHERASCO",4935,933,110,5978,"2020","067"
"30598","CHIALAMBERTO",2,0,19,21,"2020","075"
"30599","CHIAMPO",32,53,0,85,"2020","029"
"30600","CHIANOCCO",24,5,10,39,"2020","076"
"30601","CHIARANO",6,457,0,463,"2020","016"
"30602","CHIARI",1211,5748,282,7241,"2020","052"
"30603","CHIAVENNA",1,3,1,5,"2020","018"
"30604","CHIAVERANO",24,0,0,24,"2020","077"
"30605","CHIERI",2792,486,60,3338,"2020","078"
"30606","CHIES D'ALPAGO",19,7,0,26,"2020","012"
"30607","CHIESA IN VALMALENCO",23,44,0,67,"2020","019"
"30608","CHIESANUOVA",10,0,0,10,"2020","079"
"30609","CHIEVE",0,1016,0,1016,"2020","029"
"30610","CHIGNOLO D'ISOLA",82,422,0,504,"2020","072"
"30611","CHIGNOLO PO",5,71,0,76,"2020","048"
"30612","CHIOGGIA",3511,0,0,3511,"2020","008"
"30613","CHIOMONTE",0,35,0,35,"2020","080"
"30614","CHIUDUNO",25,0,0,25,"2020","073"
"30615","CHIUPPANO",3,13,0,16,"2020","030"
"30616","CHIURO",9,1,0,10,"2020","020"
"30617","CHIUSA DI PESIO",1577,407,20,2004,"2020","068"
"30618","CHIUSA DI SAN MICHELE",0,0,66,66,"2020","081"
"30619","CHIUSANO D'ASTI",3,0,0,3,"2020","038"
"30620","CHIVASSO",1383,236,0,1619,"2020","082"
"30621","CICOGNOLO",0,1053,0,1053,"2020","030"
"30622","CICONIO",113,94,0,207,"2020","083"
"30623","CIGLIANO",269,69,44,382,"2020","042"
"30624","CIGLIE'",486,0,0,486,"2020","069"
"30625","CIGOGNOLA",2,0,0,2,"2020","049"
"30626","CIGOLE",2002,1339,0,3341,"2020","053"
"30627","CILAVEGNA",1,0,0,1,"2020","050"
"30628","CIMADOLMO",365,53,0,418,"2020","017"
"30629","CIMBERGO",4,1,0,5,"2020","054"
"30630","CINAGLIO",746,0,23,769,"2020","039"
"30631","CINGIA DE' BOTTI",47,669,265,981,"2020","031"
"30632","CINO",20,14,0,34,"2020","021"
"30633","CINTANO",35,0,0,35,"2020","084"
"30634","CINTO CAOMAGGIORE",427,0,23,450,"2020","009"
"30635","CINTO EUGANEO",34,30,0,64,"2020","031"
"30636","CINZANO",16,0,0,16,"2020","085"
"30637","CIRIE'",360,189,80,629,"2020","086"
"30638","CIRIMIDO",3,23,0,26,"2020","068"
"30639","CISANO BERGAMASCO",26,0,0,26,"2020","074"
"30640","CISERANO",15,54,0,69,"2020","075"
"30641","CISLAGO",8,0,0,8,"2020","050"
"30642","CISLIANO",166,495,0,661,"2020","078"
"30643","CISON DI VALMARINO",103,0,6,109,"2020","018"
"30644","CISSONE",2,0,0,2,"2020","070"
"30645","CISTERNA D'ASTI",69,0,0,69,"2020","040"
"30646","CITTADELLA",2124,902,153,3179,"2020","032"
"30647","CITTIGLIO",5,12,0,17,"2020","051"
"30648","CIVATE",3,0,1,4,"2020","022"
"30649","CIVIASCO",1,8,0,9,"2020","043"
"30650","CIVIDATE AL PIANO",1009,570,3,1582,"2020","076"
"30651","CIVIDATE CAMUNO",1,0,0,1,"2020","055"
"30652","CIVITELLA DI ROMAGNA",415,16,22,453,"2020","009"
"30653","CIVO",11,34,0,45,"2020","022"
"30654","CLAINO CON OSTENO",1,0,3,4,"2020","071"
"30655","CLAVESANA",343,0,0,343,"2020","071"
"30656","CLIVIO",19,87,0,106,"2020","052"
"30657","CLUSONE",66,180,0,246,"2020","077"
"30658","COASSOLO TORINESE",39,0,2,41,"2020","088"
"30659","COAZZE",14,0,1,15,"2020","089"
"30660","COAZZOLO",37,0,0,37,"2020","041"
"30661","COCCAGLIO",119,1039,2,1160,"2020","056"
"30662","COCCONATO",52,0,0,52,"2020","042"
"30663","COCQUIO-TREVISAGO",20,0,0,20,"2020","053"
"30664","CODEVIGO",521,98,0,619,"2020","033"
"30665","CODIGORO",2907,300,0,3207,"2020","005"
"30666","CODOGNE'",39,175,12,226,"2020","019"
"30667","CODOGNO",24,976,0,1000,"2020","019"
"30668","COGGIOLA",9,0,0,9,"2020","019"
"30669","COGLIATE",0,0,65,65,"2020",NA
"30670","COGOLLO DEL CENGIO",387,95,0,482,"2020","032"
"30671","COLCERESA",36,391,32,459,"2020",NA
"30672","COLERE",1,0,0,1,"2020","078"
"30673","COLI",59,0,0,59,"2020","016"
"30674","COLICO",66,95,67,228,"2020","023"
"30675","COLLE BRIANZA",5,0,2,7,"2020","024"
"30676","COLLE SANTA LUCIA",0,7,0,7,"2020","014"
"30677","COLLE UMBERTO",17,108,4,129,"2020","020"
"30678","COLLECCHIO",2,2677,0,2679,"2020","009"
"30679","COLLEGNO",186,333,5,524,"2020","090"
"30680","COLLERETTO CASTELNUOVO",0,23,0,23,"2020","091"
"30681","COLLERETTO GIACOSA",19,0,0,19,"2020","092"
"30682","COLLI VERDI",166,0,0,166,"2020",NA
"30683","COLLIO",32,64,20,116,"2020","058"
"30684","COLOGNA VENETA",10002,218,0,10220,"2020","027"
"30685","COLOGNE",475,703,2,1180,"2020","059"
"30686","COLOGNO AL SERIO",37,874,23,934,"2020","079"
"30687","COLORINA",49,380,0,429,"2020","023"
"30688","COLORNO",5,1095,0,1100,"2020","010"
"30689","COLTURANO",0,19,0,19,"2020","082"
"30690","COLVERDE",16,95,16,127,"2020",NA
"30691","COLZATE",24,34,0,58,"2020","080"
"30692","COMACCHIO",351,216,0,567,"2020","006"
"30693","COMAZZO",32,846,24,902,"2020","020"
"30694","COMELICO SUPERIORE",27,133,0,160,"2020","015"
"30695","COMERIO",6,0,0,6,"2020","055"
"30696","COMEZZANO-CIZZAGO",118,1722,2,1842,"2020","060"
"30697","COMIGNAGO",1,0,0,1,"2020","052"
"30698","COMMESSAGGIO",6,12,13,31,"2020","020"
"30699","COMO",6,58,5,69,"2020","075"
"30700","COMPIANO",15,11,0,26,"2020","011"
"30701","COMUN NUOVO",86,0,0,86,"2020","081"
"30702","CONA",15663,0,3,15666,"2020","010"
"30703","CONCAMARISE",0,276,0,276,"2020","029"
"30704","CONCESIO",8,11,0,19,"2020","061"
"30705","CONCORDIA SAGITTARIA",1078,0,0,1078,"2020","011"
"30706","CONCORDIA SULLA SECCHIA",34,308,0,342,"2020","010"
"30707","CONCOREZZO",0,29,0,29,"2020",NA
"30708","CONDOVE",141,20,38,199,"2020","093"
"30709","CONEGLIANO",31,21,4,56,"2020","021"
"30710","CONFIENZA",24,15,10,49,"2020","052"
"30711","CONIOLO",164,0,0,164,"2020","060"
"30712","CONSELICE",474,235,0,709,"2020","008"
"30713","CONSELVE",1252,36,0,1288,"2020","034"
"30714","CONZANO",121,0,0,121,"2020","061"
"30715","COPPARO",96,0,0,96,"2020","007"
"30716","CORBETTA",25,60,27,112,"2020","085"
"30717","CORBOLA",18,155,0,173,"2020","017"
"30718","CORDIGNANO",79,116,0,195,"2020","022"
"30719","CORIANO",51,135,0,186,"2020","003"
"30720","CORIO",140,54,7,201,"2020","094"
"30721","CORNA IMAGNA",35,40,0,75,"2020","082"
"30722","CORNALBA",2,17,0,19,"2020","249"
"30723","CORNAREDO",3,218,9,230,"2020","087"
"30724","CORNATE D'ADDA",23,108,0,131,"2020",NA
"30725","CORNEDO VICENTINO",7,121,0,128,"2020","034"
"30726","CORNEGLIANO LAUDENSE",0,189,0,189,"2020","021"
"30727","CORNELIANO D'ALBA",145,0,0,145,"2020","072"
"30728","CORNIGLIO",47,527,0,574,"2020","012"
"30729","CORNO GIOVINE",215,75,0,290,"2020","022"
"30730","CORNOVECCHIO",119,0,0,119,"2020","023"
"30731","CORNUDA",696,427,48,1171,"2020","023"
"30732","CORREGGIO",2,2200,0,2202,"2020","020"
"30733","CORREZZANA",14,0,0,14,"2020",NA
"30734","CORREZZOLA",5000,24,0,5024,"2020","035"
"30735","CORRIDO",25,32,4,61,"2020","077"
"30736","CORSIONE",10,0,0,10,"2020","044"
"30737","CORTANDONE",1,0,0,1,"2020",NA
"30738","CORTANZE",87,0,0,87,"2020","046"
"30739","CORTAZZONE",9,0,0,9,"2020","047"
"30740","CORTE BRUGNATELLA",114,12,0,126,"2020","017"
"30741","CORTE DE' CORTESI CON CIGNONE",2,11,213,226,"2020","032"
"30742","CORTE DE' FRATI",11,853,92,956,"2020","033"
"30743","CORTE FRANCA",105,58,15,178,"2020","062"
"30744","CORTE PALASIO",6,2091,18,2115,"2020","024"
"30745","CORTEMAGGIORE",187,1855,0,2042,"2020","018"
"30746","CORTEMILIA",207,0,0,207,"2020","073"
"30747","CORTENO GOLGI",7,108,25,140,"2020","063"
"30748","CORTENOVA",5,20,1,26,"2020","025"
"30749","CORTENUOVA",145,1341,0,1486,"2020","083"
"30750","CORTEOLONA E GENZONE",166,66,0,232,"2020",NA
"30751","CORTIGLIONE",1,0,0,1,"2020","048"
"30752","CORTINA D'AMPEZZO",6,28,0,34,"2020","016"
"30753","CORVINO SAN QUIRICO",6,0,0,6,"2020","057"
"30754","CORZANO",107,240,0,347,"2020","064"
"30755","COSIO VALTELLINO",26,601,2,629,"2020","024"
"30756","COSSANO BELBO",332,0,0,332,"2020","074"
"30757","COSSATO",270,143,0,413,"2020","020"
"30758","COSSOGNO",1,0,0,1,"2020","023"
"30759","COSTA DE' NOBILI",62,13,12,87,"2020","058"
"30760","COSTA DI MEZZATE",27,0,0,27,"2020","084"
"30761","COSTA DI ROVIGO",1,278,0,279,"2020","018"
"30762","COSTA MASNAGA",8,0,1,9,"2020","026"
"30763","COSTA SERINA",9,2,0,11,"2020","247"
"30764","COSTA VALLE IMAGNA",3,6,0,9,"2020","085"
"30765","COSTA VESCOVATO",29,0,0,29,"2020","062"
"30766","COSTA VOLPINO",16,35,0,51,"2020","086"
"30767","COSTABISSARA",24,43,3,70,"2020","035"
"30768","COSTERMANO",19,55,0,74,"2020","030"
"30769","COSTIGLIOLE D'ASTI",422,0,0,422,"2020","050"
"30770","COSTIGLIOLE SALUZZO",489,3,22,514,"2020","075"
"30771","COTIGNOLA",86,0,0,86,"2020","009"
"30772","COVO",4,1222,0,1226,"2020","087"
"30773","CRANDOLA VALSASSINA",1,5,3,9,"2020","027"
"30774","CRAVAGLIANA",0,24,0,24,"2020","048"
"30775","CRAVANZANA",3,0,0,3,"2020","076"
"30776","CRAVEGGIA",9,0,0,9,"2020","024"
"30777","CREAZZO",10,29,0,39,"2020","036"
"30778","CREDARO",7,177,0,184,"2020","088"
"30779","CREDERA RUBBIANO",1,1400,26,1427,"2020","034"
"30780","CREMA",274,1972,305,2551,"2020","035"
"30781","CREMELLA",5,0,0,5,"2020","028"
"30782","CREMENO",25,30,0,55,"2020","029"
"30783","CREMIA",3,0,2,5,"2020","083"
"30784","CREMOLINO",81,0,0,81,"2020","063"
"30785","CREMONA",103,1314,1,1418,"2020","036"
"30786","CREMOSANO",23,593,0,616,"2020","037"
"30787","CRESCENTINO",128,0,37,165,"2020","049"
"30788","CRESPADORO",26,61,0,87,"2020","037"
"30789","CRESPIATICA",3,299,0,302,"2020","025"
"30790","CRESPINO",2160,0,0,2160,"2020","019"
"30791","CRESSA",72,260,0,332,"2020","055"
"30792","CREVACUORE",3,0,0,3,"2020","021"
"30793","CREVALCORE",229,23,0,252,"2020","024"
"30794","CREVOLADOSSOLA",26,36,64,126,"2020","025"
"30795","CROCETTA DEL MONTELLO",68,48,0,116,"2020","025"
"30796","CRODO",15,91,35,141,"2020","026"
"30797","CROTTA D'ADDA",1,554,0,555,"2020","038"
"30798","CUASSO AL MONTE",21,0,0,21,"2020","058"
"30799","CUCCIAGO",5,0,0,5,"2020","084"
"30800","CUCEGLIO",70,0,0,70,"2020","096"
"30801","CUGGIONO",584,17,0,601,"2020","096"
"30802","CUMIANA",1396,587,11,1994,"2020","097"
"30803","CUMIGNANO SUL NAVIGLIO",1,1291,0,1292,"2020","039"
"30804","CUNARDO",1,0,0,1,"2020","060"
"30805","CUNEO",7682,911,1080,9673,"2020","078"
"30806","CUNICO",1812,0,0,1812,"2020","051"
"30807","CUORGNE'",214,50,0,264,"2020","098"
"30808","CURA CARPIGNANO",12,130,2,144,"2020","060"
"30809","CUREGGIO",19,27,0,46,"2020","058"
"30810","CURIGLIA CON MONTEVIASCO",2,0,1,3,"2020","061"
"30811","CURINO",6,0,0,6,"2020","023"
"30812","CURNO",29,38,0,67,"2020","089"
"30813","CURTAROLO",81,218,18,317,"2020","036"
"30814","CURTATONE",3346,1713,758,5817,"2020","021"
"30815","CUSAGO",0,761,2,763,"2020","097"
"30816","CUSINO",9,0,0,9,"2020","085"
"30817","CUVEGLIO",9,3,0,12,"2020","062"
"30818","CUVIO",1,88,5,94,"2020","063"
"30819","DAIRAGO",20,40,0,60,"2020","099"
"30820","DALMINE",118,111,0,229,"2020","091"
"30821","DARFO BOARIO TERME",8,254,34,296,"2020","065"
"30822","DAVERIO",16,0,0,16,"2020","064"
"30823","DAZIO",0,14,0,14,"2020","025"
"30824","DELEBIO",19,118,48,185,"2020","026"
"30825","DELLO",684,2182,14,2880,"2020","066"
"30826","DEMONTE",938,89,0,1027,"2020","079"
"30827","DENICE",8,0,0,8,"2020","065"
"30828","DERNICE",19,0,1,20,"2020","066"
"30829","DEROVERE",24,333,0,357,"2020","040"
"30830","DESANA",30,0,0,30,"2020","054"
"30831","DESENZANO DEL GARDA",41,1315,690,2046,"2020","067"
"30832","DESIO",25,0,0,25,"2020",NA
"30833","DIANO D'ALBA",78,0,0,78,"2020","080"
"30834","DIVIGNANO",48,0,1,49,"2020","060"
"30835","DIZZASCO",0,0,5,5,"2020","087"
"30836","DOGLIANI",1713,0,0,1713,"2020","081"
"30837","DOLO",694,264,0,958,"2020","012"
"30838","DOMASO",0,4,0,4,"2020","089"
"30839","DOMODOSSOLA",21,21,11,53,"2020","028"
"30840","DONATO",134,0,44,178,"2020","024"
"30841","DONGO",5,2,3,10,"2020","090"
"30842","DORMELLETTO",5,0,0,5,"2020","062"
"30843","DORNO",14,10,0,24,"2020","061"
"30844","DORZANO",4,0,0,4,"2020","025"
"30845","DOSOLO",0,343,81,424,"2020","022"
"30846","DOSSENA",28,109,1,138,"2020","092"
"30847","DOSSO DEL LIRO",1,2,8,11,"2020","092"
"30848","DOVADOLA",161,0,0,161,"2020","011"
"30849","DOVERA",107,1228,0,1335,"2020","041"
"30850","DOZZA",6,19,0,25,"2020","025"
"30851","DRONERO",2179,260,23,2462,"2020","082"
"30852","DRUENTO",588,43,0,631,"2020","099"
"30853","DRUOGNO",13,3,2,18,"2020","029"
"30854","DUBINO",26,582,18,626,"2020","027"
"30855","DUE CARRARE",194,0,0,194,"2020","106"
"30856","DUEVILLE",383,573,0,956,"2020","038"
"30857","DUMENZA",3,0,7,10,"2020","065"
"30858","DUSINO SAN MICHELE",358,52,0,410,"2020","052"
"30859","EDOLO",9,44,21,74,"2020","068"
"30860","ELLO",1,0,0,1,"2020","033"
"30861","ELVA",14,0,19,33,"2020","083"
"30862","ENDINE GAIANO",73,93,7,173,"2020","093"
"30863","ENEGO",3,167,0,170,"2020","039"
"30864","ENTRACQUE",222,0,0,222,"2020","084"
"30865","ENTRATICO",33,39,0,72,"2020","094"
"30866","ENVIE",1778,336,231,2345,"2020","085"
"30867","ERACLEA",4184,324,0,4508,"2020","013"
"30868","ERBA",15,358,3,376,"2020","095"
"30869","ERBE'",286,38,0,324,"2020","032"
"30870","ERBEZZO",42,685,0,727,"2020","033"
"30871","ERBUSCO",251,33,0,284,"2020","069"
"30872","ERVE",1,0,0,1,"2020","034"
"30873","ESINE",3,156,8,167,"2020","070"
"30874","ESINO LARIO",8,0,23,31,"2020","035"
"30875","ESTE",1150,45,0,1195,"2020","037"
"30876","EUPILIO",17,0,45,62,"2020","097"
"30877","EXILLES",2,0,0,2,"2020",NA
"30878","FABBRICA CURONE",4,6,0,10,"2020","067"
"30879","FABBRICO",0,225,0,225,"2020","021"
"30880","FAEDO VALTELLINO",4,20,0,24,"2020","028"
"30881","FAENZA",208,80,0,288,"2020","010"
"30882","FAGGETO LARIO",4,0,6,10,"2020","098"
"30883","FAGNANO OLONA",9,5,0,14,"2020","067"
"30884","FALCADE",10,38,0,48,"2020","019"
"30885","FALOPPIO",5,0,3,8,"2020","099"
"30886","FANANO",30,496,0,526,"2020","011"
"30887","FARA GERA D'ADDA",13,660,0,673,"2020","096"
"30888","FARA NOVARESE",4,0,0,4,"2020","065"
"30889","FARA OLIVANA CON SOLA",136,225,0,361,"2020","097"
"30890","FARA VICENTINO",39,358,119,516,"2020","040"
"30891","FARIGLIANO",569,0,0,569,"2020","086"
"30892","FARINI",73,74,0,147,"2020","019"
"30893","FARRA DI SOLIGO",65,22,23,110,"2020","026"
"30894","FAULE",37,0,141,178,"2020","087"
"30895","FAVRIA",330,710,102,1142,"2020","101"
"30896","FEISOGLIO",75,0,0,75,"2020","088"
"30897","FELETTO",7,2,0,9,"2020","102"
"30898","FELINO",13,1178,0,1191,"2020","013"
"30899","FELIZZANO",19,0,0,19,"2020","068"
"30900","FELTRE",156,1083,2,1241,"2020","021"
"30901","FENEGRO'",41,3,22,66,"2020","100"
"30902","FENESTRELLE",29,0,0,29,"2020","103"
"30903","FERNO",0,0,4,4,"2020","068"
"30904","FERRARA",255,145,0,400,"2020","008"
"30905","FERRARA DI MONTE BALDO",4,14,10,28,"2020","034"
"30906","FERRERA DI VARESE",16,0,0,16,"2020","069"
"30907","FERRERA ERBOGNONE",16,0,0,16,"2020","062"
"30908","FERRERE",880,0,0,880,"2020","053"
"30909","FERRIERE",105,2,0,107,"2020","020"
"30910","FIANO",16,0,0,16,"2020","104"
"30911","FICAROLO",34,0,0,34,"2020","021"
"30912","FIDENZA",177,3947,0,4124,"2020","014"
"30913","FIESCO",10,832,0,842,"2020","043"
"30914","FIESSE",638,426,341,1405,"2020","071"
"30915","FIESSO D'ARTICO",3,37,0,40,"2020","014"
"30916","FIESSO UMBERTIANO",115,0,0,115,"2020","022"
"30917","FIGINO SERENZA",60,88,1,149,"2020","101"
"30918","FILAGO",145,0,0,145,"2020","098"
"30919","FINALE EMILIA",9,64,0,73,"2020","012"
"30920","FINO DEL MONTE",4,37,0,41,"2020","099"
"30921","FINO MORNASCO",13,0,0,13,"2020","102"
"30922","FIORANO AL SERIO",2,13,0,15,"2020","100"
"30923","FIORANO CANAVESE",13,0,0,13,"2020","105"
"30924","FIORANO MODENESE",8,41,0,49,"2020","013"
"30925","FIORENZUOLA D'ARDA",152,2230,0,2382,"2020","021"
"30926","FISCAGLIA",1619,82,0,1701,"2020",NA
"30927","FIUMALBO",100,60,0,160,"2020","014"
"30928","FLERO",416,224,96,736,"2020","072"
"30929","FOBELLO",14,0,3,17,"2020","057"
"30930","FOGLIZZO",148,0,0,148,"2020","106"
"30931","FOLLINA",328,91,0,419,"2020","027"
"30932","FOMBIO",266,221,0,487,"2020","026"
"30933","FONTANELICE",192,89,0,281,"2020","026"
"30934","FONTANELLA",3120,2286,0,5406,"2020","101"
"30935","FONTANELLATO",36,2074,0,2110,"2020","015"
"30936","FONTANELLE",67,409,36,512,"2020","028"
"30937","FONTANETO D'AGOGNA",4,113,0,117,"2020","066"
"30938","FONTANETTO PO",4,0,0,4,"2020","058"
"30939","FONTANILE",2,0,0,2,"2020","054"
"30940","FONTANIVA",242,329,1,572,"2020","038"
"30941","FONTE",955,592,0,1547,"2020","029"
"30942","FONTENO",9,0,0,9,"2020","102"
"30943","FONTEVIVO",0,1764,0,1764,"2020","016"
"30944","FONZASO",44,50,0,94,"2020","022"
"30945","FOPPOLO",2,8,0,10,"2020","103"
"30946","FORCOLA",18,115,0,133,"2020","029"
"30947","FORESTO SPARSO",18,69,4,91,"2020","104"
"30948","FORLI'",454,75,0,529,"2020","012"
"30949","FORLIMPOPOLI",11,0,0,11,"2020","013"
"30950","FORMAZZA",2,18,5,25,"2020","031"
"30951","FORMIGARA",6,1323,120,1449,"2020","044"
"30952","FORMIGINE",9,1879,0,1888,"2020","015"
"30953","FORMIGLIANA",19,0,0,19,"2020","059"
"30954","FORNO CANAVESE",42,0,0,42,"2020","107"
"30955","FORNOVO DI TARO",4,651,0,655,"2020","017"
"30956","FORNOVO SAN GIOVANNI",42,725,0,767,"2020","105"
"30957","FORTUNAGO",50,0,0,50,"2020","064"
"30958","FOSSALTA DI PIAVE",3,0,0,3,"2020","015"
"30959","FOSSALTA DI PORTOGRUARO",0,708,0,708,"2020","016"
"30960","FOSSANO",19388,4377,1197,24962,"2020","089"
"30961","FOSSO'",112,24,0,136,"2020","017"
"30962","FOZA",38,13,27,78,"2020","041"
"30963","FRABOSA SOPRANA",425,0,152,577,"2020","090"
"30964","FRABOSA SOTTANA",64,26,41,131,"2020","091"
"30965","FRACONALTO",32,0,2,34,"2020","069"
"30966","FRASCAROLO",268,34,0,302,"2020","065"
"30967","FRASSINELLE POLESINE",4,0,0,4,"2020","023"
"30968","FRASSINELLO MONFERRATO",49,0,0,49,"2020","072"
"30969","FRASSINETO PO",42,0,0,42,"2020","073"
"30970","FRASSINETTO",71,5,0,76,"2020","108"
"30971","FRASSINO",21,0,8,29,"2020","092"
"30972","FRASSINORO",69,151,0,220,"2020","016"
"30973","FRATTA POLESINE",325,132,0,457,"2020","024"
"30974","FREGONA",6,26,2,34,"2020","030"
"30975","FRESONARA",17,0,0,17,"2020","074"
"30976","FRINCO",284,0,0,284,"2020","055"
"30977","FRONT",57,0,20,77,"2020","109"
"30978","FROSSASCO",1855,0,115,1970,"2020","110"
"30979","FRUGAROLO",126,148,0,274,"2020","075"
"30980","FUBINE",216,0,0,216,"2020","076"
"30981","FUIPIANO VALLE IMAGNA",22,33,0,55,"2020","106"
"30982","FUMANE",17,35,0,52,"2020","035"
"30983","FUSIGNANO",4,0,0,4,"2020","011"
"30984","FUSINE",24,38,0,62,"2020","030"
"30985","GABBIONETA-BINANUOVA",18,800,0,818,"2020","045"
"30986","GABIANO",50,0,0,50,"2020","077"
"30987","GADESCO-PIEVE DELMONA",129,560,0,689,"2020","046"
"30988","GAGGIANO",1,477,4,482,"2020","103"
"30989","GAGGIO MONTANO",283,290,0,573,"2020","027"
"30990","GAGLIANICO",3,0,0,3,"2020","026"
"30991","GAIARINE",522,0,0,522,"2020","031"
"30992","GAIBA",15,0,0,15,"2020","025"
"30993","GAIOLA",21,0,0,21,"2020","093"
"30994","GALBIATE",41,9,8,58,"2020","036"
"30995","GALEATA",230,0,14,244,"2020","014"
"30996","GALGAGNANO",0,756,0,756,"2020","027"
"30997","GALLARATE",10,0,19,29,"2020","070"
"30998","GALLIATE",6,89,0,95,"2020","068"
"30999","GALLIATE LOMBARDO",23,0,0,23,"2020","071"
"31000","GALLIERA",0,29,0,29,"2020","028"
"31001","GALLIERA VENETA",3171,130,0,3301,"2020","039"
"31002","GALLIO",4,193,1,198,"2020","042"
"31003","GALZIGNANO TERME",7,0,0,7,"2020","040"
"31004","GAMALERO",17,0,0,17,"2020","078"
"31005","GAMBARA",4783,2486,415,7684,"2020","073"
"31006","GAMBASCA",2,0,0,2,"2020","094"
"31007","GAMBOLO'",81,125,1,207,"2020","068"
"31008","GAMBUGLIANO",0,45,30,75,"2020","044"
"31009","GANDELLINO",16,0,0,16,"2020","107"
"31010","GANDINO",62,127,0,189,"2020","108"
"31011","GANDOSSO",20,0,0,20,"2020","109"
"31012","GARBAGNA",71,0,0,71,"2020","079"
"31013","GARBAGNA NOVARESE",3,0,0,3,"2020","069"
"31014","GARBAGNATE MILANESE",7,0,0,7,"2020",NA
"31015","GARBAGNATE MONASTERO",5,0,0,5,"2020","037"
"31016","GARDA",2,0,0,2,"2020","036"
"31017","GARDONE RIVIERA",4,0,1,5,"2020","074"
"31018","GARDONE VAL TROMPIA",21,0,0,21,"2020","075"
"31019","GARESSIO",200,0,24,224,"2020","095"
"31020","GARGNANO",19,0,9,28,"2020","076"
"31021","GARLASCO",14,1,3,18,"2020","069"
"31022","GARZENO",8,3,20,31,"2020","106"
"31023","GARZIGLIANA",255,0,0,255,"2020","111"
"31024","GASSINO TORINESE",27,0,0,27,"2020","112"
"31025","GATTATICO",13,2858,0,2871,"2020","022"
"31026","GATTEO",6,0,0,6,"2020","016"
"31027","GATTICO-VERUNO",18,270,76,364,"2020",NA
"31028","GATTINARA",82,0,0,82,"2020","061"
"31029","GAVARDO",83,359,155,597,"2020","077"
"31030","GAVELLO",146,0,0,146,"2020",NA
"31031","GAVERINA TERME",11,42,0,53,"2020","110"
"31032","GAVI",6,0,0,6,"2020","081"
"31033","GAVIRATE",49,0,0,49,"2020","072"
"31034","GAZOLDO DEGLI IPPOLITI",624,112,3,739,"2020","024"
"31035","GAZZADA SCHIANNO",6,0,9,15,"2020","073"
"31036","GAZZANIGA",14,43,0,57,"2020","111"
"31037","GAZZO",36,2737,0,2773,"2020","041"
"31038","GAZZO VERONESE",1045,243,0,1288,"2020","037"
"31039","GAZZOLA",217,1648,0,1865,"2020","022"
"31040","GAZZUOLO",601,31,4,636,"2020","025"
"31041","GEMMANO",22,66,0,88,"2020","004"
"31042","GEMONIO",2,0,0,2,"2020","074"
"31043","GENIVOLTA",103,1899,0,2002,"2020","047"
"31044","GENOLA",1646,2180,225,4051,"2020","096"
"31045","GERA LARIO",12,327,5,344,"2020","107"
"31046","GERENZAGO",2,0,0,2,"2020","071"
"31047","GERENZANO",98,111,0,209,"2020","075"
"31048","GERMAGNANO",11,0,0,11,"2020","113"
"31049","GERMAGNO",2,0,0,2,"2020","032"
"31050","GERMIGNAGA",9,81,0,90,"2020","076"
"31051","GERRE DE' CAPRIOLI",0,485,0,485,"2020","048"
"31052","GESSATE",4,441,0,445,"2020","106"
"31053","GHEDI",3718,6623,134,10475,"2020","078"
"31054","GHEMME",35,0,12,47,"2020","073"
"31055","GHIFFA",2,0,5,7,"2020","033"
"31056","GHISALBA",1,849,0,850,"2020","113"
"31057","GHISLARENGO",35,0,0,35,"2020","062"
"31058","GIAGLIONE",20,0,0,20,"2020","114"
"31059","GIANICO",119,111,147,377,"2020","079"
"31060","GIAVENO",196,409,141,746,"2020","115"
"31061","GIAVERA DEL MONTELLO",896,145,0,1041,"2020","032"
"31062","GIGNESE",4,0,3,7,"2020","034"
"31063","GIUSSAGO",9,135,0,144,"2020","072"
"31064","GIUSSANO",3,0,0,3,"2020",NA
"31065","GIVOLETTO",26,0,0,26,"2020","116"
"31066","GODEGA DI SANT'URBANO",33,59,44,136,"2020","033"
"31067","GODIASCO",2,0,0,2,"2020","073"
"31068","GOITO",3394,5099,1053,9546,"2020","026"
"31069","GOLASECCA",32,0,0,32,"2020","077"
"31070","GOLFERENZO",0,0,35,35,"2020","074"
"31071","GOMBITO",3,1092,0,1095,"2020","049"
"31072","GONZAGA",15412,4271,2735,22418,"2020","027"
"31073","GORDONA",83,108,35,226,"2020","032"
"31074","GORGO AL MONTICANO",85,268,0,353,"2020","034"
"31075","GORGONZOLA",34,269,0,303,"2020","108"
"31076","GORLA MAGGIORE",3,0,219,222,"2020","078"
"31077","GORLA MINORE",79,0,0,79,"2020","079"
"31078","GORLAGO",73,296,3,372,"2020","114"
"31079","GORLE",2,0,0,2,"2020","115"
"31080","GORNATE-OLONA",10,0,2,12,"2020","080"
"31081","GORNO",22,61,0,83,"2020","116"
"31082","GORZEGNO",67,0,0,67,"2020","097"
"31083","GOSALDO",5,0,0,5,"2020",NA
"31084","GOSSOLENGO",5,681,0,686,"2020","023"
"31085","GOTTASECCA",46,0,0,46,"2020","098"
"31086","GOTTOLENGO",14352,1255,84,15691,"2020","080"
"31087","GOVONE",333,0,0,333,"2020","099"
"31088","GOZZANO",1,0,0,1,"2020","076"
"31089","GRAFFIGNANA",53,286,59,398,"2020","028"
"31090","GRAGLIA",66,20,82,168,"2020","028"
"31091","GRAGNANO TREBBIENSE",5,3383,0,3388,"2020","024"
"31092","GRANA",57,0,0,57,"2020","056"
"31093","GRANAROLO DELL'EMILIA",234,247,0,481,"2020","030"
"31094","GRANDOLA ED UNITI",0,9,46,55,"2020","111"
"31095","GRANOZZO CON MONTICELLO",0,60,0,60,"2020","077"
"31096","GRANTOLA",68,0,0,68,"2020","081"
"31097","GRANTORTO",77,790,0,867,"2020","042"
"31098","GRANZE",748,0,0,748,"2020","043"
"31099","GRASSOBBIO",9,127,0,136,"2020","117"
"31100","GRAVEDONA ED UNITI",6,16,43,65,"2020","249"
"31101","GRAVELLONA LOMELLINA",0,18,9,27,"2020","075"
"31102","GRAVELLONA TOCE",13,0,0,13,"2020","035"
"31103","GRAVERE",8,0,0,8,"2020","117"
"31104","GRAZZANO BADOGLIO",374,0,0,374,"2020","057"
"31105","GREMIASCO",41,0,0,41,"2020","083"
"31106","GREZZAGO",2,0,0,2,"2020","110"
"31107","GREZZANA",111,510,19,640,"2020","038"
"31108","GRIANTE",5,0,7,12,"2020","113"
"31109","GRIGNASCO",10,9,0,19,"2020","079"
"31110","GRINZANE CAVOUR",14,0,0,14,"2020","100"
"31111","GRISIGNANO DI ZOCCO",36,414,0,450,"2020","046"
"31112","GRIZZANA MORANDI",56,0,0,56,"2020","031"
"31113","GROMO",38,114,0,152,"2020","118"
"31114","GRONDONA",1,0,0,1,"2020","085"
"31115","GRONE",18,23,0,41,"2020","119"
"31116","GRONTARDO",160,2074,0,2234,"2020","050"
"31117","GROPELLO CAIROLI",28,0,0,28,"2020","076"
"31118","GROPPARELLO",83,23,0,106,"2020","025"
"31119","GROSCAVALLO",10,0,0,10,"2020","118"
"31120","GROSIO",15,191,4,210,"2020","033"
"31121","GROSOTTO",6,31,37,74,"2020","034"
"31122","GROSSO",57,0,0,57,"2020","119"
"31123","GRUARO",14,193,0,207,"2020","018"
"31124","GRUGLIASCO",108,0,36,144,"2020","120"
"31125","GRUMELLO CREMONESE ED UNITI",258,1854,0,2112,"2020","051"
"31126","GRUMELLO DEL MONTE",33,103,0,136,"2020","120"
"31127","GRUMOLO DELLE ABBADESSE",39,171,0,210,"2020","047"
"31128","GUALTIERI",1246,443,0,1689,"2020","023"
"31129","GUANZATE",10,0,26,36,"2020","114"
"31130","GUARDA VENETA",618,0,0,618,"2020","028"
"31131","GUARDABOSONE",48,10,0,58,"2020","066"
"31132","GUARDAMIGLIO",5,80,416,501,"2020","029"
"31133","GUARENE",298,0,0,298,"2020","101"
"31134","GUASTALLA",54,1176,0,1230,"2020","024"
"31135","GUDO VISCONTI",9,0,0,9,"2020","112"
"31136","GUIDIZZOLO",1195,857,282,2334,"2020","028"
"31137","GUIGLIA",10,575,0,585,"2020","017"
"31138","GUSSAGO",51,974,132,1157,"2020","081"
"31139","GUSSOLA",0,59,9,68,"2020","052"
"31140","IDRO",4,0,6,10,"2020","082"
"31141","IGLIANO",60,0,23,83,"2020","102"
"31142","ILLASI",0,48,0,48,"2020","039"
"31143","IMBERSAGO",0,0,1,1,"2020","039"
"31144","IMOLA",71,0,0,71,"2020","032"
"31145","INARZO",13,0,0,13,"2020","082"
"31146","INCISA SCAPACCINO",35,0,0,35,"2020","058"
"31147","INCUDINE",4,0,0,4,"2020","083"
"31148","INDUNO OLONA",20,100,0,120,"2020","083"
"31149","INTRAGNA",3,0,0,3,"2020","037"
"31150","INTROBIO",8,18,80,106,"2020","040"
"31151","INVERIGO",111,0,39,150,"2020","118"
"31152","INVERNO E MONTELEONE",56,173,30,259,"2020","077"
"31153","INVERSO PINASCA",32,0,0,32,"2020","122"
"31154","INVERUNO",0,48,11,59,"2020","113"
"31155","INVORIO",38,97,0,135,"2020","082"
"31156","INZAGO",314,616,94,1024,"2020","114"
"31157","IRMA",8,0,0,8,"2020","084"
"31158","ISASCA",15,0,0,15,"2020","103"
"31159","ISEO",28,24,0,52,"2020","085"
"31160","ISOLA D'ASTI",491,0,0,491,"2020","059"
"31161","ISOLA DELLA SCALA",7207,382,0,7589,"2020","040"
"31162","ISOLA DI FONDRA",4,19,0,23,"2020","121"
"31163","ISOLA DOVARESE",0,751,0,751,"2020","053"
"31164","ISOLA RIZZA",1872,383,3,2258,"2020","041"
"31165","ISOLA VICENTINA",1712,697,32,2441,"2020","048"
"31166","ISOLABELLA",22,0,517,539,"2020","123"
"31167","ISORELLA",11011,395,10,11416,"2020","086"
"31168","ISPRA",53,211,0,264,"2020","084"
"31169","ISSIGLIO",83,20,19,122,"2020","124"
"31170","ISSO",12,1141,0,1153,"2020","122"
"31171","ISTRANA",2791,373,49,3213,"2020","035"
"31172","IVREA",352,216,11,579,"2020","125"
"31173","IZANO",1,1060,0,1061,"2020","054"
"31174","JERAGO CON ORAGO",2,0,0,2,"2020","085"
"31175","JESOLO",3,89,0,92,"2020",NA
"31176","JOLANDA DI SAVOIA",4293,0,0,4293,"2020","010"
"31177","LA CASSA",0,313,0,313,"2020","126"
"31178","LA LOGGIA",168,0,104,272,"2020","127"
"31179","LA MORRA",73,0,0,73,"2020","105"
"31180","LA VALLE AGORDINA",8,19,5,32,"2020","027"
"31181","LA VALLETTA BRIANZA",12,14,5,31,"2020",NA
"31182","LACCHIARELLA",58,48,0,106,"2020","115"
"31183","LAGNASCO",23,0,52,75,"2020","104"
"31184","LAGOSANTO",55,0,0,55,"2020","011"
"31185","LAINATE",13,0,0,13,"2020","116"
"31186","LAINO",5,1,0,6,"2020","120"
"31187","LAMA MOCOGNO",64,386,0,450,"2020","018"
"31188","LAMBRUGO",0,112,0,112,"2020","121"
"31189","LAMON",4,33,0,37,"2020","026"
"31190","LAMPORO",35,0,0,35,"2020","067"
"31191","LANDRIANO",4,237,0,241,"2020","078"
"31192","LANGHIRANO",0,887,2,889,"2020","018"
"31193","LANGOSCO",6,0,0,6,"2020","079"
"31194","LANZADA",21,74,5,100,"2020","036"
"31195","LANZO TORINESE",165,0,14,179,"2020","128"
"31196","LARDIRAGO",0,0,1,1,"2020",NA
"31197","LASNIGO",0,25,0,25,"2020","123"
"31198","LAURIANO",24,0,0,24,"2020","129"
"31199","LAVAGNO",1,0,0,1,"2020",NA
"31200","LAVENA PONTE TRESA",4,0,0,4,"2020","086"
"31201","LAVENO-MOMBELLO",1,0,0,1,"2020","087"
"31202","LAVENONE",23,0,0,23,"2020","087"
"31203","LAZISE",98,20,0,118,"2020","043"
"31204","LAZZATE",2,0,17,19,"2020",NA
"31205","LECCO",12,25,16,53,"2020","042"
"31206","LEFFE",12,96,1,109,"2020","124"
"31207","LEGGIUNO",3,0,0,3,"2020","088"
"31208","LEGNAGO",51,23,80,154,"2020","044"
"31209","LEGNANO",0,95,0,95,"2020","118"
"31210","LEGNARO",189,43,0,232,"2020","044"
"31211","LEINI'",792,575,72,1439,"2020","130"
"31212","LEMIE",11,0,0,11,"2020","131"
"31213","LENDINARA",651,101,0,752,"2020","029"
"31214","LENNA",3,13,0,16,"2020","125"
"31215","LENO",4986,7177,1068,13231,"2020","088"
"31216","LENTA",0,20,0,20,"2020","068"
"31217","LENTATE SUL SEVESO",2,207,13,222,"2020",NA
"31218","LEQUIO BERRIA",19,0,0,19,"2020","106"
"31219","LEQUIO TANARO",2389,0,0,2389,"2020","107"
"31220","LERMA",19,0,0,19,"2020","088"
"31221","LESA",2,0,0,2,"2020","084"
"31222","LESEGNO",385,0,0,385,"2020","108"
"31223","LESIGNANO DE' BAGNI",44,1597,0,1641,"2020","019"
"31224","LESMO",4,170,34,208,"2020",NA
"31225","LESSOLO",82,9,0,91,"2020","132"
"31226","LESSONA",19,0,0,19,"2020","029"
"31227","LEVICE",60,0,0,60,"2020","109"
"31228","LEZZENO",0,0,3,3,"2020","126"
"31229","LIERNA",5,5,1,11,"2020","043"
"31230","LIMANA",77,114,0,191,"2020","029"
"31231","LIMENA",523,629,41,1193,"2020","045"
"31232","LIMIDO COMASCO",2,30,0,32,"2020","128"
"31233","LIMONE PIEMONTE",23,0,0,23,"2020","110"
"31234","LINAROLO",8,341,0,349,"2020","081"
"31235","LIRIO",36,0,0,36,"2020","082"
"31236","LISCATE",6,0,0,6,"2020","122"
"31237","LISIO",64,0,0,64,"2020","111"
"31238","LISSONE",46,0,267,313,"2020",NA
"31239","LIVIGNO",68,298,3,369,"2020","037"
"31240","LIVINALLONGO DEL COL DI LANA",3,63,0,66,"2020","030"
"31241","LIVO",5,11,0,16,"2020","130"
"31242","LIVORNO FERRARIS",8,59,0,67,"2020","071"
"31243","LIVRAGA",32,992,71,1095,"2020","030"
"31244","LIZZANO IN BELVEDERE",13,99,30,142,"2020","033"
"31245","LOAZZOLO",24,0,2,26,"2020","060"
"31246","LOCANA",115,40,0,155,"2020","134"
"31247","LOCATE DI TRIULZI",6,1028,0,1034,"2020","125"
"31248","LOCATE VARESINO",13,1,0,14,"2020","131"
"31249","LOCATELLO",33,16,0,49,"2020","127"
"31250","LODI",576,1187,63,1826,"2020","031"
"31251","LODI VECCHIO",0,1416,0,1416,"2020","032"
"31252","LODRINO",7,9,0,16,"2020","090"
"31253","LOGRATO",1140,831,8,1979,"2020","091"
"31254","LOIANO",34,235,0,269,"2020","034"
"31255","LOMAZZO",1,0,0,1,"2020","133"
"31256","LOMBARDORE",35,8,0,43,"2020","135"
"31257","LOMBRIASCO",101,137,0,238,"2020","136"
"31258","LOMELLO",0,176,0,176,"2020","083"
"31259","LONATE CEPPINO",1,260,0,261,"2020","089"
"31260","LONATE POZZOLO",6,0,6,12,"2020","090"
"31261","LONATO DEL GARDA",2629,4907,1040,8576,"2020",NA
"31262","LONGARE",74,162,0,236,"2020","051"
"31263","LONGARONE",11,0,0,11,"2020","031"
"31264","LONGHENA",0,399,0,399,"2020","093"
"31265","LONGIANO",18,0,0,18,"2020","018"
"31266","LONIGO",4988,467,0,5455,"2020","052"
"31267","LORANZE'",26,0,0,26,"2020","137"
"31268","LOREGGIA",220,462,2,684,"2020","046"
"31269","LOREGLIA",7,0,0,7,"2020","038"
"31270","LORENZAGO DI CADORE",0,9,0,9,"2020","032"
"31271","LOREO",886,53,0,939,"2020","030"
"31272","LORIA",5381,27,0,5408,"2020","036"
"31273","LOSINE",0,1,0,1,"2020","094"
"31274","LOVERE",4,39,0,43,"2020","128"
"31275","LOVERO",5,6,0,11,"2020","038"
"31276","LOZIO",0,5,0,5,"2020","095"
"31277","LOZZA",0,126,0,126,"2020","091"
"31278","LOZZO ATESTINO",1390,4,0,1394,"2020","047"
"31279","LU E CUCCARO MONFERRATO",59,0,0,59,"2020",NA
"31280","LUGAGNANO VAL D'ARDA",55,196,0,251,"2020","026"
"31281","LUGO",434,60,0,494,"2020","012"
"31282","LUGO DI VICENZA",16,116,0,132,"2020","053"
"31283","LUINO",1,11,0,12,"2020","092"
"31284","LUISAGO",9,0,0,9,"2020","135"
"31285","LUMEZZANE",21,0,0,21,"2020","096"
"31286","LURAGO D'ERBA",2,0,8,10,"2020","136"
"31287","LURAGO MARINONE",0,147,0,147,"2020","137"
"31288","LURANO",39,0,5,44,"2020","129"
"31289","LURATE CACCIVIO",39,0,113,152,"2020","138"
"31290","LUSERNA SAN GIOVANNI",466,49,46,561,"2020","139"
"31291","LUSERNETTA",100,0,0,100,"2020","140"
"31292","LUSIA",23,0,0,23,"2020","031"
"31293","LUSIANA CONCO",41,228,17,286,"2020",NA
"31294","LUSIGLIE'",119,0,0,119,"2020","141"
"31295","LUZZANA",15,0,0,15,"2020","130"
"31296","LUZZARA",2013,1304,0,3317,"2020","026"
"31297","MACCAGNO CON PINO E VEDDASCA",0,19,0,19,"2020",NA
"31298","MACCASTORNA",0,17,556,573,"2020","033"
"31299","MACELLO",1336,187,307,1830,"2020","142"
"31300","MACLODIO",37,192,0,229,"2020","097"
"31301","MACRA",4,0,0,4,"2020",NA
"31302","MACUGNAGA",4,13,0,17,"2020","039"
"31303","MADIGNANO",56,740,0,796,"2020","055"
"31304","MADONE",12,0,0,12,"2020","131"
"31305","MADONNA DEL SASSO",24,0,0,24,"2020","040"
"31306","MAGASA",10,12,0,22,"2020","098"
"31307","MAGENTA",34,733,27,794,"2020","130"
"31308","MAGGIORA",94,62,0,156,"2020","088"
"31309","MAGHERNO",0,114,0,114,"2020","085"
"31310","MAGLIANO ALFIERI",347,0,0,347,"2020","113"
"31311","MAGLIANO ALPI",521,99,0,620,"2020","114"
"31312","MAGNACAVALLO",64,272,528,864,"2020","029"
"31313","MAGNAGO",57,0,0,57,"2020","131"
"31314","MAGNANO",34,8,0,42,"2020","030"
"31315","MAIOLO",136,0,0,136,"2020","022"
"31316","MAIRAGO",0,386,0,386,"2020","034"
"31317","MAIRANO",312,570,0,882,"2020","099"
"31318","MALAGNINO",211,750,0,961,"2020","056"
"31319","MALCESINE",19,84,0,103,"2020","045"
"31320","MALEGNO",12,32,2,46,"2020","100"
"31321","MALEO",49,1376,23,1448,"2020","035"
"31322","MALESCO",4,0,6,10,"2020","041"
"31323","MALGESSO",90,0,0,90,"2020","095"
"31324","MALNATE",32,52,0,84,"2020","096"
"31325","MALO",2122,252,0,2374,"2020","055"
"31326","MALONNO",26,159,56,241,"2020","101"
"31327","MALVICINO",6,0,0,6,"2020","090"
"31328","MANDELLO DEL LARIO",4,0,6,10,"2020","046"
"31329","MANDELLO VITTA",1,0,0,1,"2020","090"
"31330","MANERBA DEL GARDA",12,0,10,22,"2020","102"
"31331","MANERBIO",451,1488,0,1939,"2020","103"
"31332","MANGO",6,0,0,6,"2020","115"
"31333","MANSUE'",47,234,13,294,"2020","037"
"31334","MANTA",1,0,0,1,"2020","116"
"31335","MANTELLO",1,134,0,135,"2020","039"
"31336","MANTOVA",647,855,140,1642,"2020","030"
"31337","MAPELLO",5,0,30,35,"2020","132"
"31338","MARANELLO",44,547,0,591,"2020","019"
"31339","MARANO DI VALPOLICELLA",8,49,16,73,"2020","046"
"31340","MARANO SUL PANARO",55,641,0,696,"2020","020"
"31341","MARANO TICINO",0,247,0,247,"2020","091"
"31342","MARANO VICENTINO",217,292,34,543,"2020","056"
"31343","MARCALLO CON CASONE",1,309,0,310,"2020","134"
"31344","MARCARIA",3205,3294,710,7209,"2020","031"
"31345","MARCHENO",6,6,9,21,"2020","104"
"31346","MARCIGNAGO",1,0,0,1,"2020","086"
"31347","MARCON",509,14,0,523,"2020","020"
"31348","MARENE",3111,2188,94,5393,"2020","117"
"31349","MARENO DI PIAVE",1342,114,6,1462,"2020","038"
"31350","MARENTINO",125,0,0,125,"2020","144"
"31351","MARETTO",216,0,0,216,"2020","062"
"31352","MARGARITA",865,0,0,865,"2020","118"
"31353","MARGNO",3,6,1,10,"2020","047"
"31354","MARIANA MANTOVANA",70,363,52,485,"2020","032"
"31355","MARIANO COMENSE",662,45,1,708,"2020","143"
"31356","MARMENTINO",4,10,15,29,"2020","105"
"31357","MARMIROLO",3880,2509,3023,9412,"2020","033"
"31358","MARMORA",0,0,95,95,"2020","119"
"31359","MARNATE",1,0,0,1,"2020",NA
"31360","MARONE",34,0,32,66,"2020","106"
"31361","MAROSTICA",102,523,7,632,"2020","057"
"31362","MARSAGLIA",103,0,0,103,"2020","120"
"31363","MARTELLAGO",26,24,0,50,"2020","021"
"31364","MARTIGNANA DI PO",1,0,0,1,"2020","057"
"31365","MARTINENGO",122,2614,0,2736,"2020","133"
"31366","MARTINIANA PO",84,60,36,180,"2020","121"
"31367","MARUDO",1,322,0,323,"2020","036"
"31368","MARZABOTTO",19,91,0,110,"2020","036"
"31369","MARZANO",2,354,0,356,"2020","087"
"31370","MARZIO",3,0,2,5,"2020","099"
"31371","MASATE",117,0,75,192,"2020","136"
"31372","MASCIAGO PRIMO",45,0,0,45,"2020","100"
"31373","MASER",3841,21,0,3862,"2020","039"
"31374","MASERA",36,22,1,59,"2020","042"
"31375","MASERA' DI PADOVA",249,172,0,421,"2020","048"
"31376","MASERADA SUL PIAVE",2473,98,10,2581,"2020","040"
"31377","MASI",34,0,0,34,"2020","049"
"31378","MASI TORELLO",6,93,0,99,"2020","012"
"31379","MASIO",897,0,0,897,"2020","091"
"31380","MASSA LOMBARDA",13,0,0,13,"2020","013"
"31381","MASSALENGO",0,116,0,116,"2020","037"
"31382","MASSANZAGO",370,153,0,523,"2020","050"
"31383","MASSAZZA",35,0,0,35,"2020","031"
"31384","MASSELLO",7,0,0,7,"2020","145"
"31385","MASSERANO",44,0,0,44,"2020","032"
"31386","MASSINO VISCONTI",5,1,5,11,"2020","093"
"31387","MASSIOLA",2,0,0,2,"2020","043"
"31388","MATHI",198,0,78,276,"2020","146"
"31389","MATTIE",1,0,11,12,"2020","147"
"31390","MAZZANO",57,486,286,829,"2020","107"
"31391","MAZZE'",961,4,0,965,"2020","148"
"31392","MAZZO DI VALTELLINA",9,23,2,34,"2020","040"
"31393","MEANA DI SUSA",1,0,0,1,"2020","149"
"31394","MEDA",1,0,0,1,"2020",NA
"31395","MEDE",21,48,0,69,"2020","088"
"31396","MEDESANO",101,1542,0,1643,"2020","020"
"31397","MEDICINA",28,108,1,137,"2020","037"
"31398","MEDIGLIA",6,1441,16,1463,"2020","139"
"31399","MEDOLAGO",10,0,0,10,"2020","250"
"31400","MEDOLE",402,1728,282,2412,"2020","034"
"31401","MEDOLLA",0,500,0,500,"2020","021"
"31402","MEDUNA DI LIVENZA",13,15,0,28,"2020","041"
"31403","MEGLIADINO SAN VITALE",2506,0,0,2506,"2020","052"
"31404","MEINA",2,0,0,2,"2020","095"
"31405","MELAZZO",125,0,0,125,"2020","092"
"31406","MELDOLA",168,0,0,168,"2020","019"
"31407","MELEGNANO",0,215,0,215,"2020","140"
"31408","MELETI",24,287,6,317,"2020","038"
"31409","MELLE",215,0,40,255,"2020","122"
"31410","MELLO",37,39,2,78,"2020","041"
"31411","MELZO",103,257,7,367,"2020","142"
"31412","MENAGGIO",2,0,0,2,"2020","145"
"31413","MENCONICO",16,0,0,16,"2020","089"
"31414","MEOLO",523,123,0,646,"2020","022"
"31415","MERANA",33,0,0,33,"2020","093"
"31416","MERATE",44,212,39,295,"2020","048"
"31417","MERCALLO",1,0,0,1,"2020",NA
"31418","MERCATO SARACENO",181,20,0,201,"2020","020"
"31419","MERCENASCO",356,0,0,356,"2020","150"
"31420","MERGOZZO",31,0,0,31,"2020","044"
"31421","MERLARA",486,0,0,486,"2020","053"
"31422","MERLINO",0,1260,30,1290,"2020","039"
"31423","MERONE",38,21,0,59,"2020","147"
"31424","MESE",13,40,31,84,"2020","043"
"31425","MESENZANA",1,20,0,21,"2020","102"
"31426","MESERO",0,59,0,59,"2020","144"
"31427","MESOLA",976,210,0,1186,"2020","014"
"31428","MESTRINO",82,72,0,154,"2020","054"
"31429","MEZZANA BIGLI",88,0,0,88,"2020","090"
"31430","MEZZANE DI SOTTO",0,20,0,20,"2020","047"
"31431","MEZZENILE",10,0,14,24,"2020","152"
"31432","MEZZOLDO",1,19,0,20,"2020","134"
"31433","MEZZOMERICO",3,0,0,3,"2020","097"
"31434","MIANE",4,10,0,14,"2020","042"
"31435","MIASINO",0,0,34,34,"2020","098"
"31436","MIAZZINA",1,0,0,1,"2020","045"
"31437","MILANO",236,94,220,550,"2020","146"
"31438","MILZANO",0,1016,0,1016,"2020","108"
"31439","MINERBE",2037,166,105,2308,"2020","048"
"31440","MINERBIO",47,0,0,47,"2020","038"
"31441","MIRA",2091,252,17,2360,"2020","023"
"31442","MIRABELLO MONFERRATO",74,0,0,74,"2020","094"
"31443","MIRADOLO TERME",16,0,60,76,"2020","093"
"31444","MIRANDOLA",335,1481,0,1816,"2020","022"
"31445","MIRANO",1096,725,1,1822,"2020","024"
"31446","MISANO ADRIATICO",7,0,0,7,"2020","005"
"31447","MISANO DI GERA D'ADDA",4,230,4,238,"2020","135"
"31448","MISSAGLIA",10,229,247,486,"2020","049"
"31449","MODENA",46,1970,0,2016,"2020","023"
"31450","MODIGLIANA",108,0,0,108,"2020","022"
"31451","MOGLIA",6933,1226,808,8967,"2020","035"
"31452","MOGLIANO VENETO",1083,390,166,1639,"2020","043"
"31453","MOIO DE' CALVI",4,10,0,14,"2020","136"
"31454","MOIOLA",14,0,32,46,"2020","123"
"31455","MOLARE",1,0,0,1,"2020","095"
"31456","MOLINELLA",2040,232,0,2272,"2020","039"
"31457","MOLLIA",4,0,0,4,"2020","078"
"31458","MOLTENO",10,35,4,49,"2020","051"
"31459","MOMBALDONE",43,0,2,45,"2020","064"
"31460","MOMBARCARO",111,0,0,111,"2020","124"
"31461","MOMBARUZZO",6,0,0,6,"2020","065"
"31462","MOMBASIGLIO",97,0,0,97,"2020","125"
"31463","MOMBELLO DI TORINO",42,0,0,42,"2020","153"
"31464","MOMBELLO MONFERRATO",8,0,0,8,"2020","097"
"31465","MOMBERCELLI",35,0,0,35,"2020","066"
"31466","MOMO",197,510,14,721,"2020","100"
"31467","MONALE",22,0,0,22,"2020","067"
"31468","MONASTERO BORMIDA",358,0,0,358,"2020","068"
"31469","MONASTERO DI LANZO",8,0,1,9,"2020","155"
"31470","MONASTERO DI VASCO",425,0,51,476,"2020","126"
"31471","MONASTEROLO CASOTTO",43,0,0,43,"2020","127"
"31472","MONASTEROLO DEL CASTELLO",13,27,0,40,"2020","137"
"31473","MONASTEROLO DI SAVIGLIANO",500,285,128,913,"2020","128"
"31474","MONASTIER DI TREVISO",1694,45,80,1819,"2020","044"
"31475","MONCALIERI",135,420,0,555,"2020","156"
"31476","MONCALVO",107,0,0,107,"2020","069"
"31477","MONCENISIO",5,0,0,5,"2020","157"
"31478","MONCESTINO",7,0,0,7,"2020","099"
"31479","MONCHIERO",250,0,0,250,"2020","129"
"31480","MONCHIO DELLE CORTI",21,154,0,175,"2020","022"
"31481","MONCRIVELLO",91,237,0,328,"2020","079"
"31482","MONCUCCO TORINESE",46,0,0,46,"2020","070"
"31483","MONDAINO",7,0,0,7,"2020","006"
"31484","MONDOVI'",5815,16,374,6205,"2020","130"
"31485","MONESIGLIO",82,0,0,82,"2020","131"
"31486","MONFORTE D'ALBA",240,0,0,240,"2020","132"
"31487","MONFUMO",28,220,2,250,"2020","045"
"31488","MONGARDINO",27,0,0,27,"2020","071"
"31489","MONGHIDORO",28,82,0,110,"2020","040"
"31490","MONGIARDINO LIGURE",26,0,23,49,"2020","100"
"31491","MONGRANDO",96,115,0,211,"2020","035"
"31492","MONGUZZO",10,0,0,10,"2020","153"
"31493","MONNO",3,39,3,45,"2020","110"
"31494","MONSELICE",382,54,0,436,"2020","055"
"31495","MONTA'",234,0,0,234,"2020","133"
"31496","MONTABONE",69,0,0,69,"2020","072"
"31497","MONTACUTO",2,0,0,2,"2020","102"
"31498","MONTAFIA",29,0,0,29,"2020","073"
"31499","MONTAGNA IN VALTELLINA",22,84,0,106,"2020","044"
"31500","MONTAGNANA",1524,0,20,1544,"2020","056"
"31501","MONTALDO DI MONDOVI'",132,0,11,143,"2020","134"
"31502","MONTALDO SCARAMPI",29,0,0,29,"2020","074"
"31503","MONTALDO TORINESE",560,0,0,560,"2020","158"
"31504","MONTALENGHE",3,0,0,3,"2020","159"
"31505","MONTALTO DORA",35,0,0,35,"2020","160"
"31506","MONTALTO PAVESE",67,0,0,67,"2020","094"
"31507","MONTANARO",194,144,0,338,"2020","161"
"31508","MONTANASO LOMBARDO",64,425,0,489,"2020","040"
"31509","MONTANERA",1787,907,200,2894,"2020","136"
"31510","MONTANO LUCINO",4,0,19,23,"2020","154"
"31511","MONTE CREMASCO",344,120,0,464,"2020","058"
"31512","MONTE DI MALO",612,130,0,742,"2020","063"
"31513","MONTE ISOLA",15,0,0,15,"2020","111"
"31514","MONTE MARENZO",8,0,0,8,"2020","052"
"31515","MONTE SAN PIETRO",113,200,0,313,"2020","042"
"31516","MONTEBELLO DELLA BATTAGLIA",0,24,0,24,"2020","095"
"31517","MONTEBELLO VICENTINO",82,0,281,363,"2020","060"
"31518","MONTEBELLUNA",3798,497,30,4325,"2020","046"
"31519","MONTECALVO VERSIGGIA",3,0,0,3,"2020",NA
"31520","MONTECCHIA DI CROSARA",3,3,0,6,"2020","049"
"31521","MONTECCHIO EMILIA",5,1739,0,1744,"2020","027"
"31522","MONTECCHIO MAGGIORE",204,45,0,249,"2020","061"
"31523","MONTECCHIO PRECALCINO",169,143,0,312,"2020","062"
"31524","MONTECHIARO D'ACQUI",67,0,0,67,"2020","106"
"31525","MONTECHIARO D'ASTI",285,0,0,285,"2020","075"
"31526","MONTECHIARUGOLO",20,3345,0,3365,"2020","023"
"31527","MONTECRESTESE",44,22,12,78,"2020","046"
"31528","MONTECRETO",11,510,0,521,"2020","024"
"31529","MONTEFIORE CONCA",21,1,0,22,"2020","008"
"31530","MONTEFIORINO",53,320,0,373,"2020","025"
"31531","MONTEFORTE D'ALPONE",823,7,0,830,"2020","050"
"31532","MONTEGALDA",40,264,0,304,"2020","064"
"31533","MONTEGALDELLA",19,324,0,343,"2020","065"
"31534","MONTEGIOCO",30,0,0,30,"2020","107"
"31535","MONTEGRIDOLFO",1,0,0,1,"2020","009"
"31536","MONTEGRINO VALTRAVAGLIA",12,0,0,12,"2020","103"
"31537","MONTEGROSSO D'ASTI",27,0,0,27,"2020","076"
"31538","MONTEGROTTO TERME",6,31,0,37,"2020","057"
"31539","MONTELUPO ALBESE",89,0,0,89,"2020","137"
"31540","MONTEMAGNO",79,0,0,79,"2020","077"
"31541","MONTEMALE DI CUNEO",167,0,0,167,"2020","138"
"31542","MONTEMEZZO",0,0,2,2,"2020","155"
"31543","MONTERENZIO",342,166,0,508,"2020","041"
"31544","MONTEROSSO GRANA",5,133,0,138,"2020","139"
"31545","MONTESCANO",1,0,0,1,"2020","097"
"31546","MONTESCUDO-MONTE COLOMBO",201,0,0,201,"2020",NA
"31547","MONTESE",81,1325,0,1406,"2020","026"
"31548","MONTESEGALE",6,0,0,6,"2020","098"
"31549","MONTEU DA PO",92,0,0,92,"2020","162"
"31550","MONTEU ROERO",502,0,0,502,"2020","140"
"31551","MONTEVECCHIA",9,0,0,9,"2020","053"
"31552","MONTEVIALE",61,0,0,61,"2020","066"
"31553","MONTEZEMOLO",45,0,0,45,"2020","141"
"31554","MONTICELLI BRUSATI",12,220,4,236,"2020","112"
"31555","MONTICELLI D'ONGINA",341,860,0,1201,"2020","027"
"31556","MONTICELLI PAVESE",1506,464,0,1970,"2020","099"
"31557","MONTICELLO BRIANZA",23,0,229,252,"2020","054"
"31558","MONTICELLO CONTE OTTO",176,753,25,954,"2020","067"
"31559","MONTICELLO D'ALBA",61,0,0,61,"2020","142"
"31560","MONTICHIARI",8593,7249,28,15870,"2020","113"
"31561","MONTIGLIO MONFERRATO",205,0,0,205,"2020","121"
"31562","MONTIRONE",3939,399,0,4338,"2020","114"
"31563","MONTODINE",97,1183,0,1280,"2020","059"
"31564","MONTORSO VICENTINO",691,114,0,805,"2020","068"
"31565","MONTU' BECCARIA",2,0,0,2,"2020","100"
"31566","MONVALLE",13,0,0,13,"2020","104"
"31567","MONZA",56,54,0,110,"2020",NA
"31568","MONZAMBANO",1398,660,183,2241,"2020","036"
"31569","MONZUNO",63,42,0,105,"2020","044"
"31570","MORANSENGO",142,0,0,142,"2020","079"
"31571","MORAZZONE",12,90,27,129,"2020","105"
"31572","MORBEGNO",16,79,1,96,"2020","045"
"31573","MORDANO",1,0,0,1,"2020","045"
"31574","MORENGO",74,52,0,126,"2020","140"
"31575","MORETTA",1746,432,224,2402,"2020","143"
"31576","MORFASSO",133,7,0,140,"2020","028"
"31577","MORGANO",1745,3,0,1748,"2020","047"
"31578","MORIAGO DELLA BATTAGLIA",2137,70,0,2207,"2020","048"
"31579","MORIMONDO",50,1620,0,1670,"2020","150"
"31580","MORIONDO TORINESE",368,0,0,368,"2020","163"
"31581","MORNAGO",32,0,0,32,"2020","106"
"31582","MORNESE",36,0,0,36,"2020","111"
"31583","MORNICO AL SERIO",432,624,5,1061,"2020","141"
"31584","MORNICO LOSANA",28,0,0,28,"2020","101"
"31585","MOROZZO",2387,570,385,3342,"2020","144"
"31586","MORSASCO",121,0,0,121,"2020","112"
"31587","MORTARA",37,0,0,37,"2020","102"
"31588","MORTERONE",1,0,29,30,"2020","055"
"31589","MOSCAZZANO",5,1517,0,1522,"2020","060"
"31590","MOTTA BALUFFI",4,85,0,89,"2020","061"
"31591","MOTTA DI LIVENZA",19,20,0,39,"2020","049"
"31592","MOTTA VISCONTI",6,0,0,6,"2020","151"
"31593","MOTTALCIATA",69,61,0,130,"2020","037"
"31594","MOTTEGGIANA",385,1305,636,2326,"2020","037"
"31595","MOZZANICA",216,611,0,827,"2020","142"
"31596","MOZZATE",8,100,0,108,"2020","159"
"31597","MOZZECANE",3488,1172,0,4660,"2020","051"
"31598","MULAZZANO",7,1145,0,1152,"2020","041"
"31599","MURA",16,6,32,54,"2020","115"
"31600","MURAZZANO",311,0,23,334,"2020","145"
"31601","MURELLO",463,1386,198,2047,"2020","146"
"31602","MURISENGO",334,0,0,334,"2020","113"
"31603","MUSCOLINE",234,587,6,827,"2020","116"
"31604","MUSILE DI PIAVE",19,17,0,36,"2020","025"
"31605","MUSSO",4,0,11,15,"2020","160"
"31606","MUSSOLENTE",248,198,0,446,"2020","070"
"31607","MUZZANO",23,0,2,25,"2020","038"
"31608","NANTO",296,227,0,523,"2020","071"
"31609","NARZOLE",1727,152,0,1879,"2020","147"
"31610","NAVE",25,179,37,241,"2020","117"
"31611","NEBBIUNO",35,0,31,66,"2020","103"
"31612","NEGRAR",8,78,0,86,"2020","052"
"31613","NEIVE",25,0,0,25,"2020","148"
"31614","NEMBRO",42,3,0,45,"2020","144"
"31615","NERVESA DELLA BATTAGLIA",532,210,16,758,"2020","050"
"31616","NERVIANO",6,117,16,139,"2020","154"
"31617","NESSO",0,5,0,5,"2020","161"
"31618","NETRO",104,43,9,156,"2020","039"
"31619","NEVIANO DEGLI ARDUINI",31,1963,0,1994,"2020","024"
"31620","NIARDO",1,137,28,166,"2020","118"
"31621","NIBIONNO",2,0,0,2,"2020","056"
"31622","NICHELINO",31,0,17,48,"2020","164"
"31623","NICORVO",1,0,0,1,"2020","103"
"31624","NIELLA BELBO",129,0,0,129,"2020","150"
"31625","NIELLA TANARO",539,0,0,539,"2020","151"
"31626","NIZZA MONFERRATO",45,3,0,48,"2020","080"
"31627","NOALE",397,79,7,483,"2020","026"
"31628","NOASCA",0,0,40,40,"2020","165"
"31629","NOCETO",25,3661,0,3686,"2020","025"
"31630","NOGARA",2838,417,2,3257,"2020","053"
"31631","NOGAROLE ROCCA",288,307,0,595,"2020","054"
"31632","NOGAROLE VICENTINO",11,12,0,23,"2020","072"
"31633","NOLE",215,39,120,374,"2020","166"
"31634","NONANTOLA",10,132,0,142,"2020","027"
"31635","NONE",828,1028,433,2289,"2020","168"
"31636","NONIO",2,0,0,2,"2020",NA
"31637","NOSATE",13,0,0,13,"2020","155"
"31638","NOVA MILANESE",0,76,0,76,"2020",NA
"31639","NOVAFELTRIA",1066,233,0,1299,"2020","023"
"31640","NOVALESA",45,15,8,68,"2020","169"
"31641","NOVARA",48,300,0,348,"2020","106"
"31642","NOVATE MEZZOLA",0,0,18,18,"2020","046"
"31643","NOVE",20,209,0,229,"2020","073"
"31644","NOVEDRATE",970,0,0,970,"2020","163"
"31645","NOVELLARA",2636,2448,0,5084,"2020","028"
"31646","NOVELLO",1079,0,0,1079,"2020","152"
"31647","NOVENTA DI PIAVE",3,7,0,10,"2020","027"
"31648","NOVENTA PADOVANA",15,0,0,15,"2020","058"
"31649","NOVENTA VICENTINA",3802,0,0,3802,"2020","074"
"31650","NOVI DI MODENA",912,749,0,1661,"2020","028"
"31651","NOVI LIGURE",436,0,0,436,"2020","114"
"31652","NOVIGLIO",12,426,0,438,"2020","158"
"31653","NUVOLENTO",5,1044,1,1050,"2020","119"
"31654","NUVOLERA",1385,314,0,1699,"2020","120"
"31655","OCCHIEPPO INFERIORE",4,104,0,108,"2020","040"
"31656","OCCHIEPPO SUPERIORE",34,44,43,121,"2020","041"
"31657","OCCHIOBELLO",5,108,0,113,"2020","033"
"31658","OCCIMIANO",35,0,0,35,"2020","115"
"31659","ODALENGO GRANDE",78,0,0,78,"2020","116"
"31660","ODERZO",36,293,0,329,"2020","051"
"31661","ODOLO",10,0,0,10,"2020","121"
"31662","OFFANENGO",289,641,3,933,"2020","062"
"31663","OFFLAGA",601,3582,113,4296,"2020","122"
"31664","OGGEBBIO",2,0,0,2,"2020","049"
"31665","OGGIONA CON SANTO STEFANO",0,19,0,19,"2020","107"
"31666","OGGIONO",40,9,12,61,"2020","057"
"31667","OGLIANICO",97,273,0,370,"2020","170"
"31668","OLEGGIO",280,1064,0,1344,"2020","108"
"31669","OLGIATE COMASCO",25,43,38,106,"2020","165"
"31670","OLGIATE MOLGORA",16,74,0,90,"2020","058"
"31671","OLGIATE OLONA",3,0,0,3,"2020","108"
"31672","OLGINATE",12,0,0,12,"2020","059"
"31673","OLIVA GESSI",6,0,0,6,"2020",NA
"31674","OLIVETO LARIO",9,0,0,9,"2020","060"
"31675","OLMENETA",4,511,0,515,"2020","063"
"31676","OLMO AL BREMBO",1,3,0,4,"2020","145"
"31677","OLMO GENTILE",45,0,11,56,"2020","081"
"31678","OLTRE IL COLLE",18,89,0,107,"2020","146"
"31679","OLTRESSENDA ALTA",3,45,0,48,"2020","147"
"31680","OLTRONA DI SAN MAMETTE",25,0,0,25,"2020","169"
"31681","OME",15,15,0,30,"2020","123"
"31682","OMEGNA",65,0,0,65,"2020","050"
"31683","ONCINO",0,0,130,130,"2020","154"
"31684","ONETA",8,37,0,45,"2020","148"
"31685","ONO SAN PIETRO",2,11,1,14,"2020","124"
"31686","ONORE",4,15,0,19,"2020","149"
"31687","OPERA",0,89,0,89,"2020","159"
"31688","OPPEANO",5600,810,0,6410,"2020","055"
"31689","ORBASSANO",528,0,4,532,"2020","171"
"31690","ORGIANO",468,13,0,481,"2020","075"
"31691","ORIGGIO",88,0,18,106,"2020","109"
"31692","ORIO CANAVESE",0,44,0,44,"2020","172"
"31693","ORIO LITTA",0,88,12,100,"2020","042"
"31694","ORMEA",136,0,15,151,"2020","155"
"31695","ORMELLE",16,114,0,130,"2020","052"
"31696","ORNAGO",2,52,0,54,"2020",NA
"31697","ORNAVASSO",23,0,0,23,"2020","051"
"31698","ORNICA",3,3,0,6,"2020","151"
"31699","ORSAGO",4,91,0,95,"2020","053"
"31700","ORSARA BORMIDA",17,0,0,17,"2020","119"
"31701","ORSENIGO",5,41,14,60,"2020","170"
"31702","ORTA SAN GIULIO",2,0,0,2,"2020","112"
"31703","ORZINUOVI",493,4946,16,5455,"2020","125"
"31704","ORZIVECCHI",11,781,0,792,"2020","126"
"31705","OSASCO",355,0,91,446,"2020","173"
"31706","OSASIO",289,121,99,509,"2020","174"
"31707","OSIO SOPRA",62,589,0,651,"2020","152"
"31708","OSNAGO",196,86,0,282,"2020","061"
"31709","OSPEDALETTO EUGANEO",400,0,2,402,"2020","059"
"31710","OSPEDALETTO LODIGIANO",0,966,0,966,"2020","043"
"31711","OSPITALETTO",264,219,0,483,"2020","127"
"31712","OSSAGO LODIGIANO",43,1525,15,1583,"2020","044"
"31713","OSSIMO",6,7,5,18,"2020","128"
"31714","OSSONA",39,0,0,39,"2020","164"
"31715","OSTELLATO",3361,0,0,3361,"2020","017"
"31716","OSTIANO",336,1300,0,1636,"2020","064"
"31717","OSTIGLIA",67,36,17,120,"2020","038"
"31718","OTTIGLIO",97,0,0,97,"2020","120"
"31719","OTTOBIANO",0,29,0,29,"2020","106"
"31720","OTTONE",113,0,0,113,"2020","030"
"31721","OULX",53,0,1,54,"2020","175"
"31722","OVADA",40,0,0,40,"2020","121"
"31723","OVIGLIO",13,14,0,27,"2020","122"
"31724","OZEGNA",244,0,0,244,"2020","176"
"31725","OZZANO DELL'EMILIA",174,294,0,468,"2020","046"
"31726","OZZANO MONFERRATO",71,0,0,71,"2020","123"
"31727","OZZERO",2,57,100,159,"2020","165"
"31728","PADENGHE SUL GARDA",47,0,31,78,"2020","129"
"31729","PADERNO D'ADDA",0,19,0,19,"2020","062"
"31730","PADERNO DUGNANO",14,0,0,14,"2020","166"
"31731","PADERNO FRANCIACORTA",2,140,114,256,"2020","130"
"31732","PADERNO PONCHIELLI",136,2167,135,2438,"2020","065"
"31733","PADOVA",585,290,35,910,"2020","060"
"31734","PAESANA",701,15,0,716,"2020","157"
"31735","PAESE",2076,544,172,2792,"2020","055"
"31736","PAGNO",53,0,0,53,"2020","158"
"31737","PAGNONA",0,6,2,8,"2020","063"
"31738","PAISCO LOVENO",1,7,12,20,"2020","131"
"31739","PAITONE",14,37,0,51,"2020","132"
"31740","PALADINA",11,0,0,11,"2020","155"
"31741","PALAGANO",70,610,0,680,"2020","029"
"31742","PALANZANO",13,429,0,442,"2020","026"
"31743","PALAZZAGO",110,60,0,170,"2020","156"
"31744","PALAZZO CANAVESE",24,0,0,24,"2020","177"
"31745","PALAZZO PIGNANO",3,820,0,823,"2020","066"
"31746","PALAZZOLO SULL'OGLIO",1339,1392,125,2856,"2020","133"
"31747","PALAZZOLO VERCELLESE",22,0,0,22,"2020","090"
"31748","PALESTRO",1,0,20,21,"2020","107"
"31749","PALLANZENO",47,0,0,47,"2020","052"
"31750","PALOSCO",433,426,0,859,"2020","157"
"31751","PALU'",132,0,0,132,"2020","056"
"31752","PAMPARATO",49,0,0,49,"2020","159"
"31753","PANCALIERI",171,106,0,277,"2020","178"
"31754","PANDINO",122,3708,0,3830,"2020","067"
"31755","PANTIGLIATE",3,0,0,3,"2020","167"
"31756","PAPOZZE",11,57,0,68,"2020","034"
"31757","PARABIAGO",62,43,21,126,"2020","168"
"31758","PARATICO",4,43,0,47,"2020","134"
"31759","PARETO",43,1,0,44,"2020","125"
"31760","PARLASCO",2,0,0,2,"2020","064"
"31761","PARMA",197,10208,0,10405,"2020","027"
"31762","PARODI LIGURE",60,0,54,114,"2020","126"
"31763","PAROLDO",20,0,2,22,"2020","160"
"31764","PARONA",7,0,0,7,"2020","109"
"31765","PARRE",18,78,0,96,"2020","158"
"31766","PARUZZARO",43,39,0,82,"2020","114"
"31767","PARZANICA",4,9,0,13,"2020","159"
"31768","PASPARDO",1,5,2,8,"2020","135"
"31769","PASSERANO MARMORITO",139,0,0,139,"2020","082"
"31770","PASSIRANO",58,114,68,240,"2020","136"
"31771","PASTRENGO",0,148,0,148,"2020","057"
"31772","PASTURO",28,114,67,209,"2020","065"
"31773","PAULLO",0,477,0,477,"2020","169"
"31774","PAVAROLO",73,0,0,73,"2020","180"
"31775","PAVIA",63,266,8,337,"2020","110"
"31776","PAVONE CANAVESE",138,0,4,142,"2020","181"
"31777","PAVONE DEL MELLA",2695,282,8,2985,"2020","137"
"31778","PAVULLO NEL FRIGNANO",210,3697,0,3907,"2020","030"
"31779","PECETTO DI VALENZA",2,0,0,2,"2020","128"
"31780","PECETTO TORINESE",105,0,0,105,"2020","183"
"31781","PEDAVENA",1,103,2,106,"2020","036"
"31782","PEDEMONTE",0,4,4,8,"2020","076"
"31783","PEDEROBBA",67,136,11,214,"2020","056"
"31784","PEDRENGO",12,253,17,282,"2020","160"
"31785","PEGLIO",2,0,8,10,"2020","178"
"31786","PEGOGNAGA",1187,2414,1819,5420,"2020","039"
"31787","PEIA",8,19,0,27,"2020","161"
"31788","PELLEGRINO PARMENSE",78,691,0,769,"2020","028"
"31789","PENANGO",41,0,0,41,"2020","083"
"31790","PENNABILLI",296,0,0,296,"2020","024"
"31791","PERLEDO",2,0,0,2,"2020","067"
"31792","PERLETTO",196,0,0,196,"2020","161"
"31793","PERLO",35,0,0,35,"2020","162"
"31794","PERNUMIA",388,140,0,528,"2020","061"
"31795","PEROSA ARGENTINA",58,10,0,68,"2020","184"
"31796","PEROSA CANAVESE",139,221,0,360,"2020","185"
"31797","PERRERO",30,0,0,30,"2020","186"
"31798","PERSICO DOSIMO",1,1729,246,1976,"2020","068"
"31799","PERTENGO",1,0,0,1,"2020","091"
"31800","PERTICA ALTA",9,5,3,17,"2020","139"
"31801","PERTICA BASSA",29,48,21,98,"2020","140"
"31802","PERTUSIO",69,0,0,69,"2020","187"
"31803","PESCANTINA",80,76,0,156,"2020","058"
"31804","PESCAROLO ED UNITI",59,979,0,1038,"2020","069"
"31805","PESCHIERA BORROMEO",39,390,1,430,"2020","171"
"31806","PESSANO CON BORNAGO",60,140,0,200,"2020","172"
"31807","PESSINA CREMONESE",327,2907,173,3407,"2020","070"
"31808","PESSINETTO",1,0,0,1,"2020","188"
"31809","PETTENASCO",4,0,0,4,"2020","116"
"31810","PETTINENGO",2,18,0,20,"2020","042"
"31811","PETTORAZZA GRIMANI",166,173,0,339,"2020","035"
"31812","PEVERAGNO",1185,485,34,1704,"2020","163"
"31813","PEZZAZE",26,35,0,61,"2020","141"
"31814","PEZZOLO VALLE UZZONE",59,0,0,59,"2020","164"
"31815","PIACENZA",331,1243,0,1574,"2020","032"
"31816","PIACENZA D'ADIGE",660,0,0,660,"2020","062"
"31817","PIADENA DRIZZONA",76,983,0,1059,"2020",NA
"31818","PIAN CAMUNO",0,288,2,290,"2020","142"
"31819","PIANCOGNO",28,71,0,99,"2020","206"
"31820","PIANELLO DEL LARIO",8,0,8,16,"2020","183"
"31821","PIANELLO VAL TIDONE",358,57,0,415,"2020","033"
"31822","PIANENGO",3,304,0,307,"2020","072"
"31823","PIANEZZA",283,359,181,823,"2020","189"
"31824","PIANEZZE",85,124,0,209,"2020","077"
"31825","PIANFEI",810,57,20,887,"2020","165"
"31826","PIANICO",10,77,0,87,"2020","162"
"31827","PIANIGA",33,43,0,76,"2020","028"
"31828","PIANORO",159,141,0,300,"2020","047"
"31829","PIANTEDO",5,247,2,254,"2020","048"
"31830","PIARIO",26,0,0,26,"2020","163"
"31831","PIASCO",251,260,44,555,"2020","166"
"31832","PIATEDA",20,71,0,91,"2020","049"
"31833","PIATTO",16,0,0,16,"2020","043"
"31834","PIAZZA BREMBANA",3,0,0,3,"2020","164"
"31835","PIAZZATORRE",2,2,0,4,"2020","165"
"31836","PIAZZOLA SUL BRENTA",2786,1064,0,3850,"2020","063"
"31837","PIAZZOLO",0,0,3,3,"2020","166"
"31838","PIEA",68,0,0,68,"2020","084"
"31839","PIEDIMULERA",0,28,0,28,"2020","053"
"31840","PIERANICA",53,26,0,79,"2020","073"
"31841","PIETRA DE' GIORGI",14,0,0,14,"2020","111"
"31842","PIEVE D'OLMI",1,2036,0,2037,"2020","074"
"31843","PIEVE DEL CAIRO",3,92,0,95,"2020","113"
"31844","PIEVE DEL GRAPPA",1130,880,9,2019,"2020",NA
"31845","PIEVE DI CADORE",2,18,0,20,"2020","039"
"31846","PIEVE DI SOLIGO",31,109,7,147,"2020","057"
"31847","PIEVE EMANUELE",0,445,127,572,"2020","173"
"31848","PIEVE FISSIRAGA",95,1201,0,1296,"2020","045"
"31849","PIEVE PORTO MORONE",133,0,0,133,"2020","114"
"31850","PIEVE SAN GIACOMO",0,1823,0,1823,"2020","075"
"31851","PIEVE VERGONTE",29,5,60,94,"2020","054"
"31852","PIEVEPELAGO",26,75,0,101,"2020","031"
"31853","PINAROLO PO",2383,0,0,2383,"2020","115"
"31854","PINASCA",141,0,37,178,"2020","190"
"31855","PINCARA",337,0,0,337,"2020","036"
"31856","PINEROLO",1995,147,134,2276,"2020","191"
"31857","PINO TORINESE",477,0,71,548,"2020","192"
"31858","PIOBESI TORINESE",288,1039,258,1585,"2020","193"
"31859","PIODE",0,10,16,26,"2020","097"
"31860","PIOLTELLO",1,0,0,1,"2020","175"
"31861","PIOMBINO DESE",4710,323,0,5033,"2020","064"
"31862","PIOSSASCO",536,877,133,1546,"2020","194"
"31863","PIOVA' MASSAIA",262,0,0,262,"2020","086"
"31864","PIOVE DI SACCO",3964,156,0,4120,"2020","065"
"31865","PIOVENE ROCCHETTE",1480,113,0,1593,"2020","078"
"31866","PIOZZANO",164,0,0,164,"2020","034"
"31867","PIOZZO",325,0,0,325,"2020","169"
"31868","PISCINA",1722,0,0,1722,"2020","195"
"31869","PISOGNE",9,157,16,182,"2020","143"
"31870","PIUBEGA",4459,916,155,5530,"2020","041"
"31871","PIURO",11,167,3,181,"2020","050"
"31872","PIVERONE",130,57,0,187,"2020","196"
"31873","PIZZIGHETTONE",82,3008,0,3090,"2020","076"
"31874","PLESIO",2,0,0,2,"2020","185"
"31875","POCAPAGLIA",158,34,0,192,"2020","170"
"31876","PODENZANO",83,665,0,748,"2020","035"
"31877","POGGIO RENATICO",16,445,0,461,"2020","018"
"31878","POGGIO RUSCO",307,848,18,1173,"2020","042"
"31879","POGGIO TORRIANA",488,0,0,488,"2020",NA
"31880","POGGIRIDENTI",7,0,0,7,"2020","051"
"31881","POGNANO",9,385,41,435,"2020","167"
"31882","POGNO",1,0,0,1,"2020",NA
"31883","POIRINO",3730,623,0,4353,"2020","197"
"31884","POJANA MAGGIORE",1353,27,0,1380,"2020","079"
"31885","POLAVENO",13,7,25,45,"2020","144"
"31886","POLESINE ZIBELLO",28,1473,0,1501,"2020",NA
"31887","POLINAGO",69,707,0,776,"2020","032"
"31888","POLLONE",182,59,0,241,"2020","046"
"31889","POLONGHERA",191,125,54,370,"2020","171"
"31890","POLPENAZZE DEL GARDA",13,111,0,124,"2020","145"
"31891","POLVERARA",4,52,0,56,"2020","066"
"31892","POMARETTO",56,0,16,72,"2020","198"
"31893","POMARO MONFERRATO",4,0,262,266,"2020","131"
"31894","POMBIA",4,79,0,83,"2020","121"
"31895","POMPIANO",18,1404,0,1422,"2020","146"
"31896","POMPONESCO",0,472,28,500,"2020","043"
"31897","PONCARALE",165,793,250,1208,"2020","147"
"31898","PONDERANO",72,42,40,154,"2020","047"
"31899","PONNA",1,0,9,10,"2020","187"
"31900","PONSO",69,0,0,69,"2020","067"
"31901","PONT-CANAVESE",39,59,0,98,"2020","199"
"31902","PONTE DELL'OLIO",173,106,0,279,"2020","036"
"31903","PONTE DI LEGNO",7,3,0,10,"2020","148"
"31904","PONTE DI PIAVE",59,34,3,96,"2020","058"
"31905","PONTE IN VALTELLINA",11,11,0,22,"2020","052"
"31906","PONTE LAMBRO",9,5,0,14,"2020","188"
"31907","PONTE NELLE ALPI",12,105,0,117,"2020","040"
"31908","PONTE NIZZA",113,32,0,145,"2020","117"
"31909","PONTE NOSSA",0,22,0,22,"2020","168"
"31910","PONTE SAN NICOLO'",24,49,0,73,"2020","069"
"31911","PONTE SAN PIETRO",6,0,0,6,"2020","170"
"31912","PONTECCHIO POLESINE",1648,0,0,1648,"2020","038"
"31913","PONTECHIANALE",212,0,0,212,"2020","172"
"31914","PONTECURONE",3,0,0,3,"2020","132"
"31915","PONTELONGO",429,0,0,429,"2020","068"
"31916","PONTENURE",41,148,0,189,"2020","037"
"31917","PONTERANICA",1,0,0,1,"2020","169"
"31918","PONTESTURA",6,0,0,6,"2020","133"
"31919","PONTEVICO",244,3550,398,4192,"2020","149"
"31920","PONTI",89,0,6,95,"2020","134"
"31921","PONTI SUL MINCIO",162,380,44,586,"2020","044"
"31922","PONTIDA",26,0,0,26,"2020","171"
"31923","PONTIROLO NUOVO",259,433,91,783,"2020","172"
"31924","PONTOGLIO",776,1373,30,2179,"2020","150"
"31925","PONZANO MONFERRATO",55,0,0,55,"2020","135"
"31926","PONZANO VENETO",346,150,0,496,"2020","059"
"31927","PONZONE",28,0,20,48,"2020","136"
"31928","PORLEZZA",3,29,15,47,"2020","189"
"31929","PORTACOMARO",47,0,0,47,"2020","087"
"31930","PORTE",25,0,0,25,"2020","200"
"31931","PORTICO E SAN BENEDETTO",58,0,0,58,"2020","031"
"31932","PORTO MANTOVANO",2132,691,1682,4505,"2020","045"
"31933","PORTO TOLLE",7,0,0,7,"2020","039"
"31934","PORTO VALTRAVAGLIA",11,0,9,20,"2020","114"
"31935","PORTO VIRO",4473,0,0,4473,"2020","052"
"31936","PORTOBUFFOLE'",1,0,4,5,"2020","060"
"31937","PORTOGRUARO",1310,84,0,1394,"2020","029"
"31938","PORTOMAGGIORE",1043,429,0,1472,"2020","019"
"31939","PORTULA",2,0,0,2,"2020","048"
"31940","POSINA",1,10,0,11,"2020","080"
"31941","POSSAGNO",11,10,0,21,"2020","061"
"31942","POSTALESIO",1,0,0,1,"2020","053"
"31943","POSTUA",0,1,0,1,"2020","102"
"31944","POVE DEL GRAPPA",5,0,9,14,"2020","081"
"31945","POVEGLIANO",119,139,8,266,"2020","062"
"31946","POVEGLIANO VERONESE",2689,534,0,3223,"2020","060"
"31947","POVIGLIO",11,1446,0,1457,"2020","029"
"31948","POZZAGLIO ED UNITI",25,2169,225,2419,"2020","077"
"31949","POZZO D'ADDA",151,0,90,241,"2020","177"
"31950","POZZOL GROPPO",40,0,0,40,"2020","137"
"31951","POZZOLENGO",572,388,40,1000,"2020","151"
"31952","POZZOLEONE",106,2332,9,2447,"2020","082"
"31953","POZZOLO FORMIGARO",32,237,0,269,"2020","138"
"31954","POZZONOVO",1297,0,0,1297,"2020","070"
"31955","POZZUOLO MARTESANA",4,220,23,247,"2020","178"
"31956","PRADALUNGA",31,0,0,31,"2020","173"
"31957","PRADLEVES",0,4,1,5,"2020","173"
"31958","PRAGELATO",9,0,3,12,"2020","201"
"31959","PRALBOINO",1654,791,21,2466,"2020","152"
"31960","PRALI",58,0,0,58,"2020","202"
"31961","PRALORMO",1248,362,0,1610,"2020","203"
"31962","PRALUNGO",102,2,24,128,"2020","049"
"31963","PRAMAGGIORE",5,5,0,10,"2020","030"
"31964","PRAMOLLO",7,0,0,7,"2020","204"
"31965","PRAROSTINO",41,10,0,51,"2020","205"
"31966","PRASCO",19,0,0,19,"2020","139"
"31967","PRASCORSANO",3,0,0,3,"2020","206"
"31968","PRATA CAMPORTACCIO",17,171,74,262,"2020","054"
"31969","PRATIGLIONE",5,0,0,5,"2020","207"
"31970","PRATO SESIA",3,0,0,3,"2020","122"
"31971","PRAY",73,0,0,73,"2020","050"
"31972","PRAZZO",190,21,38,249,"2020","174"
"31973","PREDAPPIO",161,25,0,186,"2020","032"
"31974","PREDORE",27,0,0,27,"2020","174"
"31975","PREDOSA",217,92,0,309,"2020","140"
"31976","PREGANZIOL",20,176,0,196,"2020","063"
"31977","PREGNANA MILANESE",7,103,0,110,"2020","179"
"31978","PREMANA",0,5,5,10,"2020","069"
"31979","PREMENO",4,0,0,4,"2020","055"
"31980","PREMIA",43,205,10,258,"2020","056"
"31981","PREMILCUORE",298,0,35,333,"2020","033"
"31982","PREMOLO",14,9,0,23,"2020","175"
"31983","PREMOSELLO-CHIOVENDA",18,0,0,18,"2020","057"
"31984","PRESEGLIE",60,0,1,61,"2020","153"
"31985","PRESSANA",4424,0,42,4466,"2020","061"
"31986","PREVALLE",20,560,30,610,"2020","155"
"31987","PRIERO",31,0,0,31,"2020","175"
"31988","PRIGNANO SULLA SECCHIA",128,1285,0,1413,"2020","033"
"31989","PRIMALUNA",12,49,9,70,"2020","070"
"31990","PRIOCCA",500,0,0,500,"2020","176"
"31991","PRIOLA",110,0,0,110,"2020","177"
"31992","PROSERPIO",2,4,0,6,"2020","192"
"31993","PROVAGLIO D'ISEO",119,208,1,328,"2020","156"
"31994","PROVAGLIO VAL SABBIA",23,0,5,28,"2020","157"
"31995","PRUNETTO",66,0,0,66,"2020","178"
"31996","PUEGNAGO SUL GARDA",14,119,1,134,"2020","158"
"31997","PUMENENGO",1672,936,227,2835,"2020","177"
"31998","PUSIANO",0,0,1,1,"2020","193"
"31999","QUAREGNA CERRETO",129,0,0,129,"2020",NA
"32000","QUARGNENTO",612,0,0,612,"2020","141"
"32001","QUARNA SOTTO",9,0,0,9,"2020","059"
"32002","QUARONA",6,13,0,19,"2020","107"
"32003","QUARTO D'ALTINO",9,0,0,9,"2020","031"
"32004","QUASSOLO",56,15,9,80,"2020","209"
"32005","QUATTORDIO",235,0,0,235,"2020","142"
"32006","QUATTRO CASTELLA",20,1432,0,1452,"2020","030"
"32007","QUERO VAS",21,51,18,90,"2020",NA
"32008","QUINCINETTO",26,36,0,62,"2020","210"
"32009","QUINGENTOLE",950,48,54,1052,"2020","046"
"32010","QUINTANO",2,371,0,373,"2020","078"
"32011","QUINTO DI TREVISO",158,150,11,319,"2020","064"
"32012","QUINTO VERCELLESE",2,0,0,2,"2020","108"
"32013","QUINTO VICENTINO",36,667,0,703,"2020","083"
"32014","QUINZANO D'OGLIO",358,3098,0,3456,"2020","159"
"32015","QUISTELLO",165,1486,589,2240,"2020","047"
"32016","RACCONIGI",2342,1986,169,4497,"2020","179"
"32017","RANCIO VALCUVIA",5,0,0,5,"2020","115"
"32018","RANCO",0,0,38,38,"2020","116"
"32019","RANICA",29,19,0,48,"2020","178"
"32020","RANZANICO",6,24,0,30,"2020","179"
"32021","RASURA",0,8,0,8,"2020","055"
"32022","RAVENNA",1074,1305,0,2379,"2020","014"
"32023","RE",13,0,0,13,"2020","060"
"32024","REANO",28,0,6,34,"2020","211"
"32025","RECOARO TERME",72,92,0,164,"2020","084"
"32026","REDAVALLE",120,0,0,120,"2020","120"
"32027","REDONDESCO",228,700,852,1780,"2020","048"
"32028","REFRANCORE",30,0,0,30,"2020","089"
"32029","REFRONTOLO",16,22,1,39,"2020","065"
"32030","REGGIO NELL'EMILIA",82,10931,2,11015,"2020","033"
"32031","REGGIOLO",731,2529,0,3260,"2020","032"
"32032","REMEDELLO",7585,2421,196,10202,"2020","160"
"32033","RENATE",4,0,1,5,"2020",NA
"32034","RESANA",2902,55,9,2966,"2020","066"
"32035","REVELLO",6690,1969,284,8943,"2020","180"
"32036","REVIGLIASCO D'ASTI",256,0,0,256,"2020","090"
"32037","REVINE LAGO",14,0,0,14,"2020","067"
"32038","REZZATO",405,806,0,1211,"2020","161"
"32039","RHO",9,601,0,610,"2020","182"
"32040","RIBORDONE",10,0,0,10,"2020","212"
"32041","RICCIONE",2,0,0,2,"2020","013"
"32042","RICENGO",19,2508,9,2536,"2020","079"
"32043","RIESE PIO X",8591,406,8,9005,"2020","068"
"32044","RIFREDDO",894,9,51,954,"2020","181"
"32045","RIMELLA",2,6,8,16,"2020","113"
"32046","RIMINI",92,123,0,215,"2020","014"
"32047","RIO SALICETO",993,343,0,1336,"2020","034"
"32048","RIOLO TERME",317,0,0,317,"2020","015"
"32049","RIOLUNATO",65,12,0,77,"2020","035"
"32050","RIPALTA ARPINA",0,420,0,420,"2020","080"
"32051","RIPALTA CREMASCA",3,327,0,330,"2020","081"
"32052","RIPALTA GUERINA",2,526,0,528,"2020","082"
"32053","RIVA DEL PO",1639,80,0,1719,"2020",NA
"32054","RIVA DI SOLTO",1,0,0,1,"2020","180"
"32055","RIVA PRESSO CHIERI",2957,140,163,3260,"2020","215"
"32056","RIVALBA",71,0,0,71,"2020","213"
"32057","RIVALTA DI TORINO",103,0,0,103,"2020","214"
"32058","RIVAMONTE AGORDINO",0,14,0,14,"2020","043"
"32059","RIVANAZZANO",91,0,0,91,"2020","122"
"32060","RIVARA",138,112,0,250,"2020","216"
"32061","RIVAROLO CANAVESE",1105,308,566,1979,"2020","217"
"32062","RIVAROLO DEL RE ED UNITI",3260,149,231,3640,"2020","083"
"32063","RIVAROLO MANTOVANO",57,1248,146,1451,"2020","050"
"32064","RIVAROSSA",5,133,0,138,"2020","218"
"32065","RIVERGARO",66,1131,0,1197,"2020","038"
"32066","RIVOLI",1418,9,48,1475,"2020","219"
"32067","RIVOLI VERONESE",172,3,5,180,"2020","062"
"32068","RIVOLTA D'ADDA",2216,2536,116,4868,"2020","084"
"32069","ROANA",29,400,3,432,"2020","085"
"32070","ROASCIO",8,0,0,8,"2020","184"
"32071","ROASIO",4,0,0,4,"2020","116"
"32072","ROATTO",131,0,0,131,"2020","091"
"32073","ROBASSOMERO",45,93,19,157,"2020","220"
"32074","ROBBIO",5,156,0,161,"2020","123"
"32075","ROBECCHETTO CON INDUNO",235,202,18,455,"2020","183"
"32076","ROBECCO D'OGLIO",0,3009,0,3009,"2020","085"
"32077","ROBECCO PAVESE",1,0,0,1,"2020","124"
"32078","ROBECCO SUL NAVIGLIO",53,692,71,816,"2020","184"
"32079","ROBELLA",420,0,0,420,"2020","092"
"32080","ROBILANTE",244,0,2,246,"2020","185"
"32081","ROBURENT",23,0,0,23,"2020","186"
"32082","ROCCA CANAVESE",100,0,0,100,"2020","221"
"32083","ROCCA CIGLIE'",8,0,0,8,"2020","188"
"32084","ROCCA D'ARAZZO",278,0,0,278,"2020","093"
"32085","ROCCA DE' BALDI",2656,948,729,4333,"2020","189"
"32086","ROCCA GRIMALDA",14,0,0,14,"2020","147"
"32087","ROCCA PIETORE",0,11,0,11,"2020","044"
"32088","ROCCA SAN CASCIANO",133,0,0,133,"2020","036"
"32089","ROCCA SUSELLA",1,0,0,1,"2020",NA
"32090","ROCCABIANCA",0,1068,0,1068,"2020","030"
"32091","ROCCABRUNA",57,44,58,159,"2020","187"
"32092","ROCCAFORTE LIGURE",41,0,0,41,"2020","146"
"32093","ROCCAFORTE MONDOVI'",1179,0,8,1187,"2020","190"
"32094","ROCCAFRANCA",1884,1753,20,3657,"2020","162"
"32095","ROCCASPARVERA",533,0,0,533,"2020","191"
"32096","ROCCAVERANO",114,0,0,114,"2020","094"
"32097","ROCCAVIONE",33,0,0,33,"2020","192"
"32098","ROCCHETTA LIGURE",26,0,0,26,"2020","148"
"32099","ROCCHETTA PALAFEA",2,0,0,2,"2020","095"
"32100","ROCCHETTA TANARO",435,0,0,435,"2020","096"
"32101","RODANO",64,48,0,112,"2020","185"
"32102","RODDI",55,38,0,93,"2020","194"
"32103","RODDINO",73,0,0,73,"2020","195"
"32104","RODELLO",104,0,0,104,"2020","196"
"32105","RODENGO-SAIANO",15,249,115,379,"2020","163"
"32106","RODERO",2,6,1,9,"2020",NA
"32107","RODIGO",1105,1171,1406,3682,"2020","051"
"32108","ROE' VOLCIANO",6,0,0,6,"2020","164"
"32109","ROGENO",20,241,38,299,"2020","072"
"32110","ROGNANO",12,0,0,12,"2020","127"
"32111","ROGNO",11,83,0,94,"2020","182"
"32112","ROGOLO",7,25,0,32,"2020","056"
"32113","ROLETTO",141,90,0,231,"2020","222"
"32114","ROLO",17,259,0,276,"2020","035"
"32115","ROMAGNANO SESIA",38,0,0,38,"2020","130"
"32116","ROMAGNESE",101,0,0,101,"2020","128"
"32117","ROMANENGO",0,2570,0,2570,"2020","086"
"32118","ROMANO CANAVESE",36,0,0,36,"2020","223"
"32119","ROMANO D'EZZELINO",204,485,10,699,"2020","086"
"32120","ROMANO DI LOMBARDIA",121,3149,66,3336,"2020","183"
"32121","ROMENTINO",14,0,0,14,"2020","131"
"32122","RONAGO",1,0,33,34,"2020","199"
"32123","RONCA'",3,0,0,3,"2020","063"
"32124","RONCADE",2118,76,0,2194,"2020","069"
"32125","RONCADELLE",251,791,0,1042,"2020","165"
"32126","RONCARO",2,0,0,2,"2020","129"
"32127","RONCELLO",1,0,0,1,"2020",NA
"32128","RONCO ALL'ADIGE",6957,0,0,6957,"2020","064"
"32129","RONCO BIELLESE",21,45,0,66,"2020","053"
"32130","RONCO BRIANTINO",0,164,0,164,"2020",NA
"32131","RONCOBELLO",2,0,0,2,"2020",NA
"32132","RONCOFERRARO",3135,785,277,4197,"2020","052"
"32133","RONCOFREDDO",21,61,0,82,"2020","037"
"32134","RONCOLA",20,46,0,66,"2020","185"
"32135","RONSECCO",4,0,0,4,"2020",NA
"32136","ROPPOLO",6,0,0,6,"2020","054"
"32137","RORA'",25,0,0,25,"2020","226"
"32138","ROSA'",66,638,2,706,"2020","087"
"32139","ROSATE",3360,510,0,3870,"2020","188"
"32140","ROSIGNANO MONFERRATO",101,0,0,101,"2020","149"
"32141","ROSOLINA",7,0,0,7,"2020","040"
"32142","ROSSA",9,13,0,22,"2020","121"
"32143","ROSSANA",109,121,0,230,"2020","197"
"32144","ROSSANO VENETO",321,197,14,532,"2020","088"
"32145","ROSTA",29,0,86,115,"2020","228"
"32146","ROTA D'IMAGNA",10,51,0,61,"2020","186"
"32147","ROTTOFRENO",502,1200,0,1702,"2020","039"
"32148","ROTZO",122,0,3,125,"2020","089"
"32149","ROURE",23,0,0,23,"2020","227"
"32150","ROVASENDA",12,0,0,12,"2020","122"
"32151","ROVATO",1874,2363,11,4248,"2020","166"
"32152","ROVELLASCA",6,69,0,75,"2020","201"
"32153","ROVELLO PORRO",1,0,0,1,"2020",NA
"32154","ROVERBELLA",13925,761,107,14793,"2020","053"
"32155","ROVERCHIARA",4374,0,42,4416,"2020","065"
"32156","ROVERE' VERONESE",265,1230,0,1495,"2020","067"
"32157","ROVEREDO DI GUA'",1614,56,33,1703,"2020","066"
"32158","ROVESCALA",13,0,0,13,"2020","131"
"32159","ROVETTA",35,128,0,163,"2020","187"
"32160","ROVIGO",1349,5,0,1354,"2020","041"
"32161","ROVOLON",167,25,43,235,"2020","071"
"32162","RUBANO",63,34,0,97,"2020","072"
"32163","RUBIANA",6,0,1,7,"2020","229"
"32164","RUBIERA",2,455,0,457,"2020","036"
"32165","RUDIANO",314,1226,29,1569,"2020","167"
"32166","RUEGLIO",96,0,3,99,"2020","230"
"32167","RUFFIA",415,185,61,661,"2020","198"
"32168","RUSSI",7,0,0,7,"2020","016"
"32169","SABBIO CHIESE",17,82,7,106,"2020","168"
"32170","SABBIONETA",6,53,0,59,"2020","054"
"32171","SACCOLONGO",69,520,5,594,"2020","073"
"32172","SAGLIANO MICCA",38,0,0,38,"2020","056"
"32173","SALA BAGANZA",21,131,44,196,"2020","031"
"32174","SALA BIELLESE",8,0,0,8,"2020","057"
"32175","SALA BOLOGNESE",368,0,0,368,"2020","050"
"32176","SALA COMACINA",3,0,0,3,"2020","203"
"32177","SALARA",2,0,0,2,"2020","042"
"32178","SALASSA",25,0,0,25,"2020","231"
"32179","SALBERTRAND",52,0,0,52,"2020","232"
"32180","SALCEDO",680,62,0,742,"2020","090"
"32181","SALE DELLE LANGHE",189,0,0,189,"2020","199"
"32182","SALE MARASINO",35,11,28,74,"2020","169"
"32183","SALE SAN GIOVANNI",68,0,0,68,"2020","200"
"32184","SALERANO CANAVESE",4,0,0,4,"2020",NA
"32185","SALERANO SUL LAMBRO",1,292,0,293,"2020","046"
"32186","SALGAREDA",1572,185,1,1758,"2020","070"
"32187","SALICETO",45,0,0,45,"2020","201"
"32188","SALIZZOLE",2573,363,49,2985,"2020","068"
"32189","SALMOUR",256,0,0,256,"2020","202"
"32190","SALO'",0,36,3,39,"2020","170"
"32191","SALSOMAGGIORE TERME",13,1004,0,1017,"2020","032"
"32192","SALTRIO",2,60,0,62,"2020","117"
"32193","SALUDECIO",93,0,0,93,"2020","015"
"32194","SALUGGIA",542,160,0,702,"2020","128"
"32195","SALUSSOLA",590,6,0,596,"2020","058"
"32196","SALUZZO",3164,3572,611,7347,"2020","203"
"32197","SALVIROLA",720,72,5,797,"2020","087"
"32198","SALZANO",295,27,2,324,"2020","032"
"32199","SAMARATE",39,0,0,39,"2020","118"
"32200","SAMBUCO",40,0,0,40,"2020","204"
"32201","SAMOLACO",153,720,49,922,"2020","057"
"32202","SAMPEYRE",285,102,0,387,"2020","205"
"32203","SAN BARTOLOMEO VAL CAVARGNA",2,0,0,2,"2020","204"
"32204","SAN BASSANO",6,1712,0,1718,"2020","088"
"32205","SAN BELLINO",1495,0,0,1495,"2020","043"
"32206","SAN BENEDETTO BELBO",58,0,0,58,"2020","206"
"32207","SAN BENEDETTO PO",887,2047,531,3465,"2020","055"
"32208","SAN BENEDETTO VAL DI SAMBRO",222,87,3,312,"2020","051"
"32209","SAN BENIGNO CANAVESE",228,0,7,235,"2020","236"
"32210","SAN BERNARDINO VERBANO",3,0,0,3,"2020","061"
"32211","SAN BIAGIO DI CALLALTA",416,0,0,416,"2020","071"
"32212","SAN BONIFACIO",1759,0,0,1759,"2020","069"
"32213","SAN CARLO CANAVESE",240,152,106,498,"2020","237"
"32214","SAN CESARIO SUL PANARO",37,648,0,685,"2020","036"
"32215","SAN CLEMENTE",18,0,0,18,"2020","016"
"32216","SAN COLOMBANO AL LAMBRO",23,267,0,290,"2020","191"
"32217","SAN COLOMBANO BELMONTE",2,16,0,18,"2020","238"
"32218","SAN CRISTOFORO",1,0,0,1,"2020","152"
"32219","SAN DAMIANO D'ASTI",4103,0,0,4103,"2020","097"
"32220","SAN DAMIANO MACRA",40,0,0,40,"2020","207"
"32221","SAN DANIELE PO",8,1633,0,1641,"2020","089"
"32222","SAN DIDERO",0,6,0,6,"2020","239"
"32223","SAN DONA' DI PIAVE",238,318,0,556,"2020","033"
"32224","SAN DONATO MILANESE",0,0,6,6,"2020","192"
"32225","SAN FELICE DEL BENACO",7,0,0,7,"2020","171"
"32226","SAN FELICE SUL PANARO",0,952,0,952,"2020","037"
"32227","SAN FERMO DELLA BATTAGLIA",36,0,20,56,"2020","206"
"32228","SAN FIOR",34,19,8,61,"2020","072"
"32229","SAN FIORANO",0,150,0,150,"2020","047"
"32230","SAN FRANCESCO AL CAMPO",641,327,0,968,"2020","240"
"32231","SAN GENESIO ED UNITI",1,574,0,575,"2020","135"
"32232","SAN GERMANO CHISONE",86,11,4,101,"2020","242"
"32233","SAN GERMANO VERCELLESE",6,0,0,6,"2020","131"
"32234","SAN GERVASIO BRESCIANO",1,262,0,263,"2020","172"
"32235","SAN GIACOMO DELLE SEGNATE",416,241,87,744,"2020","056"
"32236","SAN GIACOMO VERCELLESE",1516,0,0,1516,"2020","035"
"32237","SAN GILLIO",110,66,0,176,"2020","243"
"32238","SAN GIORGIO BIGARELLO",1819,304,443,2566,"2020",NA
"32239","SAN GIORGIO CANAVESE",155,21,0,176,"2020","244"
"32240","SAN GIORGIO DELLE PERTICHE",257,70,0,327,"2020","075"
"32241","SAN GIORGIO DI LOMELLINA",1,0,0,1,"2020","136"
"32242","SAN GIORGIO DI PIANO",11,0,0,11,"2020","052"
"32243","SAN GIORGIO IN BOSCO",230,692,7,929,"2020","076"
"32244","SAN GIORGIO MONFERRATO",18,0,0,18,"2020","153"
"32245","SAN GIORGIO PIACENTINO",235,796,0,1031,"2020","040"
"32246","SAN GIORGIO SCARAMPI",71,0,0,71,"2020","098"
"32247","SAN GIORIO DI SUSA",7,21,0,28,"2020","245"
"32248","SAN GIOVANNI BIANCO",42,29,0,71,"2020","188"
"32249","SAN GIOVANNI DEL DOSSO",0,262,183,445,"2020","058"
"32250","SAN GIOVANNI ILARIONE",693,2,0,695,"2020","070"
"32251","SAN GIOVANNI IN CROCE",0,469,1,470,"2020","090"
"32252","SAN GIOVANNI IN MARIGNANO",5,0,0,5,"2020","017"
"32253","SAN GIOVANNI IN PERSICETO",26,779,0,805,"2020","053"
"32254","SAN GIOVANNI LUPATOTO",658,70,0,728,"2020","071"
"32255","SAN GIULIANO MILANESE",25,500,93,618,"2020","195"
"32256","SAN GIUSTO CANAVESE",160,31,0,191,"2020","246"
"32257","SAN GREGORIO NELLE ALPI",11,53,0,64,"2020","045"
"32258","SAN LAZZARO DI SAVENA",5,0,0,5,"2020","054"
"32259","SAN LEO",317,368,0,685,"2020","025"
"32260","SAN MARTINO ALFIERI",11,0,0,11,"2020","099"
"32261","SAN MARTINO BUON ALBERGO",155,1046,0,1201,"2020","073"
"32262","SAN MARTINO CANAVESE",58,0,0,58,"2020","247"
"32263","SAN MARTINO DALL'ARGINE",163,970,75,1208,"2020","059"
"32264","SAN MARTINO DEL LAGO",10,0,0,10,"2020","091"
"32265","SAN MARTINO DI LUPARI",3187,316,1,3504,"2020","077"
"32266","SAN MARTINO IN RIO",0,1044,0,1044,"2020","037"
"32267","SAN MARTINO IN STRADA",0,936,0,936,"2020","048"
"32268","SAN MARTINO SICCOMARIO",0,1,0,1,"2020","137"
"32269","SAN MARZANO OLIVETO",23,0,0,23,"2020","100"
"32270","SAN MAURIZIO CANAVESE",136,374,198,708,"2020","248"
"32271","SAN MAURIZIO D'OPAGLIO",6,0,0,6,"2020","133"
"32272","SAN MAURO DI SALINE",87,340,0,427,"2020","074"
"32273","SAN MAURO TORINESE",4,0,0,4,"2020","249"
"32274","SAN MICHELE AL TAGLIAMENTO",2618,44,0,2662,"2020","034"
"32275","SAN MICHELE MONDOVI'",177,0,0,177,"2020","210"
"32276","SAN NAZZARO SESIA",136,0,0,136,"2020","134"
"32277","SAN NAZZARO VAL CAVARGNA",4,0,6,10,"2020","207"
"32278","SAN NICOLO' DI COMELICO",8,6,0,14,"2020","046"
"32279","SAN PAOLO",357,2776,22,3155,"2020","138"
"32280","SAN PAOLO D'ARGON",30,0,9,39,"2020","189"
"32281","SAN PAOLO SOLBRITO",23,0,0,23,"2020","101"
"32282","SAN PELLEGRINO TERME",64,30,0,94,"2020","190"
"32283","SAN PIETRO DI CADORE",1,55,0,56,"2020","047"
"32284","SAN PIETRO DI FELETTO",27,14,7,48,"2020","073"
"32285","SAN PIETRO DI MORUBIO",2,0,0,2,"2020","075"
"32286","SAN PIETRO IN CASALE",3,424,0,427,"2020","055"
"32287","SAN PIETRO IN CERRO",113,974,0,1087,"2020","041"
"32288","SAN PIETRO IN GU",709,3219,0,3928,"2020","078"
"32289","SAN PIETRO MOSEZZO",1,0,0,1,"2020","135"
"32290","SAN PIETRO MUSSOLINO",13,0,0,13,"2020","094"
"32291","SAN PIETRO VAL LEMINA",6,0,0,6,"2020","250"
"32292","SAN PIETRO VIMINARIO",130,20,0,150,"2020","079"
"32293","SAN POLO D'ENZA",0,705,0,705,"2020","038"
"32294","SAN POLO DI PIAVE",873,56,0,929,"2020","074"
"32295","SAN PONSO",0,30,0,30,"2020","251"
"32296","SAN POSSIDONIO",0,412,0,412,"2020","038"
"32297","SAN PROSPERO",0,337,0,337,"2020","039"
"32298","SAN RAFFAELE CIMENA",52,0,0,52,"2020","252"
"32299","SAN ROCCO AL PORTO",131,744,14,889,"2020","049"
"32300","SAN SALVATORE MONFERRATO",182,0,0,182,"2020","154"
"32301","SAN SEBASTIANO CURONE",23,0,0,23,"2020","155"
"32302","SAN SEBASTIANO DA PO",254,3,0,257,"2020","253"
"32303","SAN SECONDO DI PINEROLO",536,18,74,628,"2020","254"
"32304","SAN SECONDO PARMENSE",0,1486,0,1486,"2020","033"
"32305","SAN SIRO",1,0,9,10,"2020","248"
"32306","SAN VENDEMIANO",70,107,0,177,"2020","076"
"32307","SAN VITO DI LEGUZZANO",425,148,0,573,"2020","096"
"32308","SAN VITTORE OLONA",19,42,0,61,"2020","201"
"32309","SAN ZENO DI MONTAGNA",154,153,63,370,"2020","079"
"32310","SAN ZENO NAVIGLIO",0,613,0,613,"2020","173"
"32311","SAN ZENONE AL LAMBRO",0,854,0,854,"2020","202"
"32312","SAN ZENONE DEGLI EZZELINI",2457,416,0,2873,"2020","077"
"32313","SANDIGLIANO",81,85,9,175,"2020","059"
"32314","SANDRIGO",1381,1673,0,3054,"2020","091"
"32315","SANFRE'",655,0,16,671,"2020","208"
"32316","SANFRONT",2223,164,50,2437,"2020","209"
"32317","SANGANO",58,0,11,69,"2020","241"
"32318","SANGIANO",0,48,0,48,"2020","141"
"32319","SANGUINETTO",5,180,0,185,"2020","072"
"32320","SANNAZZARO DE' BURGONDI",10,45,0,55,"2020","138"
"32321","SANT'AGATA BOLOGNESE",0,688,0,688,"2020","056"
"32322","SANT'AGATA FELTRIA",192,38,0,230,"2020","026"
"32323","SANT'AGATA FOSSILI",77,0,0,77,"2020","156"
"32324","SANT'AGATA SUL SANTERNO",9,0,0,9,"2020","017"
"32325","SANT'ALBANO STURA",4181,927,17,5125,"2020","211"
"32326","SANT'ALESSIO CON VIALONE",0,1,0,1,"2020","141"
"32327","SANT'AMBROGIO DI TORINO",55,13,12,80,"2020","255"
"32328","SANT'AMBROGIO DI VALPOLICELLA",3,59,0,62,"2020","077"
"32329","SANT'ANGELO DI PIOVE DI SACCO",309,73,0,382,"2020","082"
"32330","SANT'ANGELO LODIGIANO",28,360,3,391,"2020","050"
"32331","SANT'ANGELO LOMELLINA",0,461,0,461,"2020","144"
"32332","SANT'ANNA D'ALFAEDO",169,1329,116,1614,"2020","078"
"32333","SANT'ANTONINO DI SUSA",23,62,19,104,"2020","256"
"32334","SANT'ELENA",59,0,0,59,"2020","083"
"32335","SANT'ILARIO D'ENZA",2,639,0,641,"2020","039"
"32336","SANT'OMOBONO TERME",98,66,0,164,"2020","192"
"32337","SANT'URBANO",696,0,0,696,"2020","084"
"32338","SANTA BRIGIDA",10,18,0,28,"2020","191"
"32339","SANTA CRISTINA E BISSONE",9,125,0,134,"2020","139"
"32340","SANTA GIULETTA",14,0,0,14,"2020","140"
"32341","SANTA GIUSTINA",195,117,0,312,"2020","048"
"32342","SANTA GIUSTINA IN COLLE",1504,291,22,1817,"2020","080"
"32343","SANTA LUCIA DI PIAVE",32,52,10,94,"2020","075"
"32344","SANTA MARGHERITA DI STAFFORA",27,0,38,65,"2020","142"
"32345","SANTA MARIA DELLA VERSA",3,0,0,3,"2020","143"
"32346","SANTA MARIA DI SALA",49,147,14,210,"2020","035"
"32347","SANTA MARIA HOE'",7,0,0,7,"2020","074"
"32348","SANTA MARIA MAGGIORE",18,6,27,51,"2020","062"
"32349","SANTA SOFIA",233,0,1,234,"2020","043"
"32350","SANTA VITTORIA D'ALBA",57,0,0,57,"2020","212"
"32351","SANTARCANGELO DI ROMAGNA",32,0,0,32,"2020","018"
"32352","SANTENA",438,0,0,438,"2020","257"
"32353","SANTHIA'",294,41,0,335,"2020","133"
"32354","SANTO STEFANO BELBO",5,0,0,5,"2020","213"
"32355","SANTO STEFANO DI CADORE",4,19,0,23,"2020","050"
"32356","SANTO STEFANO LODIGIANO",83,390,0,473,"2020","051"
"32357","SANTO STEFANO ROERO",71,0,0,71,"2020","214"
"32358","SANTO STEFANO TICINO",0,0,82,82,"2020","200"
"32359","SANTO STINO DI LIVENZA",3591,96,0,3687,"2020","036"
"32360","SANTORSO",423,149,0,572,"2020","095"
"32361","SAONARA",281,0,0,281,"2020","085"
"32362","SARCEDO",1515,377,0,1892,"2020","097"
"32363","SARDIGLIANO",1,0,0,1,"2020","157"
"32364","SAREGO",353,23,0,376,"2020","098"
"32365","SAREZZO",10,26,0,36,"2020","174"
"32366","SARMATO",0,295,0,295,"2020","042"
"32367","SARMEDE",41,16,15,72,"2020","078"
"32368","SARNICO",4,0,0,4,"2020","193"
"32369","SARONNO",2,0,0,2,"2020","119"
"32370","SARSINA",219,22,0,241,"2020","044"
"32371","SASSO MARCONI",37,28,0,65,"2020","057"
"32372","SASSUOLO",26,381,0,407,"2020","040"
"32373","SAUZE D'OULX",85,0,0,85,"2020","259"
"32374","SAUZE DI CESANA",18,0,19,37,"2020","258"
"32375","SAVIGLIANO",11381,5099,196,16676,"2020","215"
"32376","SAVIGNANO SUL PANARO",38,55,0,93,"2020","041"
"32377","SAVIGNANO SUL RUBICONE",62,0,0,62,"2020","045"
"32378","SAVIORE DELL'ADAMELLO",7,34,5,46,"2020","175"
"32379","SCAGNELLO",202,0,0,202,"2020","216"
"32380","SCALDASOLE",0,20,0,20,"2020","147"
"32381","SCALENGHE",1781,2347,275,4403,"2020","260"
"32382","SCANDIANO",33,1274,0,1307,"2020","040"
"32383","SCANDOLARA RAVARA",0,878,0,878,"2020","092"
"32384","SCANDOLARA RIPA D'OGLIO",28,748,29,805,"2020","093"
"32385","SCANZOROSCIATE",36,0,0,36,"2020","194"
"32386","SCARMAGNO",5,0,0,5,"2020","261"
"32387","SCARNAFIGI",1298,1656,74,3028,"2020","217"
"32388","SCHIAVON",1541,1811,0,3352,"2020","099"
"32389","SCHIGNANO",23,1,4,28,"2020","211"
"32390","SCHILPARIO",0,73,0,73,"2020","195"
"32391","SCHIO",403,247,2,652,"2020","100"
"32392","SCIOLZE",169,0,0,169,"2020","262"
"32393","SCOPELLO",41,12,0,53,"2020","135"
"32394","SCORZE'",4294,34,0,4328,"2020","037"
"32395","SECUGNAGO",0,1305,0,1305,"2020","052"
"32396","SEDICO",1672,131,1,1804,"2020","053"
"32397","SEDRIANO",17,835,0,852,"2020","204"
"32398","SEDRINA",34,12,0,46,"2020","196"
"32399","SEGRATE",23,0,0,23,"2020","205"
"32400","SEGUSINO",12,54,3,69,"2020","079"
"32401","SELLERO",9,17,4,30,"2020","176"
"32402","SELVA DI CADORE",0,1,0,1,"2020","054"
"32403","SELVA DI PROGNO",42,468,72,582,"2020","080"
"32404","SELVAZZANO DENTRO",31,0,40,71,"2020","086"
"32405","SELVINO",1,0,0,1,"2020","197"
"32406","SENIGA",2028,2212,0,4240,"2020","177"
"32407","SENNA COMASCO",5,0,35,40,"2020","212"
"32408","SENNA LODIGIANA",3,1011,0,1014,"2020","053"
"32409","SEREGNO",4,0,0,4,"2020",NA
"32410","SEREN DEL GRAPPA",81,49,193,323,"2020","055"
"32411","SERGNANO",20,1741,0,1761,"2020","094"
"32412","SERIATE",103,82,3,188,"2020","198"
"32413","SERINA",19,107,0,126,"2020","199"
"32414","SERLE",20,35,29,84,"2020","178"
"32415","SERMIDE E FELONICA",0,190,103,293,"2020",NA
"32416","SERNAGLIA DELLA BATTAGLIA",957,0,3,960,"2020","080"
"32417","SERNIO",4,0,0,4,"2020","059"
"32418","SEROLE",68,16,1,85,"2020","104"
"32419","SERRALUNGA D'ALBA",24,0,0,24,"2020","218"
"32420","SERRALUNGA DI CREA",23,0,0,23,"2020","159"
"32421","SERRAMAZZONI",23,1620,0,1643,"2020","042"
"32422","SERRAVALLE A PO",80,0,136,216,"2020","062"
"32423","SERRAVALLE LANGHE",101,0,0,101,"2020","219"
"32424","SERRAVALLE SCRIVIA",10,0,0,10,"2020","160"
"32425","SERRAVALLE SESIA",7,0,0,7,"2020","137"
"32426","SESTO CALENDE",31,0,1,32,"2020","120"
"32427","SESTO ED UNITI",4,2194,0,2198,"2020","095"
"32428","SESTOLA",51,331,0,382,"2020","043"
"32429","SETTALA",34,317,58,409,"2020","210"
"32430","SETTIME",162,0,0,162,"2020","106"
"32431","SETTIMO MILANESE",7,327,4,338,"2020","211"
"32432","SETTIMO ROTTARO",1,25,0,26,"2020","264"
"32433","SETTIMO TORINESE",423,392,54,869,"2020","265"
"32434","SETTIMO VITTONE",132,106,6,244,"2020","266"
"32435","SEVESO",1,0,0,1,"2020",NA
"32436","SEZZADIO",48,0,0,48,"2020","161"
"32437","SILEA",3,113,0,116,"2020","081"
"32438","SILLAVENGO",38,125,0,163,"2020","138"
"32439","SILVANO D'ORBA",3,0,0,3,"2020","162"
"32440","SILVANO PIETRA",1,0,0,1,"2020",NA
"32441","SINIO",10,10,0,20,"2020","220"
"32442","SIRONE",5,99,3,107,"2020","075"
"32443","SIRTORI",5,0,0,5,"2020","076"
"32444","SISSA TRECASALI",11,834,0,845,"2020",NA
"32445","SIZIANO",53,64,0,117,"2020","150"
"32446","SIZZANO",223,9,79,311,"2020","139"
"32447","SOAVE",103,0,0,103,"2020","081"
"32448","SOGLIANO AL RUBICONE",190,43,0,233,"2020","046"
"32449","SOIANO DEL LAGO",0,0,4,4,"2020","180"
"32450","SOLAGNA",6,8,0,14,"2020","101"
"32451","SOLARO",0,31,0,31,"2020","213"
"32452","SOLAROLO RAINERIO",0,273,0,273,"2020","096"
"32453","SOLBIATE CON CAGNO",3,131,0,134,"2020",NA
"32454","SOLERO",298,0,0,298,"2020","163"
"32455","SOLESINO",5,0,0,5,"2020","087"
"32456","SOLFERINO",618,299,148,1065,"2020","063"
"32457","SOLIERA",28,1012,0,1040,"2020","044"
"32458","SOLIGNANO",14,221,0,235,"2020","035"
"32459","SOLONGHELLO",101,0,0,101,"2020","164"
"32460","SOLTO COLLINA",20,0,0,20,"2020","200"
"32461","SOMAGLIA",0,1291,0,1291,"2020","054"
"32462","SOMANO",70,0,0,70,"2020","221"
"32463","SOMMA LOMBARDO",27,12,27,66,"2020","123"
"32464","SOMMACAMPAGNA",1586,361,54,2001,"2020","082"
"32465","SOMMARIVA DEL BOSCO",1027,579,174,1780,"2020","222"
"32466","SOMMARIVA PERNO",19,0,0,19,"2020","223"
"32467","SOMMO",15,0,0,15,"2020","151"
"32468","SONA",1950,589,12,2551,"2020","083"
"32469","SONCINO",659,5328,142,6129,"2020","097"
"32470","SONDALO",21,72,10,103,"2020","060"
"32471","SONDRIO",12,48,0,60,"2020","061"
"32472","SONGAVAZZO",1,0,0,1,"2020","201"
"32473","SONICO",2,81,12,95,"2020","181"
"32474","SORAGNA",15,1559,0,1574,"2020","036"
"32475","SORBOLO MEZZANI",9,1831,0,1840,"2020",NA
"32476","SORDEVOLO",73,37,0,110,"2020","063"
"32477","SORDIO",0,283,0,283,"2020","055"
"32478","SORESINA",37,1204,5,1246,"2020","098"
"32479","SORGA'",1629,37,0,1666,"2020","084"
"32480","SORICO",7,14,86,107,"2020","216"
"32481","SORISO",5,0,0,5,"2020","140"
"32482","SORISOLE",60,76,0,136,"2020","202"
"32483","SORMANO",21,0,0,21,"2020","217"
"32484","SOSPIRO",67,537,0,604,"2020","099"
"32485","SOSPIROLO",5,77,0,82,"2020","056"
"32486","SOSSANO",50,373,0,423,"2020","102"
"32487","SOSTEGNO",5,18,0,23,"2020","064"
"32488","SOTTO IL MONTE GIOVANNI XXIII",113,0,0,113,"2020","203"
"32489","SOVERE",68,33,0,101,"2020","204"
"32490","SOVERZENE",6,0,0,6,"2020","057"
"32491","SOVICO",1,0,0,1,"2020",NA
"32492","SOVIZZO",421,110,0,531,"2020","103"
"32493","SOVRAMONTE",22,75,0,97,"2020","058"
"32494","SOZZAGO",1,0,0,1,"2020","141"
"32495","SPARONE",32,54,0,86,"2020","267"
"32496","SPESSA",12,0,0,12,"2020","152"
"32497","SPIGNO MONFERRATO",134,12,67,213,"2020","165"
"32498","SPILAMBERTO",1943,1361,0,3304,"2020","045"
"32499","SPINEA",29,138,0,167,"2020","038"
"32500","SPINEDA",6,767,0,773,"2020","101"
"32501","SPINETO SCRIVIA",108,0,0,108,"2020","166"
"32502","SPINO D'ADDA",782,2280,0,3062,"2020","102"
"32503","SPINONE AL LAGO",3,1,1,5,"2020","205"
"32504","SPIRANO",4,1052,0,1056,"2020","206"
"32505","SPRESIANO",35,200,0,235,"2020","082"
"32506","STAGNO LOMBARDO",3,6560,0,6563,"2020","103"
"32507","STANGHELLA",387,0,0,387,"2020","088"
"32508","STAZZANO",1,0,0,1,"2020","167"
"32509","STAZZONA",6,3,6,15,"2020","218"
"32510","STEZZANO",248,245,215,708,"2020","207"
"32511","STIENTA",79,0,0,79,"2020","045"
"32512","STRA",4,0,0,4,"2020","039"
"32513","STRADELLA",6,30,0,36,"2020","153"
"32514","STRAMBINELLO",28,0,0,28,"2020",NA
"32515","STRAMBINO",178,0,0,178,"2020","269"
"32516","STRESA",80,0,0,80,"2020","064"
"32517","STREVI",24,0,0,24,"2020","168"
"32518","STROPPO",9,0,0,9,"2020","224"
"32519","STROZZA",4,0,0,4,"2020","208"
"32520","SUARDI",5,0,0,5,"2020","154"
"32521","SUELLO",2,0,12,14,"2020","078"
"32522","SUISIO",2,103,0,105,"2020","209"
"32523","SULBIATE",37,0,0,37,"2020",NA
"32524","SULZANO",43,263,2,308,"2020","182"
"32525","SUMIRAGO",91,73,0,164,"2020","124"
"32526","SUNO",44,388,0,432,"2020","143"
"32527","SUSA",167,0,0,167,"2020","270"
"32528","SUSEGANA",724,51,2,777,"2020","083"
"32529","SUSTINENTE",706,639,259,1604,"2020","064"
"32530","SUZZARA",2229,1431,2007,5667,"2020","065"
"32531","TACENO",4,0,13,17,"2020","079"
"32532","TAGLIO DI PO",8012,0,0,8012,"2020","046"
"32533","TAGLIOLO MONFERRATO",55,0,0,55,"2020","169"
"32534","TAIBON AGORDINO",0,28,0,28,"2020","059"
"32535","TAINO",40,117,0,157,"2020","125"
"32536","TALAMELLO",2,0,0,2,"2020","027"
"32537","TALAMONA",5,144,23,172,"2020","063"
"32538","TALEGGIO",75,21,0,96,"2020","210"
"32539","TAMBRE",10,99,0,109,"2020","060"
"32540","TARANTASCA",2746,723,0,3469,"2020","225"
"32541","TARTANO",15,21,0,36,"2020","064"
"32542","TARZO",27,0,3,30,"2020","084"
"32543","TAVAGNASCO",124,8,0,132,"2020","271"
"32544","TAVAZZANO CON VILLAVESCO",0,1074,60,1134,"2020","056"
"32545","TAVERNOLA BERGAMASCA",7,2,0,9,"2020","211"
"32546","TAVERNOLE SUL MELLA",14,43,10,67,"2020","183"
"32547","TAVIGLIANO",62,0,0,62,"2020","066"
"32548","TEGLIO",64,200,35,299,"2020","065"
"32549","TELGATE",2497,173,13,2683,"2020","212"
"32550","TEMU'",8,4,7,19,"2020","184"
"32551","TEOLO",37,27,0,64,"2020","089"
"32552","TERDOBBIATE",5,148,0,153,"2020","144"
"32553","TERENZO",57,798,0,855,"2020","038"
"32554","TERNO D'ISOLA",22,0,0,22,"2020","213"
"32555","TERRANOVA DEI PASSERINI",0,278,268,546,"2020","057"
"32556","TERRASSA PADOVANA",1415,0,0,1415,"2020","090"
"32557","TERRAZZO",0,10,0,10,"2020","085"
"32558","TERRE DEL RENO",0,0,1,1,"2020",NA
"32559","TERRUGGIA",36,0,0,36,"2020","171"
"32560","TERZO",19,0,0,19,"2020","172"
"32561","TEZZE SUL BRENTA",84,268,0,352,"2020","104"
"32562","THIENE",145,428,0,573,"2020","105"
"32563","TICENGO",0,396,0,396,"2020","104"
"32564","TIGLIOLE",865,0,0,865,"2020","108"
"32565","TIGNALE",12,0,0,12,"2020","185"
"32566","TIRANO",6,0,17,23,"2020","066"
"32567","TIZZANO VAL PARMA",2,731,0,733,"2020","039"
"32568","TOANO",60,1859,0,1919,"2020","041"
"32569","TOCENO",35,4,16,55,"2020","065"
"32570","TOLLEGNO",26,0,0,26,"2020","068"
"32571","TOMBOLO",971,15,0,986,"2020","091"
"32572","TONCO",741,0,0,741,"2020","109"
"32573","TONENGO",67,0,0,67,"2020","110"
"32574","TONEZZA DEL CIMONE",3,0,0,3,"2020","106"
"32575","TORBOLE CASAGLIA",11,856,1,868,"2020","186"
"32576","TORINO",142,0,30,172,"2020","272"
"32577","TORLINO VIMERCATI",0,332,0,332,"2020","105"
"32578","TORNACO",0,107,0,107,"2020",NA
"32579","TORNATA",4,170,0,174,"2020","106"
"32580","TORNOLO",81,4,0,85,"2020","040"
"32581","TORRAZZA COSTE",9,0,0,9,"2020","155"
"32582","TORRAZZA PIEMONTE",168,0,0,168,"2020","273"
"32583","TORRAZZO",13,0,0,13,"2020","069"
"32584","TORRE BERETTI E CASTELLARO",16,366,0,382,"2020","156"
"32585","TORRE BOLDONE",6,0,0,6,"2020","214"
"32586","TORRE BORMIDA",11,0,2,13,"2020","226"
"32587","TORRE D'ISOLA",0,778,0,778,"2020","159"
"32588","TORRE DE' BUSI",8,0,0,8,"2020","080"
"32589","TORRE DE' NEGRI",12,54,251,317,"2020","158"
"32590","TORRE DE' PICENARDI",81,2739,0,2820,"2020","107"
"32591","TORRE DE' ROVERI",12,0,0,12,"2020","216"
"32592","TORRE DI MOSTO",11,588,0,599,"2020","041"
"32593","TORRE DI SANTA MARIA",14,7,7,28,"2020","067"
"32594","TORRE PALLAVICINA",291,279,0,570,"2020","217"
"32595","TORRE PELLICE",90,0,10,100,"2020","275"
"32596","TORRE SAN GIORGIO",114,8,20,142,"2020","228"
"32597","TORREBELVICINO",990,4,0,994,"2020","107"
"32598","TORREGLIA",3,0,0,3,"2020","092"
"32599","TORRESINA",2,0,0,2,"2020","229"
"32600","TORREVECCHIA PIA",75,13,14,102,"2020","160"
"32601","TORRI DEL BENACO",4,0,0,4,"2020",NA
"32602","TORRI DI QUARTESOLO",45,156,0,201,"2020","108"
"32603","TORRICELLA VERZATE",2,0,0,2,"2020",NA
"32604","TORRILE",0,2660,0,2660,"2020","041"
"32605","TORTONA",2637,147,0,2784,"2020","174"
"32606","TOSCOLANO-MADERNO",2,0,2,4,"2020","187"
"32607","TOVO DI SANT'AGATA",7,71,1,79,"2020","068"
"32608","TRADATE",22,0,0,22,"2020","127"
"32609","TRANA",46,14,21,81,"2020","276"
"32610","TRAONA",63,85,95,243,"2020","069"
"32611","TRAREGO VIGGIONA",7,0,0,7,"2020","066"
"32612","TRASQUERA",9,0,7,16,"2020","067"
"32613","TRAVAGLIATO",308,545,0,853,"2020","188"
"32614","TRAVEDONA-MONATE",6,0,13,19,"2020","128"
"32615","TRAVERSELLA",39,27,10,76,"2020","278"
"32616","TRAVERSETOLO",91,1037,0,1128,"2020","042"
"32617","TRAVES",11,0,0,11,"2020","279"
"32618","TRAVO",40,22,0,62,"2020","043"
"32619","TREBASELEGHE",6471,89,0,6560,"2020","093"
"32620","TRECATE",1,185,0,186,"2020","149"
"32621","TRECENTA",309,119,0,428,"2020","047"
"32622","TREDOZIO",120,0,0,120,"2020","049"
"32623","TREGNAGO",606,133,0,739,"2020","087"
"32624","TREMEZZINA",23,15,32,70,"2020",NA
"32625","TREMOSINE",25,401,63,489,"2020","189"
"32626","TRENZANO",859,1418,160,2437,"2020","190"
"32627","TRESCORE BALNEARIO",37,39,11,87,"2020","218"
"32628","TRESCORE CREMASCO",22,531,0,553,"2020","109"
"32629","TRESIGNANA",3,0,0,3,"2020",NA
"32630","TRESIVIO",12,15,0,27,"2020","070"
"32631","TREVENZUOLO",284,1105,0,1389,"2020","088"
"32632","TREVIGLIO",956,1676,6,2638,"2020","219"
"32633","TREVIGNANO",1987,153,2,2142,"2020","085"
"32634","TREVILLE",15,0,0,15,"2020","175"
"32635","TREVIOLO",103,82,0,185,"2020","220"
"32636","TREVISO",476,119,13,608,"2020","086"
"32637","TREVISO BRESCIANO",6,39,6,51,"2020","191"
"32638","TREZZO SULL'ADDA",3,435,0,438,"2020","221"
"32639","TREZZO TINELLA",13,0,0,13,"2020","231"
"32640","TREZZONE",1,0,1,2,"2020","226"
"32641","TRIBANO",3,0,0,3,"2020","094"
"32642","TRIBIANO",1,68,0,69,"2020","222"
"32643","TRIGOLO",0,1125,0,1125,"2020","110"
"32644","TRINITA'",2584,508,426,3518,"2020","232"
"32645","TRINO",9,147,0,156,"2020","148"
"32646","TRISOBBIO",58,0,0,58,"2020","176"
"32647","TRISSINO",74,275,0,349,"2020","110"
"32648","TRIUGGIO",4,330,38,372,"2020",NA
"32649","TROFARELLO",588,62,0,650,"2020","280"
"32650","TROMELLO",17,354,208,579,"2020","164"
"32651","TRONTANO",15,12,0,27,"2020","068"
"32652","TRONZANO VERCELLESE",189,0,0,189,"2020","150"
"32653","TROVO",8,56,0,64,"2020","165"
"32654","TRUCCAZZANO",39,1916,27,1982,"2020","224"
"32655","TURANO LODIGIANO",72,2059,0,2131,"2020","058"
"32656","TURBIGO",0,40,5,45,"2020","226"
"32657","UBIALE CLANEZZO",8,0,0,8,"2020","221"
"32658","UBOLDO",12,0,0,12,"2020","130"
"32659","UGGIATE-TREVANO",11,54,12,77,"2020","228"
"32660","URAGO D'OGLIO",246,1162,0,1408,"2020","192"
"32661","URBANA",987,0,0,987,"2020","095"
"32662","URGNANO",165,183,0,348,"2020","222"
"32663","USMATE VELATE",4,21,2,27,"2020",NA
"32664","USSEAUX",24,45,35,104,"2020","281"
"32665","USSEGLIO",3,0,0,3,"2020","282"
"32666","VAIANO CREMASCO",8,672,0,680,"2020","111"
"32667","VAIE",0,8,30,38,"2020","283"
"32668","VAILATE",54,352,5,411,"2020","112"
"32669","VAL BREMBILLA",88,54,7,149,"2020",NA
"32670","VAL DELLA TORRE",236,0,20,256,"2020","284"
"32671","VAL DI CHY",34,0,0,34,"2020",NA
"32672","VAL DI NIZZA",1,0,0,1,"2020","166"
"32673","VAL DI ZOLDO",21,6,0,27,"2020",NA
"32674","VAL LIONA",290,174,0,464,"2020",NA
"32675","VAL MASINO",1,9,0,10,"2020","074"
"32676","VAL REZZO",20,0,19,39,"2020","233"
"32677","VALBONDIONE",3,15,0,18,"2020","223"
"32678","VALBREMBO",112,0,0,112,"2020","224"
"32679","VALBRENTA",33,34,5,72,"2020",NA
"32680","VALBRONA",6,0,2,8,"2020","229"
"32681","VALCHIUSA",112,121,22,255,"2020",NA
"32682","VALDAGNO",33,141,6,180,"2020","111"
"32683","VALDASTICO",1019,29,0,1048,"2020","112"
"32684","VALDENGO",37,25,0,62,"2020","071"
"32685","VALDIDENTRO",23,159,39,221,"2020","071"
"32686","VALDIERI",4,0,0,4,"2020","233"
"32687","VALDILANA",70,69,16,155,"2020",NA
"32688","VALDISOTTO",34,109,20,163,"2020","072"
"32689","VALDOBBIADENE",68,340,9,417,"2020","087"
"32690","VALDUGGIA",6,0,0,6,"2020","152"
"32691","VALEGGIO",20,0,0,20,"2020","167"
"32692","VALEGGIO SUL MINCIO",2042,2362,35,4439,"2020","089"
"32693","VALENZA",98,0,0,98,"2020","177"
"32694","VALERA FRATTA",7,259,179,445,"2020","059"
"32695","VALFENERA",1037,109,232,1378,"2020","112"
"32696","VALFURVA",21,93,10,124,"2020","073"
"32697","VALGANNA",13,0,1,14,"2020","131"
"32698","VALGIOIE",2,0,0,2,"2020",NA
"32699","VALGOGLIO",21,54,0,75,"2020","225"
"32700","VALGRANA",358,0,0,358,"2020","234"
"32701","VALGREGHENTINO",5,0,1,6,"2020","082"
"32702","VALLADA AGORDINA",0,8,0,8,"2020","062"
"32703","VALLE DI CADORE",1,0,0,1,"2020","063"
"32704","VALLE LOMELLINA",18,822,0,840,"2020","168"
"32705","VALLE SAN NICOLAO",7,0,0,7,"2020","074"
"32706","VALLEVE",0,4,0,4,"2020","226"
"32707","VALLI DEL PASUBIO",0,5,2,7,"2020","113"
"32708","VALLIO TERME",6,0,0,6,"2020","193"
"32709","VALLO TORINESE",13,0,0,13,"2020","286"
"32710","VALMADRERA",14,0,9,23,"2020","083"
"32711","VALMOREA",2,29,0,31,"2020","232"
"32712","VALMOZZOLA",51,24,0,75,"2020","044"
"32713","VALPERGA",173,130,20,323,"2020","287"
"32714","VALSAMOGGIA",286,840,0,1126,"2020",NA
"32715","VALSOLDA",2,8,4,14,"2020","234"
"32716","VALSTRONA",11,0,0,11,"2020","069"
"32717","VALTORTA",0,22,0,22,"2020","229"
"32718","VALVARRONE",0,0,2,2,"2020",NA
"32719","VALVESTINO",0,5,0,5,"2020","194"
"32720","VANZAGO",42,0,0,42,"2020","229"
"32721","VAPRIO D'ADDA",11,387,6,404,"2020","230"
"32722","VARALLO",19,50,0,69,"2020","156"
"32723","VARALLO POMBIA",1,0,0,1,"2020","154"
"32724","VARANO DE' MELEGARI",70,345,0,415,"2020","045"
"32725","VAREDO",1,0,0,1,"2020",NA
"32726","VARESE",80,83,0,163,"2020","133"
"32727","VARISELLA",132,0,0,132,"2020","289"
"32728","VARSI",6,424,0,430,"2020","046"
"32729","VARZI",74,7,3,84,"2020","171"
"32730","VARZO",6,14,7,27,"2020","071"
"32731","VAUDA CANAVESE",53,0,0,53,"2020","290"
"32732","VAZZOLA",1338,94,4,1436,"2020","088"
"32733","VEDANO OLONA",4,209,0,213,"2020","134"
"32734","VEDELAGO",20453,385,112,20950,"2020","089"
"32735","VEDESETA",17,119,0,136,"2020","230"
"32736","VEGGIANO",303,87,1,391,"2020","096"
"32737","VEGLIO",1,1,0,2,"2020","075"
"32738","VELESO",0,0,8,8,"2020","236"
"32739","VELLEZZO BELLINI",12,471,5,488,"2020","173"
"32740","VELO D'ASTICO",830,22,0,852,"2020","115"
"32741","VELO VERONESE",429,1498,42,1969,"2020","090"
"32742","VENARIA REALE",55,17,210,282,"2020","292"
"32743","VENASCA",35,0,0,35,"2020","237"
"32744","VENAUS",30,21,9,60,"2020","291"
"32745","VENEGONO INFERIORE",0,81,0,81,"2020","136"
"32746","VENEGONO SUPERIORE",11,0,0,11,"2020","137"
"32747","VENEZIA",1647,175,0,1822,"2020","042"
"32748","VENIANO",63,64,0,127,"2020","238"
"32749","VENTASSO",85,329,0,414,"2020",NA
"32750","VERANO BRIANZA",3,0,0,3,"2020",NA
"32751","VERBANIA",59,0,3,62,"2020","072"
"32752","VERCANA",7,9,0,16,"2020","239"
"32753","VERCEIA",11,0,5,16,"2020","075"
"32754","VERCELLI",96,217,0,313,"2020","158"
"32755","VERDELLINO",0,76,0,76,"2020","232"
"32756","VERDELLO",254,46,0,300,"2020","233"
"32757","VERDERIO",7,0,44,51,"2020",NA
"32758","VERDUNO",97,0,0,97,"2020","238"
"32759","VERGATO",63,0,0,63,"2020","059"
"32760","VERGHERETO",690,0,0,690,"2020","050"
"32761","VERGIATE",20,0,0,20,"2020","138"
"32762","VERMEZZO CON ZELO",13,622,0,635,"2020",NA
"32763","VERNANTE",179,41,0,220,"2020","239"
"32764","VERNASCA",55,48,0,103,"2020","044"
"32765","VERNATE",7,84,0,91,"2020","236"
"32766","VEROLANUOVA",1099,1960,89,3148,"2020","195"
"32767","VEROLAVECCHIA",9,3175,515,3699,"2020","196"
"32768","VEROLENGO",453,139,0,592,"2020","293"
"32769","VERONA",3835,838,0,4673,"2020","091"
"32770","VERONELLA",5217,278,0,5495,"2020","092"
"32771","VERRETTO",6,0,0,6,"2020","174"
"32772","VERRONE",38,0,0,38,"2020","076"
"32773","VERRUA SAVOIA",574,0,0,574,"2020","294"
"32774","VERTEMATE CON MINOPRIO",3,0,0,3,"2020","242"
"32775","VERTOVA",14,37,0,51,"2020","234"
"32776","VERUCCHIO",198,0,0,198,"2020","020"
"32777","VERVIO",38,46,0,84,"2020","076"
"32778","VERZUOLO",3,0,0,3,"2020","240"
"32779","VESCOVANA",5,0,0,5,"2020","097"
"32780","VESCOVATO",110,1269,0,1379,"2020","113"
"32781","VESIME",539,0,0,539,"2020","113"
"32782","VESPOLATE",38,104,0,142,"2020","158"
"32783","VESTENANOVA",593,217,0,810,"2020","093"
"32784","VESTIGNE'",5,98,0,103,"2020","295"
"32785","VESTONE",6,0,0,6,"2020","197"
"32786","VETTO",9,403,0,412,"2020","042"
"32787","VEZZA D'ALBA",2,0,0,2,"2020","241"
"32788","VEZZA D'OGLIO",1,161,44,206,"2020","198"
"32789","VEZZANO SUL CROSTOLO",8,151,0,159,"2020","043"
"32790","VIADANA",277,1289,7,1573,"2020","066"
"32791","VIADANICA",10,25,0,35,"2020","235"
"32792","VIALE",298,0,0,298,"2020","114"
"32793","VIALFRE'",17,0,0,17,"2020","296"
"32794","VIANO",2,799,0,801,"2020","044"
"32795","VIARIGI",19,0,0,19,"2020","115"
"32796","VICENZA",129,845,0,974,"2020","116"
"32797","VICOFORTE",454,0,0,454,"2020","242"
"32798","VIDIGULFO",2,330,0,332,"2020","176"
"32799","VIDOR",3,358,9,370,"2020","090"
"32800","VIDRACCO",4,0,0,4,"2020","298"
"32801","VIGANO SAN MARTINO",5,0,0,5,"2020","236"
"32802","VIGASIO",701,525,0,1226,"2020","094"
"32803","VIGEVANO",46,51,11,108,"2020","177"
"32804","VIGGIU'",20,0,0,20,"2020","139"
"32805","VIGHIZZOLO D'ESTE",93,18,0,111,"2020","098"
"32806","VIGLIANO BIELLESE",4,0,0,4,"2020","077"
"32807","VIGLIANO D'ASTI",54,0,0,54,"2020","116"
"32808","VIGNALE MONFERRATO",235,0,0,235,"2020","179"
"32809","VIGNATE",0,258,67,325,"2020","237"
"32810","VIGNOLA",1,97,0,98,"2020","046"
"32811","VIGNOLE BORBERA",15,0,0,15,"2020","180"
"32812","VIGNOLO",1436,0,0,1436,"2020","243"
"32813","VIGNONE",2,0,0,2,"2020","074"
"32814","VIGO DI CADORE",2,11,0,13,"2020","065"
"32815","VIGODARZERE",291,68,0,359,"2020","099"
"32816","VIGOLO",3,185,0,188,"2020","237"
"32817","VIGOLZONE",60,435,0,495,"2020","045"
"32818","VIGONE",2956,1225,195,4376,"2020","299"
"32819","VIGONOVO",3,0,0,3,"2020","043"
"32820","VIGONZA",853,169,0,1022,"2020","100"
"32821","VILLA BARTOLOMEA",169,0,0,169,"2020","095"
"32822","VILLA CARCINA",1,0,0,1,"2020","199"
"32823","VILLA CORTESE",51,0,0,51,"2020","248"
"32824","VILLA D'ADDA",10,0,0,10,"2020","238"
"32825","VILLA D'ALME'",117,7,0,124,"2020","239"
"32826","VILLA D'OGNA",2,48,0,50,"2020","241"
"32827","VILLA DEL BOSCO",1,0,0,1,"2020","078"
"32828","VILLA DEL CONTE",629,594,0,1223,"2020","101"
"32829","VILLA DI CHIAVENNA",1,13,5,19,"2020","077"
"32830","VILLA DI SERIO",28,0,0,28,"2020","240"
"32831","VILLA DI TIRANO",10,138,70,218,"2020","078"
"32832","VILLA ESTENSE",284,0,0,284,"2020","102"
"32833","VILLA GUARDIA",113,0,53,166,"2020","245"
"32834","VILLA MINOZZO",39,799,0,838,"2020","045"
"32835","VILLA SAN SECONDO",6,0,0,6,"2020","119"
"32836","VILLACHIARA",584,1977,1026,3587,"2020","200"
"32837","VILLADEATI",10,0,0,10,"2020","182"
"32838","VILLADOSE",219,5,80,304,"2020","048"
"32839","VILLADOSSOLA",11,0,0,11,"2020","075"
"32840","VILLAFALLETTO",2452,783,247,3482,"2020","244"
"32841","VILLAFRANCA D'ASTI",236,0,0,236,"2020","117"
"32842","VILLAFRANCA DI VERONA",8499,3336,124,11959,"2020","096"
"32843","VILLAFRANCA PADOVANA",695,2019,85,2799,"2020","103"
"32844","VILLAFRANCA PIEMONTE",2199,1955,389,4543,"2020","300"
"32845","VILLAGA",200,205,0,405,"2020","117"
"32846","VILLALVERNIA",4,0,0,4,"2020",NA
"32847","VILLAMARZANA",827,84,0,911,"2020","049"
"32848","VILLAMIROGLIO",2,0,0,2,"2020","184"
"32849","VILLANOVA BIELLESE",470,0,0,470,"2020","079"
"32850","VILLANOVA CANAVESE",38,11,11,60,"2020","301"
"32851","VILLANOVA D'ASTI",3929,90,0,4019,"2020","118"
"32852","VILLANOVA DEL GHEBBO",42,0,0,42,"2020","050"
"32853","VILLANOVA DEL SILLARO",0,906,8,914,"2020","060"
"32854","VILLANOVA DI CAMPOSAMPIERO",31,12,1,44,"2020","104"
"32855","VILLANOVA MARCHESANA",0,51,0,51,"2020","051"
"32856","VILLANOVA MONDOVI'",2499,432,145,3076,"2020","245"
"32857","VILLANOVA MONFERRATO",0,77,0,77,"2020","185"
"32858","VILLANOVA SOLARO",282,616,4,902,"2020","246"
"32859","VILLANOVA SULL'ARDA",1,1554,0,1555,"2020","046"
"32860","VILLANTERIO",3,0,184,187,"2020","180"
"32861","VILLANUOVA SUL CLISI",4,0,0,4,"2020","201"
"32862","VILLAR DORA",71,0,17,88,"2020","303"
"32863","VILLAR FOCCHIARDO",9,28,77,114,"2020","305"
"32864","VILLAR PELLICE",252,28,19,299,"2020","306"
"32865","VILLAR PEROSA",8,0,4,12,"2020","307"
"32866","VILLAR SAN COSTANZO",413,237,6,656,"2020","247"
"32867","VILLARBASSE",248,15,1,264,"2020","302"
"32868","VILLARBOIT",2,0,0,2,"2020","163"
"32869","VILLAREGGIA",57,0,0,57,"2020","304"
"32870","VILLASTELLONE",774,493,98,1365,"2020","308"
"32871","VILLATA",10,43,0,53,"2020","164"
"32872","VILLAVERLA",100,1380,0,1480,"2020","118"
"32873","VILLETTE",23,0,41,64,"2020","076"
"32874","VILLIMPENTA",404,20,23,447,"2020","068"
"32875","VILLONGO",8,0,0,8,"2020","242"
"32876","VILLORBA",135,0,0,135,"2020","091"
"32877","VILMINORE DI SCALVE",16,158,0,174,"2020","243"
"32878","VIMERCATE",2,51,0,53,"2020",NA
"32879","VINADIO",236,0,0,236,"2020","248"
"32880","VINCHIO",3,0,0,3,"2020","120"
"32881","VINOVO",406,183,25,614,"2020","309"
"32882","VINZAGLIO",11,42,0,53,"2020","164"
"32883","VIOLA",59,0,0,59,"2020","249"
"32884","VIONE",11,15,1,27,"2020","202"
"32885","VIRLE PIEMONTE",295,231,154,680,"2020","310"
"32886","VISANO",1585,450,23,2058,"2020","203"
"32887","VISCHE",25,0,0,25,"2020","311"
"32888","VISONE",42,0,0,42,"2020","187"
"32889","VISTARINO",37,0,0,37,"2020","181"
"32890","VISTRORIO",10,0,13,23,"2020","312"
"32891","VITTORIO VENETO",187,101,3,291,"2020","092"
"32892","VITTUONE",1,223,0,224,"2020","243"
"32893","VIU'",40,0,5,45,"2020","313"
"32894","VIVERONE",42,0,0,42,"2020","080"
"32895","VIZZOLO PREDABISSI",16,0,76,92,"2020","244"
"32896","VO'",49,63,0,112,"2020","105"
"32897","VOBARNO",37,70,8,115,"2020","204"
"32898","VOCCA",0,29,0,29,"2020","166"
"32899","VODO CADORE",0,0,25,25,"2020","066"
"32900","VOGHERA",44,0,0,44,"2020","182"
"32901","VOGHIERA",1,0,0,1,"2020","023"
"32902","VOGOGNA",9,4,0,13,"2020","077"
"32903","VOLONGO",28,0,0,28,"2020","114"
"32904","VOLPAGO DEL MONTELLO",1002,575,18,1595,"2020","093"
"32905","VOLPEDO",1,0,0,1,"2020","188"
"32906","VOLPIANO",298,158,21,477,"2020","314"
"32907","VOLTA MANTOVANA",3412,1316,1022,5750,"2020","070"
"32908","VOLTAGGIO",25,0,60,85,"2020","190"
"32909","VOLTAGO AGORDINO",1,0,0,1,"2020",NA
"32910","VOLTIDO",0,333,0,333,"2020","115"
"32911","VOLVERA",1163,353,0,1516,"2020","315"
"32912","VOTTIGNASCO",1843,100,100,2043,"2020","250"
"32913","ZANDOBBIO",7,0,0,7,"2020","244"
"32914","ZANE'",285,148,0,433,"2020","119"
"32915","ZANICA",262,1089,158,1509,"2020","245"
"32916","ZAVATTARELLO",80,0,0,80,"2020","184"
"32917","ZECCONE",7,271,0,278,"2020","185"
"32918","ZELBIO",0,0,8,8,"2020","246"
"32919","ZELO BUON PERSICO",4,1251,0,1255,"2020","061"
"32920","ZEME",69,30,0,99,"2020","186"
"32921","ZENEVREDO",4,0,0,4,"2020","187"
"32922","ZENSON DI PIAVE",10,0,0,10,"2020","094"
"32923","ZERBOLO'",0,141,0,141,"2020","189"
"32924","ZERMEGHEDO",0,54,0,54,"2020","120"
"32925","ZERO BRANCO",327,118,8,453,"2020","095"
"32926","ZEVIO",3883,653,105,4641,"2020","097"
"32927","ZIANO PIACENTINO",81,0,0,81,"2020","048"
"32928","ZIBIDO SAN GIACOMO",37,392,49,478,"2020","247"
"32929","ZIMELLA",8683,507,0,9190,"2020","098"
"32930","ZIMONE",12,0,0,12,"2020",NA
"32931","ZINASCO",27,0,0,27,"2020","190"
"32932","ZOCCA",40,791,0,831,"2020","047"
"32933","ZOGNO",98,64,0,162,"2020","246"
"32934","ZOLA PREDOSA",16,106,0,122,"2020","060"
"32935","ZONE",4,27,0,31,"2020","205"
"32936","ZOPPE' DI CADORE",0,4,0,4,"2020",NA
"32937","ZOVENCEDO",6,0,0,6,"2020","121"
"32938","ZUBIENA",49,0,24,73,"2020","082"
"32939","ZUGLIANO",555,131,12,698,"2020","122"
"32940","ZUMAGLIA",22,0,0,22,"2020","083"
"32941","ABANO TERME",50,175,0,225,"2021","001"
"32942","ABBADIA CERRETO",0,1325,0,1325,"2021","001"
"32943","ABBADIA LARIANA",4,23,5,32,"2021","001"
"32944","ABBIATEGRASSO",58,1531,3,1592,"2021","002"
"32945","ACCEGLIO",114,0,0,114,"2021","001"
"32946","ACQUAFREDDA",985,85,0,1070,"2021","001"
"32947","ACQUANEGRA CREMONESE",0,992,0,992,"2021","001"
"32948","ACQUANEGRA SUL CHIESE",1585,381,440,2406,"2021","001"
"32949","ACQUI TERME",253,0,0,253,"2021","001"
"32950","ADRARA SAN MARTINO",38,16,3,57,"2021","001"
"32951","ADRARA SAN ROCCO",13,0,0,13,"2021","002"
"32952","ADRIA",2506,166,0,2672,"2021","001"
"32953","ADRO",492,19,0,511,"2021","002"
"32954","AGAZZANO",87,351,0,438,"2021","001"
"32955","AGLIANO TERME",49,0,0,49,"2021","001"
"32956","AGLIE'",412,34,31,477,"2021","001"
"32957","AGNA",223,0,0,223,"2021","002"
"32958","AGNADELLO",0,1764,51,1815,"2021","002"
"32959","AGNOSINE",6,47,3,56,"2021","003"
"32960","AGORDO",5,5,0,10,"2021","001"
"32961","AGRATE CONTURBIA",18,0,0,18,"2021","001"
"32962","AGUGLIARO",328,2,0,330,"2021","001"
"32963","AICURZIO",7,0,30,37,"2021",NA
"32964","AILOCHE",0,3,0,3,"2021","001"
"32965","AIRASCA",814,684,0,1498,"2021","002"
"32966","AIRUNO",2,0,0,2,"2021","002"
"32967","AISONE",20,0,0,20,"2021","002"
"32968","ALA DI STURA",30,0,0,30,"2021","003"
"32969","ALAGNA",1,0,0,1,"2021",NA
"32970","ALAGNA VALSESIA",44,21,0,65,"2021","002"
"32971","ALANO DI PIAVE",391,53,2,446,"2021","002"
"32972","ALBA",689,0,0,689,"2021","003"
"32973","ALBAIRATE",31,564,9,604,"2021","005"
"32974","ALBANO SANT'ALESSANDRO",1,0,0,1,"2021","003"
"32975","ALBAREDO D'ADIGE",11750,202,0,11952,"2021","002"
"32976","ALBAREDO PER SAN MARCO",6,17,0,23,"2021","001"
"32977","ALBARETO",106,53,0,159,"2021","001"
"32978","ALBARETTO DELLA TORRE",29,0,0,29,"2021","004"
"32979","ALBERA LIGURE",40,0,0,40,"2021","002"
"32980","ALBESE CON CASSANO",0,0,2,2,"2021","004"
"32981","ALBETTONE",2291,678,30,2999,"2021","002"
"32982","ALBIANO D'IVREA",138,43,0,181,"2021","004"
"32983","ALBIATE",228,0,0,228,"2021",NA
"32984","ALBIGNASEGO",117,208,1,326,"2021","003"
"32985","ALBINEA",24,1070,0,1094,"2021","001"
"32986","ALBINO",76,57,0,133,"2021","004"
"32987","ALBIOLO",2,12,0,14,"2021","005"
"32988","ALBIZZATE",5,0,0,5,"2021","002"
"32989","ALBOSAGGIA",48,53,51,152,"2021","002"
"32990","ALBUGNANO",55,0,0,55,"2021","002"
"32991","ALBUZZANO",32,0,0,32,"2021","004"
"32992","ALESSANDRIA",9589,2251,93,11933,"2021","003"
"32993","ALFIANELLO",0,620,7,627,"2021","004"
"32994","ALFIANO NATTA",31,0,0,31,"2021","004"
"32995","ALFONSINE",50,0,0,50,"2021","001"
"32996","ALGUA",7,3,0,10,"2021","248"
"32997","ALICE BEL COLLE",1,0,0,1,"2021","005"
"32998","ALICE CASTELLO",855,31,0,886,"2021","004"
"32999","ALLEGHE",4,0,0,4,"2021","003"
"33000","ALLUVIONI PIOVERA",250,111,0,361,"2021",NA
"33001","ALME'",2,0,0,2,"2021","005"
"33002","ALMENNO SAN BARTOLOMEO",34,0,0,34,"2021","006"
"33003","ALMENNO SAN SALVATORE",3,0,0,3,"2021","007"
"33004","ALMESE",62,30,0,92,"2021","006"
"33005","ALONTE",718,11,0,729,"2021","003"
"33006","ALPAGO",25,199,2,226,"2021",NA
"33007","ALPIGNANO",297,97,19,413,"2021","008"
"33008","ALSENO",12,966,0,978,"2021","002"
"33009","ALSERIO",6,0,0,6,"2021","006"
"33010","ALTA VAL TIDONE",534,209,0,743,"2021",NA
"33011","ALTA VALLE INTELVI",51,43,0,94,"2021",NA
"33012","ALTAVILLA MONFERRATO",85,0,0,85,"2021","007"
"33013","ALTAVILLA VICENTINA",123,0,0,123,"2021","004"
"33014","ALTISSIMO",27,41,0,68,"2021","005"
"33015","ALTIVOLE",11973,43,1,12017,"2021","001"
"33016","ALTO RENO TERME",59,0,0,59,"2021",NA
"33017","ALTO SERMENZA",2,23,0,25,"2021",NA
"33018","ALZANO LOMBARDO",16,39,0,55,"2021","008"
"33019","ALZANO SCRIVIA",1,0,0,1,"2021","008"
"33020","ALZATE BRIANZA",5,162,0,167,"2021","007"
"33021","AMBIVERE",1,0,0,1,"2021","009"
"33022","AMENO",34,6,13,53,"2021","002"
"33023","ANDALO VALTELLINO",21,0,0,21,"2021",NA
"33024","ANDEZENO",389,0,0,389,"2021","009"
"33025","ANDORNO MICCA",16,0,52,68,"2021","002"
"33026","ANDRATE",45,0,0,45,"2021","010"
"33027","ANFO",0,18,0,18,"2021","005"
"33028","ANGERA",66,136,18,220,"2021","003"
"33029","ANGOLO TERME",2,47,3,52,"2021","006"
"33030","ANGROGNA",117,0,30,147,"2021","011"
"33031","ANGUILLARA VENETA",15,0,0,15,"2021","004"
"33032","ANNICCO",6,883,252,1141,"2021","003"
"33033","ANNONE DI BRIANZA",31,4,0,35,"2021","003"
"33034","ANNONE VENETO",29,0,2,31,"2021","001"
"33035","ANTEGNATE",770,1708,0,2478,"2021","010"
"33036","ANTIGNANO",46,0,0,46,"2021","003"
"33037","ANTRONA SCHIERANCO",5,0,0,5,"2021","001"
"33038","ANZANO DEL PARCO",1,84,39,124,"2021","009"
"33039","ANZOLA D'OSSOLA",0,207,0,207,"2021","002"
"33040","ANZOLA DELL'EMILIA",23,577,0,600,"2021","001"
"33041","APPIANO GENTILE",61,259,30,350,"2021","010"
"33042","APRICA",0,1,0,1,"2021","004"
"33043","ARAMENGO",225,0,0,225,"2021","004"
"33044","ARCADE",946,57,0,1003,"2021","002"
"33045","ARCENE",3,452,0,455,"2021","011"
"33046","ARCISATE",98,882,0,980,"2021","004"
"33047","ARCOLE",1289,89,0,1378,"2021","004"
"33048","ARCONATE",48,97,0,145,"2021","007"
"33049","ARCORE",45,0,5,50,"2021",NA
"33050","ARCUGNANO",90,2,0,92,"2021","006"
"33051","ARDENNO",29,41,23,93,"2021","005"
"33052","ARDESIO",110,76,0,186,"2021","012"
"33053","ARENA PO",44,512,40,596,"2021","005"
"33054","ARESE",0,116,0,116,"2021","009"
"33055","ARGEGNO",1,0,0,1,"2021","011"
"33056","ARGELATO",65,80,0,145,"2021","002"
"33057","ARGENTA",1438,5,0,1443,"2021","001"
"33058","ARGUELLO",78,0,0,78,"2021","007"
"33059","ARIANO NEL POLESINE",795,149,0,944,"2021","002"
"33060","ARIGNANO",542,0,0,542,"2021","012"
"33061","ARLUNO",47,305,0,352,"2021","010"
"33062","ARMENO",83,93,0,176,"2021","006"
"33063","AROLA",2,0,6,8,"2021","004"
"33064","ARONA",1,0,0,1,"2021","008"
"33065","AROSIO",2,0,0,2,"2021","012"
"33066","ARQUA' PETRARCA",141,0,0,141,"2021","005"
"33067","ARQUA' POLESINE",864,0,0,864,"2021","003"
"33068","ARQUATA SCRIVIA",2,0,0,2,"2021","009"
"33069","ARRE",6,9,0,15,"2021","006"
"33070","ARSAGO SEPRIO",7,0,0,7,"2021","005"
"33071","ARSIE'",7,401,0,408,"2021","004"
"33072","ARSIERO",5,27,4,36,"2021","007"
"33073","ARTOGNE",4,346,55,405,"2021","007"
"33074","ARZAGO D'ADDA",431,1085,0,1516,"2021","013"
"33075","ARZERGRANDE",294,135,0,429,"2021","007"
"33076","ARZIGNANO",114,300,1,415,"2021","008"
"33077","ASIAGO",40,1258,43,1341,"2021","009"
"33078","ASIGLIANO VENETO",181,0,0,181,"2021","010"
"33079","ASIGLIANO VERCELLESE",8,0,0,8,"2021","007"
"33080","ASOLA",9733,1902,1167,12802,"2021","002"
"33081","ASOLO",9495,581,57,10133,"2021","003"
"33082","ASSAGO",2,0,0,2,"2021","011"
"33083","ASSO",5,0,16,21,"2021","013"
"33084","ASTI",2484,0,0,2484,"2021","005"
"33085","AURANO",27,0,0,27,"2021","005"
"33086","AURONZO DI CADORE",18,13,0,31,"2021","005"
"33087","AVIATICO",0,16,0,16,"2021","015"
"33088","AVIGLIANA",148,49,11,208,"2021","013"
"33089","AVOLASCA",241,0,0,241,"2021","010"
"33090","AZEGLIO",90,7,57,154,"2021","014"
"33091","AZZANELLO",1,238,0,239,"2021","004"
"33092","AZZANO D'ASTI",1,0,0,1,"2021",NA
"33093","AZZANO MELLA",71,988,0,1059,"2021","008"
"33094","AZZANO SAN PAOLO",28,151,0,179,"2021","016"
"33095","AZZATE",12,0,10,22,"2021","006"
"33096","AZZIO",3,133,0,136,"2021","007"
"33097","AZZONE",0,1,0,1,"2021","017"
"33098","BACENO",8,26,0,34,"2021","006"
"33099","BADIA CALAVENA",1158,264,0,1422,"2021","005"
"33100","BADIA PAVESE",195,0,0,195,"2021","006"
"33101","BADIA POLESINE",187,0,0,187,"2021","004"
"33102","BAGNACAVALLO",27,0,0,27,"2021","002"
"33103","BAGNARA DI ROMAGNA",2,0,0,2,"2021","003"
"33104","BAGNARIA",49,0,0,49,"2021","007"
"33105","BAGNASCO",144,0,0,144,"2021","008"
"33106","BAGNATICA",2,104,0,106,"2021","018"
"33107","BAGNO DI ROMAGNA",811,20,0,831,"2021","001"
"33108","BAGNOLI DI SOPRA",922,7,0,929,"2021","008"
"33109","BAGNOLO CREMASCO",3,1969,0,1972,"2021","005"
"33110","BAGNOLO IN PIANO",1,546,0,547,"2021","002"
"33111","BAGNOLO MELLA",369,3198,298,3865,"2021","009"
"33112","BAGNOLO PIEMONTE",881,0,133,1014,"2021","009"
"33113","BAGNOLO SAN VITO",201,2701,913,3815,"2021","003"
"33114","BAGOLINO",6,289,2,297,"2021","010"
"33115","BAIRO",85,90,5,180,"2021","015"
"33116","BAISO",6,886,0,892,"2021","003"
"33117","BALANGERO",187,2,107,296,"2021","016"
"33118","BALDICHIERI D'ASTI",28,0,0,28,"2021","007"
"33119","BALDISSERO CANAVESE",0,67,0,67,"2021","017"
"33120","BALDISSERO D'ALBA",481,0,0,481,"2021","010"
"33121","BALDISSERO TORINESE",181,0,0,181,"2021","018"
"33122","BALLABIO",17,65,11,93,"2021","004"
"33123","BALME",9,0,0,9,"2021","019"
"33124","BALOCCO",97,0,39,136,"2021","009"
"33125","BANCHETTE",4,0,3,7,"2021","020"
"33126","BANNIO ANZINO",93,0,1,94,"2021","007"
"33127","BAONE",7,0,0,7,"2021","009"
"33128","BARBANIA",35,128,100,263,"2021","021"
"33129","BARBARANO MOSSANO",681,344,0,1025,"2021",NA
"33130","BARBARESCO",19,0,0,19,"2021","011"
"33131","BARBARIGA",1085,1436,53,2574,"2021","011"
"33132","BARBATA",0,871,0,871,"2021","019"
"33133","BARBIANELLO",120,5,0,125,"2021","008"
"33134","BARBONA",291,4,0,295,"2021","010"
"33135","BARDELLO",19,0,0,19,"2021","009"
"33136","BARDI",66,598,0,664,"2021","002"
"33137","BARDOLINO",28,106,0,134,"2021","006"
"33138","BARDONECCHIA",20,0,0,20,"2021","022"
"33139","BAREGGIO",7,149,0,156,"2021","012"
"33140","BARENGO",0,152,0,152,"2021","012"
"33141","BARGE",5287,1578,624,7489,"2021","012"
"33142","BARGHE",6,14,0,20,"2021","012"
"33143","BARIANO",56,361,0,417,"2021","020"
"33144","BARLASSINA",3,0,0,3,"2021",NA
"33145","BARNI",4,4,1,9,"2021","015"
"33146","BAROLO",34,0,0,34,"2021","013"
"33147","BARONE CANAVESE",106,63,0,169,"2021","023"
"33148","BARZAGO",169,0,0,169,"2021","005"
"33149","BARZANO'",2,0,9,11,"2021","006"
"33150","BARZIO",17,46,44,107,"2021","007"
"33151","BASALUZZO",214,0,0,214,"2021","012"
"33152","BASCAPE'",25,910,0,935,"2021","009"
"33153","BASIGLIO",0,89,0,89,"2021","015"
"33154","BASSANO BRESCIANO",1,127,0,128,"2021","013"
"33155","BASSANO DEL GRAPPA",158,218,10,386,"2021","012"
"33156","BASSIGNANA",1,0,0,1,"2021","013"
"33157","BASTIA MONDOVI'",837,0,0,837,"2021","014"
"33158","BASTIDA PANCARANA",3,0,0,3,"2021","011"
"33159","BASTIGLIA",128,0,0,128,"2021","001"
"33160","BATTAGLIA TERME",6,0,0,6,"2021","011"
"33161","BEDERO VALCUVIA",17,0,0,17,"2021","010"
"33162","BEDIZZOLE",4576,1284,148,6008,"2021","014"
"33163","BEDONIA",198,92,0,290,"2021","003"
"33164","BEDULITA",3,0,0,3,"2021","022"
"33165","BEE",5,0,0,5,"2021","009"
"33166","BEINASCO",11,0,0,11,"2021","024"
"33167","BEINETTE",844,337,0,1181,"2021","016"
"33168","BELFIORE",2891,0,0,2891,"2021","007"
"33169","BELGIOIOSO",0,131,0,131,"2021","013"
"33170","BELLAGIO",3,65,37,105,"2021","019"
"33171","BELLANO",11,2,9,22,"2021","008"
"33172","BELLARIA-IGEA MARINA",7,0,0,7,"2021","001"
"33173","BELLINO",130,0,0,130,"2021","017"
"33174","BELLINZAGO LOMBARDO",639,1384,12,2035,"2021","016"
"33175","BELLINZAGO NOVARESE",475,711,0,1186,"2021","016"
"33176","BELLUNO",707,254,169,1130,"2021","006"
"33177","BELVEDERE LANGHE",91,0,86,177,"2021","018"
"33178","BEMA",8,3,0,11,"2021","006"
"33179","BENE LARIO",0,0,64,64,"2021","021"
"33180","BENE VAGIENNA",1737,505,0,2242,"2021","019"
"33181","BENEVELLO",120,0,0,120,"2021","020"
"33182","BENNA",4,40,34,78,"2021","003"
"33183","BENTIVOGLIO",9,110,0,119,"2021","005"
"33184","BERBENNO",10,45,0,55,"2021","023"
"33185","BERBENNO DI VALTELLINA",22,175,0,197,"2021","007"
"33186","BERCETO",30,384,0,414,"2021","004"
"33187","BEREGAZZO CON FIGLIARO",7,0,0,7,"2021","022"
"33188","BEREGUARDO",10,525,108,643,"2021","014"
"33189","BERGAMASCO",50,0,0,50,"2021","015"
"33190","BERGAMO",108,100,0,208,"2021","024"
"33191","BERLINGO",3086,281,27,3394,"2021","015"
"33192","BERNAREGGIO",1,17,0,18,"2021",NA
"33193","BERNATE TICINO",5,119,20,144,"2021","019"
"33194","BERNEZZO",292,32,21,345,"2021","022"
"33195","BERTINORO",152,9,0,161,"2021","003"
"33196","BERTONICO",0,2612,0,2612,"2021","002"
"33197","BERZANO DI SAN PIETRO",11,0,0,11,"2021","009"
"33198","BERZO DEMO",4,44,4,52,"2021","016"
"33199","BERZO INFERIORE",5,133,3,141,"2021","017"
"33200","BERZO SAN FERMO",850,90,0,940,"2021","025"
"33201","BESANA IN BRIANZA",793,48,19,860,"2021",NA
"33202","BESANO",19,0,10,29,"2021","011"
"33203","BESATE",144,0,1,145,"2021","022"
"33204","BESENZONE",102,1844,0,1946,"2021","003"
"33205","BESNATE",1,225,0,226,"2021","012"
"33206","BESOZZO",16,60,0,76,"2021","013"
"33207","BETTOLA",364,68,0,432,"2021","004"
"33208","BEURA-CARDEZZA",34,0,5,39,"2021","011"
"33209","BEVILACQUA",72,35,0,107,"2021","008"
"33210","BIANDRONNO",15,0,0,15,"2021","014"
"33211","BIANZANO",5,9,0,14,"2021","026"
"33212","BIANZE'",77,510,0,587,"2021","011"
"33213","BIANZONE",3,5,0,8,"2021","008"
"33214","BIASSONO",9,0,0,9,"2021",NA
"33215","BIBBIANO",52,2703,0,2755,"2021","004"
"33216","BIBIANA",466,0,0,466,"2021","025"
"33217","BIELLA",127,45,124,296,"2021","004"
"33218","BIENNO",0,154,4,158,"2021","018"
"33219","BINAGO",37,186,1,224,"2021","023"
"33220","BIOGLIO",10,0,1,11,"2021","005"
"33221","BIONE",7,5,2,14,"2021","019"
"33222","BISTAGNO",2,0,0,2,"2021","017"
"33223","BISUSCHIO",3,0,0,3,"2021","015"
"33224","BIZZARONE",0,13,5,18,"2021","024"
"33225","BLELLO",0,73,0,73,"2021","027"
"33226","BLESSAGNO",1,0,4,5,"2021","025"
"33227","BOARA PISANI",1,0,0,1,"2021","012"
"33228","BOBBIO",154,90,0,244,"2021","005"
"33229","BOBBIO PELLICE",36,14,132,182,"2021","026"
"33230","BOCCIOLETO",8,0,0,8,"2021","014"
"33231","BOFFALORA D'ADDA",0,202,0,202,"2021","003"
"33232","BOFFALORA SOPRA TICINO",64,85,47,196,"2021","026"
"33233","BOGOGNO",2,0,0,2,"2021",NA
"33234","BOLGARE",86,214,2,302,"2021","028"
"33235","BOLLATE",1,254,0,255,"2021","027"
"33236","BOLLENGO",74,42,0,116,"2021","027"
"33237","BOLOGNA",6,0,56,62,"2021","006"
"33238","BOLTIERE",18,35,0,53,"2021","029"
"33239","BOLZANO NOVARESE",0,6,0,6,"2021","022"
"33240","BOLZANO VICENTINO",141,1226,0,1367,"2021","013"
"33241","BOMPORTO",16,155,0,171,"2021","002"
"33242","BONATE SOPRA",298,0,0,298,"2021","030"
"33243","BONATE SOTTO",41,0,0,41,"2021","031"
"33244","BONAVIGO",3576,35,34,3645,"2021","009"
"33245","BONDENO",628,431,0,1059,"2021","003"
"33246","BONEMERSE",27,166,0,193,"2021","006"
"33247","BORCA DI CADORE",1,0,0,1,"2021",NA
"33248","BORDOLANO",25,503,0,528,"2021","007"
"33249","BORE",78,0,0,78,"2021","005"
"33250","BORETTO",0,244,0,244,"2021","005"
"33251","BORGARO TORINESE",92,58,0,150,"2021","028"
"33252","BORGHETTO DI BORBERA",186,0,15,201,"2021","018"
"33253","BORGHETTO LODIGIANO",11,1689,86,1786,"2021","004"
"33254","BORGHI",1127,0,0,1127,"2021","004"
"33255","BORGIALLO",6,36,0,42,"2021","029"
"33256","BORGO D'ALE",315,0,0,315,"2021","015"
"33257","BORGO DI TERZO",3,0,0,3,"2021","032"
"33258","BORGO MANTOVANO",20,989,94,1103,"2021",NA
"33259","BORGO PRIOLO",8,0,0,8,"2021","016"
"33260","BORGO SAN DALMAZZO",513,0,89,602,"2021","025"
"33261","BORGO SAN GIACOMO",1316,3702,155,5173,"2021","020"
"33262","BORGO SAN GIOVANNI",7,968,0,975,"2021","005"
"33263","BORGO SAN SIRO",0,873,0,873,"2021","018"
"33264","BORGO TICINO",30,0,0,30,"2021","025"
"33265","BORGO TOSSIGNANO",6,0,0,6,"2021","007"
"33266","BORGO VAL DI TARO",112,225,0,337,"2021","006"
"33267","BORGO VALBELLUNA",157,758,9,924,"2021",NA
"33268","BORGO VENETO",2087,38,0,2125,"2021",NA
"33269","BORGO VERCELLI",4,0,0,4,"2021","017"
"33270","BORGO VIRGILIO",164,4317,2436,6917,"2021",NA
"33271","BORGOCARBONARA",0,482,271,753,"2021",NA
"33272","BORGOFRANCO D'IVREA",204,2,8,214,"2021","030"
"33273","BORGOLAVEZZARO",3,0,0,3,"2021","023"
"33274","BORGOMALE",22,0,0,22,"2021","024"
"33275","BORGOMANERO",111,13,6,130,"2021","024"
"33276","BORGOMASINO",62,0,60,122,"2021","031"
"33277","BORGOMEZZAVALLE",5,0,0,5,"2021",NA
"33278","BORGONE SUSA",30,35,0,65,"2021","032"
"33279","BORGONOVO VAL TIDONE",799,2447,0,3246,"2021","006"
"33280","BORGORATTO ALESSANDRINO",32,0,0,32,"2021","019"
"33281","BORGORATTO MORMOROLO",5,0,0,5,"2021","017"
"33282","BORGORICCO",55,7,4,66,"2021","013"
"33283","BORGOSATOLLO",47,553,73,673,"2021","021"
"33284","BORGOSESIA",29,71,0,100,"2021","016"
"33285","BORMIO",14,348,4,366,"2021","009"
"33286","BORNASCO",151,551,2,704,"2021","019"
"33287","BORNO",1,137,51,189,"2021","022"
"33288","BORRIANA",102,28,1,131,"2021","006"
"33289","BORSO DEL GRAPPA",108,265,27,400,"2021","004"
"33290","BOSCHI SANT'ANNA",79,0,0,79,"2021","010"
"33291","BOSCO CHIESANUOVA",48,1434,12,1494,"2021","011"
"33292","BOSCO MARENGO",65,25,0,90,"2021","021"
"33293","BOSCONERO",93,38,0,131,"2021","033"
"33294","BOSIA",371,0,0,371,"2021","026"
"33295","BOSIO",9,0,2,11,"2021","022"
"33296","BOSISIO PARINI",0,139,1,140,"2021","009"
"33297","BOSSICO",37,54,1,92,"2021","033"
"33298","BOSSOLASCO",43,54,0,97,"2021","027"
"33299","BOTTANUCO",217,809,0,1026,"2021","034"
"33300","BOTTICINO",21,0,0,21,"2021","023"
"33301","BOVEGNO",32,113,10,155,"2021","024"
"33302","BOVES",611,844,146,1601,"2021","028"
"33303","BOVEZZO",1,0,0,1,"2021","025"
"33304","BOVOLENTA",4828,231,0,5059,"2021","014"
"33305","BOVOLONE",3947,352,0,4299,"2021","012"
"33306","BOZZOLO",32,1530,17,1579,"2021","007"
"33307","BRA",3493,1758,156,5407,"2021","029"
"33308","BRACCA",5,0,0,5,"2021","035"
"33309","BRALLO DI PREGOLA",15,0,0,15,"2021","021"
"33310","BRANDICO",0,765,0,765,"2021","026"
"33311","BRANDIZZO",0,0,76,76,"2021","034"
"33312","BRANZI",2,38,0,40,"2021","036"
"33313","BRAONE",3,29,4,36,"2021","027"
"33314","BREBBIA",42,2,0,44,"2021","017"
"33315","BREDA DI PIAVE",64,440,4,508,"2021","005"
"33316","BREGANO",6,0,0,6,"2021","018"
"33317","BREGANZE",460,617,108,1185,"2021","014"
"33318","BREGNANO",12,87,0,99,"2021","028"
"33319","BREMBATE",51,165,0,216,"2021","037"
"33320","BREMBATE DI SOPRA",0,245,0,245,"2021","038"
"33321","BREMBIO",98,2639,0,2737,"2021","006"
"33322","BREME",18,0,0,18,"2021","022"
"33323","BRENDOLA",341,118,0,459,"2021","015"
"33324","BRENNA",4,0,0,4,"2021","029"
"33325","BRENO",4,258,11,273,"2021","028"
"33326","BRENTA",3,0,0,3,"2021","019"
"33327","BRENZONE",11,0,0,11,"2021","014"
"33328","BRESCELLO",2,35,0,37,"2021","006"
"33329","BRESCIA",21,610,0,631,"2021","029"
"33330","BRESSANA BOTTARONE",102,0,0,102,"2021","023"
"33331","BRESSANVIDO",20,1693,22,1735,"2021","016"
"33332","BRESSO",9,0,1,10,"2021",NA
"33333","BREZZO DI BEDERO",0,1,0,1,"2021","020"
"33334","BRIAGLIA",68,0,0,68,"2021","030"
"33335","BRICHERASIO",618,78,0,696,"2021","035"
"33336","BRIGA NOVARESE",0,88,0,88,"2021","026"
"33337","BRIGNANO GERA D'ADDA",246,1898,0,2144,"2021","040"
"33338","BRIGNANO-FRASCATA",2,0,0,2,"2021","024"
"33339","BRINZIO",6,0,0,6,"2021","021"
"33340","BRIONA",10,906,0,916,"2021","027"
"33341","BRIONE",16,0,0,16,"2021","030"
"33342","BRIOSCO",13,0,0,13,"2021",NA
"33343","BRISIGHELLA",390,64,0,454,"2021","004"
"33344","BRISSAGO-VALTRAVAGLIA",2,0,0,2,"2021","022"
"33345","BRIVIO",12,68,0,80,"2021","010"
"33346","BROGLIANO",29,41,0,70,"2021","017"
"33347","BRONDELLO",7,0,0,7,"2021","032"
"33348","BRONI",53,0,0,53,"2021","024"
"33349","BROSSASCO",59,0,0,59,"2021","033"
"33350","BROSSO",33,11,10,54,"2021","036"
"33351","BROVELLO-CARPUGNINO",17,0,6,23,"2021","013"
"33352","BROZOLO",132,0,0,132,"2021","037"
"33353","BRUGHERIO",3,209,7,219,"2021",NA
"33354","BRUGINE",3440,63,0,3503,"2021","015"
"33355","BRUINO",98,0,0,98,"2021","038"
"33356","BRUMANO",9,18,0,27,"2021","041"
"33357","BRUNELLO",8,3,0,11,"2021","023"
"33358","BRUNO",15,0,0,15,"2021","010"
"33359","BRUSAPORTO",52,24,0,76,"2021","042"
"33360","BRUSASCO",120,0,0,120,"2021","039"
"33361","BRUSNENGO",5,0,0,5,"2021","007"
"33362","BRUZOLO",20,58,41,119,"2021","040"
"33363","BUBBIANO",0,37,0,37,"2021","035"
"33364","BUBBIO",57,0,0,57,"2021","011"
"33365","BUCCINASCO",15,629,0,644,"2021","036"
"33366","BUDRIO",137,249,0,386,"2021","008"
"33367","BUGLIO IN MONTE",22,208,0,230,"2021","010"
"33368","BULCIAGO",1,148,14,163,"2021","011"
"33369","BULGAROGRASSO",34,289,0,323,"2021","034"
"33370","BURIASCO",1276,781,137,2194,"2021","041"
"33371","BUROLO",33,0,0,33,"2021","042"
"33372","BURONZO",5,11,0,16,"2021","021"
"33373","BUSANO",43,34,0,77,"2021","043"
"33374","BUSCA",4110,1576,461,6147,"2021","034"
"33375","BUSCATE",106,0,0,106,"2021","038"
"33376","BUSNAGO",26,12,0,38,"2021",NA
"33377","BUSSERO",1,332,0,333,"2021","040"
"33378","BUSSETO",4,3825,0,3829,"2021","007"
"33379","BUSSOLENGO",365,127,94,586,"2021","015"
"33380","BUSSOLENO",26,176,30,232,"2021","044"
"33381","BUSTO ARSIZIO",15,168,36,219,"2021","026"
"33382","BUSTO GAROLFO",94,274,0,368,"2021","041"
"33383","BUTTAPIETRA",147,72,0,219,"2021","016"
"33384","BUTTIGLIERA ALTA",87,49,0,136,"2021","045"
"33385","BUTTIGLIERA D'ASTI",1997,88,74,2159,"2021","012"
"33386","CABELLA LIGURE",94,0,0,94,"2021","025"
"33387","CADEGLIANO-VICONAGO",1,0,0,1,"2021","027"
"33388","CADELBOSCO DI SOPRA",22,1769,0,1791,"2021","008"
"33389","CADEO",29,2818,0,2847,"2021","007"
"33390","CADONEGHE",5,0,0,5,"2021","016"
"33391","CADORAGO",2,48,0,50,"2021","036"
"33392","CADREZZATE CON OSMATE",22,0,0,22,"2021",NA
"33393","CAERANO DI SAN MARCO",203,35,0,238,"2021","006"
"33394","CAFASSE",147,41,2,190,"2021","046"
"33395","CAGLIO",27,0,33,60,"2021","037"
"33396","CAINO",8,0,0,8,"2021","031"
"33397","CAIOLO",4,84,0,88,"2021","011"
"33398","CAIRATE",3,0,0,3,"2021","029"
"33399","CALALZO DI CADORE",1,0,0,1,"2021",NA
"33400","CALAMANDRANA",74,0,0,74,"2021","013"
"33401","CALASCA-CASTIGLIONE",8,0,0,8,"2021","014"
"33402","CALCINATE",317,268,5,590,"2021","043"
"33403","CALCINATO",6302,2123,428,8853,"2021","032"
"33404","CALCIO",256,1449,0,1705,"2021","044"
"33405","CALCO",13,191,0,204,"2021","012"
"33406","CALDERARA DI RENO",39,38,0,77,"2021","009"
"33407","CALDOGNO",45,352,100,497,"2021","018"
"33408","CALENDASCO",139,348,0,487,"2021","008"
"33409","CALESTANO",28,300,0,328,"2021","008"
"33410","CALLABIANA",31,0,0,31,"2021","008"
"33411","CALLIANO",213,0,0,213,"2021","014"
"33412","CALOLZIOCORTE",6,0,15,21,"2021","013"
"33413","CALOSSO",4,0,0,4,"2021","015"
"33414","CALTIGNAGA",1148,128,0,1276,"2021","030"
"33415","CALTO",30,0,0,30,"2021","008"
"33416","CALTRANO",1559,6,0,1565,"2021","019"
"33417","CALUSCO D'ADDA",14,0,0,14,"2021","046"
"33418","CALUSO",960,190,0,1150,"2021","047"
"33419","CALVAGESE DELLA RIVIERA",60,198,0,258,"2021","033"
"33420","CALVATONE",1,122,0,123,"2021","009"
"33421","CALVENE",14,49,0,63,"2021","020"
"33422","CALVENZANO",2,712,0,714,"2021","047"
"33423","CALVIGNASCO",0,28,0,28,"2021","042"
"33424","CALVISANO",12951,4815,207,17973,"2021","034"
"33425","CAMAGNA MONFERRATO",22,0,0,22,"2021","026"
"33426","CAMANDONA",12,0,0,12,"2021","009"
"33427","CAMBIAGO",32,92,0,124,"2021","044"
"33428","CAMBIANO",312,0,0,312,"2021","048"
"33429","CAMBIASCA",12,0,0,12,"2021","015"
"33430","CAMBURZANO",75,0,19,94,"2021","010"
"33431","CAMERANA",280,0,0,280,"2021","035"
"33432","CAMERANO CASASCO",22,0,0,22,"2021","016"
"33433","CAMERATA CORNELLO",16,69,0,85,"2021","048"
"33434","CAMERI",73,751,0,824,"2021","032"
"33435","CAMINO",2,0,0,2,"2021",NA
"33436","CAMISANO",138,3046,0,3184,"2021","010"
"33437","CAMISANO VICENTINO",318,1286,251,1855,"2021","021"
"33438","CAMPAGNA LUPIA",81,100,0,181,"2021","002"
"33439","CAMPAGNOLA CREMASCA",39,702,91,832,"2021","011"
"33440","CAMPAGNOLA EMILIA",0,774,0,774,"2021","009"
"33441","CAMPEGINE",0,1231,0,1231,"2021","010"
"33442","CAMPERTOGNO",0,37,0,37,"2021","025"
"33443","CAMPIGLIA CERVO",4,2,0,6,"2021","011"
"33444","CAMPIGLIA DEI BERICI",570,135,0,705,"2021","022"
"33445","CAMPIGLIONE-FENILE",553,0,27,580,"2021","049"
"33446","CAMPO SAN MARTINO",223,100,0,323,"2021","020"
"33447","CAMPODARSEGO",799,41,5,845,"2021","017"
"33448","CAMPODORO",89,146,0,235,"2021","018"
"33449","CAMPOGALLIANO",1,364,0,365,"2021","003"
"33450","CAMPOLONGO MAGGIORE",20,28,0,48,"2021","003"
"33451","CAMPONOGARA",125,43,0,168,"2021","004"
"33452","CAMPOSAMPIERO",276,61,0,337,"2021","019"
"33453","CAMUGNANO",601,117,0,718,"2021","010"
"33454","CANALE",742,0,0,742,"2021","037"
"33455","CANARO",532,0,0,532,"2021","009"
"33456","CANDELO",75,37,117,229,"2021","012"
"33457","CANDIA CANAVESE",21,0,0,21,"2021","050"
"33458","CANDIANA",11926,197,0,12123,"2021","021"
"33459","CANDIOLO",90,655,50,795,"2021","051"
"33460","CANELLI",5,0,0,5,"2021","017"
"33461","CANISCHIO",9,23,0,32,"2021","052"
"33462","CANNETO SULL'OGLIO",1565,2773,561,4899,"2021","008"
"33463","CANNOBIO",9,6,0,15,"2021","017"
"33464","CANONICA D'ADDA",11,461,0,472,"2021","049"
"33465","CANOSIO",9,0,0,9,"2021","038"
"33466","CANOSSA",15,227,0,242,"2021","018"
"33467","CANTALUPA",39,0,0,39,"2021","053"
"33468","CANTALUPO LIGURE",29,0,0,29,"2021","028"
"33469","CANTARANA",53,0,0,53,"2021","018"
"33470","CANTELLO",119,141,0,260,"2021","030"
"33471","CANTOIRA",73,10,19,102,"2021","054"
"33472","CANTU'",228,263,29,520,"2021","041"
"33473","CANZO",0,2,20,22,"2021","042"
"33474","CAORLE",795,27,40,862,"2021","005"
"33475","CAORSO",3,460,0,463,"2021","010"
"33476","CAPERGNANICA",313,1128,0,1441,"2021","012"
"33477","CAPIAGO INTIMIANO",0,10,2,12,"2021","043"
"33478","CAPIZZONE",24,16,0,40,"2021","050"
"33479","CAPO DI PONTE",29,161,10,200,"2021","035"
"33480","CAPONAGO",69,0,0,69,"2021",NA
"33481","CAPOVALLE",4,0,1,5,"2021","036"
"33482","CAPPELLA CANTONE",0,384,0,384,"2021","013"
"33483","CAPPELLA DE' PICENARDI",4,399,0,403,"2021","014"
"33484","CAPPELLA MAGGIORE",10,8,0,18,"2021","007"
"33485","CAPRALBA",1,1464,0,1465,"2021","015"
"33486","CAPRAUNA",3,0,0,3,"2021","039"
"33487","CAPRIANO DEL COLLE",4,395,0,399,"2021","037"
"33488","CAPRIATA D'ORBA",16,0,0,16,"2021","029"
"33489","CAPRIE",30,0,0,30,"2021","055"
"33490","CAPRIGLIO",2,0,0,2,"2021","019"
"33491","CAPRILE",65,2,0,67,"2021","013"
"33492","CAPRINO BERGAMASCO",13,0,0,13,"2021","052"
"33493","CAPRINO VERONESE",80,640,93,813,"2021","018"
"33494","CAPRIOLO",306,0,57,363,"2021","038"
"33495","CARAGLIO",3355,635,484,4474,"2021","040"
"33496","CARAMAGNA PIEMONTE",1881,729,76,2686,"2021","041"
"33497","CARAVAGGIO",325,3022,0,3347,"2021","053"
"33498","CARAVATE",0,111,0,111,"2021","031"
"33499","CARBONARA AL TICINO",19,356,0,375,"2021","030"
"33500","CARBONARA SCRIVIA",26,0,0,26,"2021","030"
"33501","CARBONATE",103,45,19,167,"2021","045"
"33502","CARBONERA",132,192,10,334,"2021","008"
"33503","CARCERI",1517,0,0,1517,"2021","022"
"33504","CARCOFORO",0,0,7,7,"2021","029"
"33505","CARDE'",2709,1943,68,4720,"2021","042"
"33506","CAREMA",64,0,4,68,"2021","057"
"33507","CARENNO",21,0,15,36,"2021","014"
"33508","CARENTINO",31,559,0,590,"2021","031"
"33509","CARESANA",3,0,0,3,"2021","030"
"33510","CAREZZANO",1,0,0,1,"2021","032"
"33511","CARIGNANO",2754,1542,372,4668,"2021","058"
"33512","CARISIO",57,0,0,57,"2021","032"
"33513","CARLAZZO",54,61,4,119,"2021","047"
"33514","CARMAGNOLA",6836,3110,0,9946,"2021","059"
"33515","CARMIGNANO DI BRENTA",90,1327,0,1417,"2021","023"
"33516","CARNAGO",27,38,0,65,"2021","033"
"33517","CAROBBIO DEGLI ANGELI",81,29,0,110,"2021","055"
"33518","CARONNO PERTUSELLA",4,0,0,4,"2021","034"
"33519","CARONNO VARESINO",33,0,0,33,"2021","035"
"33520","CARPANETO PIACENTINO",35,4444,0,4479,"2021","011"
"33521","CARPENEDOLO",1448,4165,181,5794,"2021","039"
"33522","CARPENETO",117,0,0,117,"2021","033"
"33523","CARPI",5,2120,0,2125,"2021","005"
"33524","CARPIANO",209,1260,0,1469,"2021","050"
"33525","CARPIGNANO SESIA",114,0,0,114,"2021","036"
"33526","CARPINETI",87,1341,0,1428,"2021","011"
"33527","CARRE'",189,94,0,283,"2021","024"
"33528","CARREGA LIGURE",24,0,0,24,"2021","034"
"33529","CARRU'",760,45,52,857,"2021","043"
"33530","CARTIGLIANO",24,9,0,33,"2021","025"
"33531","CARTIGNANO",199,75,0,274,"2021","044"
"33532","CARTOSIO",56,0,0,56,"2021","036"
"33533","CARTURA",390,0,0,390,"2021","026"
"33534","CARUGATE",29,113,0,142,"2021","051"
"33535","CARUGO",3,0,0,3,"2021","048"
"33536","CARVICO",2,0,0,2,"2021","057"
"33537","CASALBELTRAME",1,0,167,168,"2021","037"
"33538","CASALBORGONE",46,0,0,46,"2021","060"
"33539","CASALBUTTANO ED UNITI",2,1871,0,1873,"2021","016"
"33540","CASALE CORTE CERRO",30,0,0,30,"2021","019"
"33541","CASALE CREMASCO-VIDOLASCO",0,1971,0,1971,"2021","017"
"33542","CASALE DI SCODOSIA",557,0,0,557,"2021","027"
"33543","CASALE LITTA",37,160,0,197,"2021","036"
"33544","CASALE MONFERRATO",143,160,0,303,"2021","039"
"33545","CASALE SUL SILE",265,42,38,345,"2021","009"
"33546","CASALEGGIO BOIRO",22,0,0,22,"2021","038"
"33547","CASALEONE",6,0,0,6,"2021","019"
"33548","CASALETTO CEREDANO",20,9,0,29,"2021","018"
"33549","CASALETTO DI SOPRA",9,372,0,381,"2021","019"
"33550","CASALETTO LODIGIANO",35,642,0,677,"2021","008"
"33551","CASALETTO VAPRIO",138,870,0,1008,"2021","020"
"33552","CASALFIUMANESE",318,101,0,419,"2021","012"
"33553","CASALGRANDE",27,1238,0,1265,"2021","012"
"33554","CASALGRASSO",325,221,134,680,"2021","045"
"33555","CASALINO",8,131,0,139,"2021","040"
"33556","CASALMAGGIORE",5,691,0,696,"2021","021"
"33557","CASALMAIOCCO",26,490,0,516,"2021","009"
"33558","CASALMORANO",98,2474,0,2572,"2021","022"
"33559","CASALMORO",396,239,288,923,"2021","010"
"33560","CASALNOCETO",23,0,0,23,"2021","040"
"33561","CASALOLDO",969,1223,870,3062,"2021","011"
"33562","CASALPUSTERLENGO",2690,1275,0,3965,"2021","010"
"33563","CASALROMANO",339,278,245,862,"2021","012"
"33564","CASALSERUGO",83,7,0,90,"2021","028"
"33565","CASALVOLONE",3,23,0,26,"2021","041"
"33566","CASALZUIGNO",2,102,0,104,"2021","037"
"33567","CASAPINTA",1,0,0,1,"2021",NA
"33568","CASARGO",7,16,1,24,"2021","015"
"33569","CASARILE",63,0,0,63,"2021","055"
"33570","CASATENOVO",488,0,2,490,"2021","016"
"33571","CASAZZA",8,4,0,12,"2021","058"
"33572","CASCIAGO",16,34,0,50,"2021","038"
"33573","CASEI GEROLA",639,0,0,639,"2021","033"
"33574","CASELETTE",108,336,43,487,"2021","062"
"33575","CASELLE LANDI",233,505,0,738,"2021","011"
"33576","CASELLE LURANI",37,453,0,490,"2021","012"
"33577","CASELLE TORINESE",210,1392,0,1602,"2021","063"
"33578","CASIER",14,69,0,83,"2021","010"
"33579","CASINA",68,904,0,972,"2021","013"
"33580","CASIRATE D'ADDA",138,335,0,473,"2021","059"
"33581","CASLINO D'ERBA",7,0,2,9,"2021","052"
"33582","CASNIGO",27,76,0,103,"2021","060"
"33583","CASOLA VALSENIO",199,17,0,216,"2021","005"
"33584","CASORATE PRIMO",39,138,0,177,"2021","034"
"33585","CASOREZZO",0,301,0,301,"2021","058"
"33586","CASORZO",5,0,0,5,"2021","020"
"33587","CASPOGGIO",1,49,0,50,"2021","013"
"33588","CASSAGO BRIANZA",1,60,7,68,"2021","017"
"33589","CASSANO D'ADDA",148,293,53,494,"2021","059"
"33590","CASSANO MAGNAGO",45,81,0,126,"2021","040"
"33591","CASSANO SPINOLA",261,0,0,261,"2021","042"
"33592","CASSINA DE' PECCHI",0,366,0,366,"2021","060"
"33593","CASSINA VALSASSINA",9,35,0,44,"2021","018"
"33594","CASSINASCO",19,0,19,38,"2021","021"
"33595","CASSINE",313,0,0,313,"2021","043"
"33596","CASSINELLE",2,0,0,2,"2021","044"
"33597","CASSINETTA DI LUGAGNANO",0,216,0,216,"2021","061"
"33598","CASSOLA",427,23,0,450,"2021","026"
"33599","CASTAGNARO",246,0,0,246,"2021","020"
"33600","CASTAGNETO PO",46,0,0,46,"2021","064"
"33601","CASTAGNITO",120,0,0,120,"2021","046"
"33602","CASTAGNOLE DELLE LANZE",256,0,0,256,"2021","022"
"33603","CASTAGNOLE MONFERRATO",51,0,0,51,"2021","023"
"33604","CASTAGNOLE PIEMONTE",1386,609,80,2075,"2021","065"
"33605","CASTANA",2,0,0,2,"2021","036"
"33606","CASTANO PRIMO",74,0,15,89,"2021","062"
"33607","CASTEGGIO",521,0,0,521,"2021","037"
"33608","CASTEGNATO",33,999,1,1033,"2021","040"
"33609","CASTEGNERO",42,26,0,68,"2021","027"
"33610","CASTEL BOGLIONE",6,0,0,6,"2021","024"
"33611","CASTEL BOLOGNESE",16,0,0,16,"2021","006"
"33612","CASTEL D'AIANO",18,643,30,691,"2021","013"
"33613","CASTEL D'ARIO",137,45,1162,1344,"2021","014"
"33614","CASTEL D'AZZANO",1816,128,0,1944,"2021","021"
"33615","CASTEL DEL RIO",30,0,0,30,"2021","014"
"33616","CASTEL DI CASIO",41,29,0,70,"2021","015"
"33617","CASTEL GABBIANO",0,1861,0,1861,"2021","024"
"33618","CASTEL GOFFREDO",1882,630,459,2971,"2021","015"
"33619","CASTEL GUELFO DI BOLOGNA",133,228,0,361,"2021","016"
"33620","CASTEL MELLA",5,389,0,394,"2021","042"
"33621","CASTEL ROZZONE",0,36,0,36,"2021","063"
"33622","CASTEL SAN GIOVANNI",69,806,0,875,"2021","013"
"33623","CASTEL SAN PIETRO TERME",616,335,0,951,"2021","020"
"33624","CASTELBELFORTE",1593,0,0,1593,"2021","013"
"33625","CASTELCOVATI",4,415,2,421,"2021","041"
"33626","CASTELCUCCO",59,184,10,253,"2021","011"
"33627","CASTELDELCI",187,0,0,187,"2021","021"
"33628","CASTELDELFINO",43,0,0,43,"2021","047"
"33629","CASTELDIDONE",55,0,0,55,"2021","023"
"33630","CASTELFRANCO EMILIA",1842,2986,0,4828,"2021","006"
"33631","CASTELFRANCO VENETO",4564,174,3,4741,"2021","012"
"33632","CASTELGERUNDO",19,1827,0,1846,"2021",NA
"33633","CASTELGOMBERTO",295,440,0,735,"2021","028"
"33634","CASTELGUGLIELMO",582,0,0,582,"2021","011"
"33635","CASTELL'ALFERO",396,0,0,396,"2021","025"
"33636","CASTELL'ARQUATO",44,916,0,960,"2021","012"
"33637","CASTELLAMONTE",339,275,102,716,"2021","066"
"33638","CASTELLARANO",25,345,0,370,"2021","014"
"33639","CASTELLAZZO BORMIDA",130,85,0,215,"2021","047"
"33640","CASTELLAZZO NOVARESE",1,0,0,1,"2021","042"
"33641","CASTELLEONE",778,4462,0,5240,"2021","025"
"33642","CASTELLERO",1,0,0,1,"2021","026"
"33643","CASTELLETTO CERVO",27,40,0,67,"2021","015"
"33644","CASTELLETTO D'ORBA",5,0,0,5,"2021","049"
"33645","CASTELLETTO DI BRANDUZZO",1,0,0,1,"2021","038"
"33646","CASTELLETTO MERLI",11,0,0,11,"2021","050"
"33647","CASTELLETTO MONFERRATO",87,0,0,87,"2021","051"
"33648","CASTELLETTO SOPRA TICINO",107,42,0,149,"2021","043"
"33649","CASTELLETTO STURA",1930,47,61,2038,"2021","049"
"33650","CASTELLETTO UZZONE",1,0,0,1,"2021","050"
"33651","CASTELLI CALEPIO",11,308,0,319,"2021","062"
"33652","CASTELLINALDO D'ALBA",982,0,0,982,"2021",NA
"33653","CASTELLINO TANARO",157,0,0,157,"2021","052"
"33654","CASTELLO CABIAGLIO",10,0,0,10,"2021","043"
"33655","CASTELLO D'AGOGNA",8,0,0,8,"2021",NA
"33656","CASTELLO D'ARGILE",29,0,0,29,"2021","017"
"33657","CASTELLO DELL'ACQUA",13,14,0,27,"2021","014"
"33658","CASTELLO DI ANNONE",142,0,0,142,"2021","028"
"33659","CASTELLO DI BRIANZA",1,0,24,25,"2021","019"
"33660","CASTELLO DI GODEGO",6280,148,0,6428,"2021","013"
"33661","CASTELLUCCHIO",876,1867,1859,4602,"2021","016"
"33662","CASTELMAGNO",61,9,9,79,"2021","053"
"33663","CASTELMARTE",13,0,1,14,"2021","058"
"33664","CASTELMASSA",0,102,0,102,"2021","012"
"33665","CASTELNOVETTO",3,0,0,3,"2021","040"
"33666","CASTELNOVO BARIANO",2094,0,0,2094,"2021","013"
"33667","CASTELNOVO DI SOTTO",6,1226,0,1232,"2021","015"
"33668","CASTELNOVO NE' MONTI",53,1426,0,1479,"2021","016"
"33669","CASTELNUOVO BOCCA D'ADDA",1966,418,20,2404,"2021","013"
"33670","CASTELNUOVO BORMIDA",9,0,0,9,"2021","052"
"33671","CASTELNUOVO BOZZENTE",4,5,0,9,"2021","059"
"33672","CASTELNUOVO CALCEA",4,0,0,4,"2021","030"
"33673","CASTELNUOVO DEL GARDA",3475,264,1,3740,"2021","022"
"33674","CASTELNUOVO DON BOSCO",174,0,0,174,"2021","031"
"33675","CASTELNUOVO NIGRA",38,0,0,38,"2021","067"
"33676","CASTELNUOVO RANGONE",0,938,0,938,"2021","007"
"33677","CASTELNUOVO SCRIVIA",13,0,0,13,"2021","053"
"33678","CASTELSEPRIO",4,0,1,5,"2021","044"
"33679","CASTELSPINA",12,0,0,12,"2021","054"
"33680","CASTELVECCANA",4,0,0,4,"2021","045"
"33681","CASTELVERDE",116,3446,0,3562,"2021","026"
"33682","CASTELVETRO DI MODENA",41,939,0,980,"2021","008"
"33683","CASTELVETRO PIACENTINO",1049,1041,0,2090,"2021","014"
"33684","CASTELVISCONTI",6,1375,307,1688,"2021","027"
"33685","CASTENASO",135,102,0,237,"2021","021"
"33686","CASTENEDOLO",803,1176,4,1983,"2021","043"
"33687","CASTIGLIONE D'ADDA",3,268,0,271,"2021","014"
"33688","CASTIGLIONE DEI PEPOLI",125,39,0,164,"2021","022"
"33689","CASTIGLIONE DELLE STIVIERE",4977,2723,559,8259,"2021","017"
"33690","CASTIGLIONE FALLETTO",42,0,0,42,"2021","055"
"33691","CASTIGLIONE OLONA",4,0,6,10,"2021","046"
"33692","CASTIGLIONE TINELLA",63,0,0,63,"2021","056"
"33693","CASTIGLIONE TORINESE",12,0,0,12,"2021","068"
"33694","CASTINO",77,0,0,77,"2021","057"
"33695","CASTIONE ANDEVENNO",12,53,0,65,"2021","015"
"33696","CASTIONE DELLA PRESOLANA",10,3,0,13,"2021","064"
"33697","CASTIRAGA VIDARDO",11,296,0,307,"2021","015"
"33698","CASTO",25,28,3,56,"2021","044"
"33699","CASTREZZATO",365,1109,106,1580,"2021","045"
"33700","CASTRO",2,0,0,2,"2021","065"
"33701","CASTROCARO TERME E TERRA DEL SOLE",16,6,0,22,"2021","005"
"33702","CASTRONNO",3,0,0,3,"2021","047"
"33703","CAVAGLIA'",844,160,0,1004,"2021","016"
"33704","CAVAGLIETTO",2,228,0,230,"2021","044"
"33705","CAVAGNOLO",44,0,0,44,"2021","069"
"33706","CAVAION VERONESE",3,0,0,3,"2021","023"
"33707","CAVALLERLEONE",349,1152,82,1583,"2021","058"
"33708","CAVALLERMAGGIORE",2775,2274,34,5083,"2021","059"
"33709","CAVALLINO-TREPORTI",14,0,0,14,"2021","044"
"33710","CAVALLIRIO",4,0,0,4,"2021","047"
"33711","CAVARGNA",1,0,6,7,"2021","062"
"33712","CAVARIA CON PREMEZZO",5,0,0,5,"2021","048"
"33713","CAVARZERE",4948,0,0,4948,"2021","006"
"33714","CAVASO DEL TOMBA",67,51,3,121,"2021","014"
"33715","CAVATORE",6,0,0,6,"2021","055"
"33716","CAVENAGO D'ADDA",11,981,0,992,"2021","017"
"33717","CAVEZZO",0,372,0,372,"2021","009"
"33718","CAVOUR",4954,832,734,6520,"2021","070"
"33719","CAVRIAGO",11,619,0,630,"2021","017"
"33720","CAVRIANA",1739,1710,289,3738,"2021","018"
"33721","CAZZAGO SAN MARTINO",3384,121,407,3912,"2021","046"
"33722","CAZZANO DI TRAMIGNA",4,58,0,62,"2021","024"
"33723","CAZZANO SANT'ANDREA",309,9,0,318,"2021","067"
"33724","CECIMA",15,0,0,15,"2021","042"
"33725","CEDEGOLO",4,14,3,21,"2021","047"
"33726","CEDRASCO",0,66,0,66,"2021","016"
"33727","CEGGIA",16,0,0,16,"2021","007"
"33728","CELLA DATI",2568,86,34,2688,"2021","028"
"33729","CELLA MONTE",80,0,0,80,"2021","056"
"33730","CELLARENGO",214,95,151,460,"2021","033"
"33731","CELLATICA",0,75,2,77,"2021","048"
"33732","CELLE DI MACRA",42,0,17,59,"2021","060"
"33733","CELLE ENOMONDO",192,0,0,192,"2021","034"
"33734","CELLIO CON BREIA",12,0,0,12,"2021",NA
"33735","CENATE SOPRA",12,11,0,23,"2021","068"
"33736","CENATE SOTTO",16,0,0,16,"2021","069"
"33737","CENCENIGHE AGORDINO",1,1,0,2,"2021","010"
"33738","CENE",37,50,0,87,"2021","070"
"33739","CENESELLI",0,218,30,248,"2021","014"
"33740","CENTALLO",5197,734,412,6343,"2021","061"
"33741","CENTO",19,0,0,19,"2021","004"
"33742","CENTRO VALLE INTELVI",31,13,8,52,"2021",NA
"33743","CEPPO MORELLI",29,0,0,29,"2021","021"
"33744","CERANO",23,0,0,23,"2021","049"
"33745","CERANO D'INTELVI",5,0,35,40,"2021","063"
"33746","CERANOVA",0,632,0,632,"2021","043"
"33747","CERCENASCO",150,304,0,454,"2021","071"
"33748","CERCINO",64,7,30,101,"2021","017"
"33749","CEREA",1352,236,0,1588,"2021","025"
"33750","CERES",5,0,0,5,"2021","072"
"33751","CERESARA",1159,343,107,1609,"2021","019"
"33752","CERESETO",113,0,0,113,"2021","057"
"33753","CERESOLE ALBA",3571,706,0,4277,"2021","062"
"33754","CERESOLE REALE",0,4,0,4,"2021","073"
"33755","CERETE",20,160,0,180,"2021","071"
"33756","CERIANO LAGHETTO",0,44,0,44,"2021",NA
"33757","CERIGNALE",13,0,0,13,"2021","015"
"33758","CERMENATE",13,150,2,165,"2021","064"
"33759","CERNUSCO LOMBARDONE",10,0,10,20,"2021","020"
"33760","CERNUSCO SUL NAVIGLIO",19,151,0,170,"2021","070"
"33761","CERRETO D'ASTI",1,0,0,1,"2021","035"
"33762","CERRETO GRUE",26,0,0,26,"2021","058"
"33763","CERRETTO LANGHE",7,0,0,7,"2021","063"
"33764","CERRINA MONFERRATO",37,26,17,80,"2021","059"
"33765","CERRIONE",102,267,0,369,"2021","018"
"33766","CERRO AL LAMBRO",7,731,0,738,"2021","071"
"33767","CERRO MAGGIORE",3,86,0,89,"2021","072"
"33768","CERRO TANARO",260,0,0,260,"2021","036"
"33769","CERRO VERONESE",34,208,0,242,"2021","026"
"33770","CERTOSA DI PAVIA",14,0,0,14,"2021","046"
"33771","CERVARESE SANTA CROCE",21,135,0,156,"2021","030"
"33772","CERVASCA",1273,302,2,1577,"2021","064"
"33773","CERVENO",0,23,2,25,"2021","049"
"33774","CERVERE",1944,187,0,2131,"2021","065"
"33775","CERVIGNANO D'ADDA",0,980,0,980,"2021","018"
"33776","CESANA BRIANZA",3,17,1,21,"2021","021"
"33777","CESANA TORINESE",64,12,26,102,"2021","074"
"33778","CESANO BOSCONE",0,84,0,84,"2021","074"
"33779","CESANO MADERNO",4,0,0,4,"2021",NA
"33780","CESATE",2,0,0,2,"2021","076"
"33781","CESENA",56,22,0,78,"2021","007"
"33782","CESENATICO",13,0,0,13,"2021","008"
"33783","CESIOMAGGIORE",213,103,8,324,"2021","011"
"33784","CESSALTO",39,119,0,158,"2021","015"
"33785","CESSOLE",185,0,0,185,"2021","037"
"33786","CETO",7,49,5,61,"2021","050"
"33787","CEVA",1480,0,0,1480,"2021","066"
"33788","CEVO",0,38,2,40,"2021","051"
"33789","CHERASCO",4899,997,109,6005,"2021","067"
"33790","CHIALAMBERTO",1,0,19,20,"2021","075"
"33791","CHIAMPO",19,59,3,81,"2021","029"
"33792","CHIANOCCO",22,0,9,31,"2021","076"
"33793","CHIARANO",5,529,1,535,"2021","016"
"33794","CHIARI",752,5728,308,6788,"2021","052"
"33795","CHIAVENNA",5,8,2,15,"2021","018"
"33796","CHIAVERANO",34,0,0,34,"2021","077"
"33797","CHIERI",2797,505,60,3362,"2021","078"
"33798","CHIES D'ALPAGO",13,7,0,20,"2021","012"
"33799","CHIESA IN VALMALENCO",20,46,0,66,"2021","019"
"33800","CHIESANUOVA",2,0,0,2,"2021","079"
"33801","CHIEVE",0,1080,0,1080,"2021","029"
"33802","CHIGNOLO D'ISOLA",87,430,0,517,"2021","072"
"33803","CHIGNOLO PO",7,81,0,88,"2021","048"
"33804","CHIOGGIA",3329,0,0,3329,"2021","008"
"33805","CHIOMONTE",0,21,0,21,"2021","080"
"33806","CHIUDUNO",15,0,0,15,"2021","073"
"33807","CHIUPPANO",10,12,0,22,"2021","030"
"33808","CHIURO",9,6,0,15,"2021","020"
"33809","CHIUSA DI PESIO",1565,454,5,2024,"2021","068"
"33810","CHIUSA DI SAN MICHELE",0,0,72,72,"2021","081"
"33811","CHIUSANO D'ASTI",2,0,0,2,"2021","038"
"33812","CHIVASSO",1331,263,0,1594,"2021","082"
"33813","CICOGNOLO",0,1023,0,1023,"2021","030"
"33814","CICONIO",96,96,0,192,"2021","083"
"33815","CIGLIANO",283,69,39,391,"2021","042"
"33816","CIGLIE'",468,0,0,468,"2021","069"
"33817","CIGOGNOLA",2,0,0,2,"2021","049"
"33818","CIGOLE",2222,1353,0,3575,"2021","053"
"33819","CILAVEGNA",5,0,0,5,"2021","050"
"33820","CIMADOLMO",409,55,0,464,"2021","017"
"33821","CIMBERGO",5,0,2,7,"2021","054"
"33822","CINAGLIO",333,0,22,355,"2021","039"
"33823","CINGIA DE' BOTTI",50,840,0,890,"2021","031"
"33824","CINO",16,10,0,26,"2021","021"
"33825","CINTANO",21,0,0,21,"2021","084"
"33826","CINTO CAOMAGGIORE",437,0,24,461,"2021","009"
"33827","CINTO EUGANEO",49,32,0,81,"2021","031"
"33828","CINZANO",13,0,0,13,"2021","085"
"33829","CIRIE'",297,169,123,589,"2021","086"
"33830","CIRIMIDO",3,25,0,28,"2021","068"
"33831","CISANO BERGAMASCO",29,0,0,29,"2021","074"
"33832","CISERANO",23,55,0,78,"2021","075"
"33833","CISLAGO",6,0,0,6,"2021","050"
"33834","CISLIANO",132,541,0,673,"2021","078"
"33835","CISON DI VALMARINO",105,0,2,107,"2021","018"
"33836","CISSONE",6,0,0,6,"2021","070"
"33837","CISTERNA D'ASTI",85,0,0,85,"2021","040"
"33838","CITTADELLA",2005,971,118,3094,"2021","032"
"33839","CITTIGLIO",10,13,0,23,"2021","051"
"33840","CIVATE",2,0,1,3,"2021","022"
"33841","CIVIASCO",1,6,0,7,"2021","043"
"33842","CIVIDATE AL PIANO",514,655,1,1170,"2021","076"
"33843","CIVIDATE CAMUNO",5,0,0,5,"2021","055"
"33844","CIVITELLA DI ROMAGNA",376,26,18,420,"2021","009"
"33845","CIVO",7,37,0,44,"2021","022"
"33846","CLAINO CON OSTENO",1,0,3,4,"2021","071"
"33847","CLAVESANA",384,0,0,384,"2021","071"
"33848","CLIVIO",17,100,0,117,"2021","052"
"33849","CLUSONE",52,200,2,254,"2021","077"
"33850","COASSOLO TORINESE",34,0,2,36,"2021","088"
"33851","COAZZE",6,0,7,13,"2021","089"
"33852","COAZZOLO",37,0,0,37,"2021","041"
"33853","COCCAGLIO",131,1105,2,1238,"2021","056"
"33854","COCCONATO",35,0,0,35,"2021","042"
"33855","COCQUIO-TREVISAGO",32,0,0,32,"2021","053"
"33856","CODEVIGO",418,115,0,533,"2021","033"
"33857","CODEVILLA",3,0,0,3,"2021","051"
"33858","CODIGORO",3404,247,0,3651,"2021","005"
"33859","CODOGNE'",34,181,16,231,"2021","019"
"33860","CODOGNO",23,958,3,984,"2021","019"
"33861","COGGIOLA",6,5,0,11,"2021","019"
"33862","COGLIATE",0,0,43,43,"2021",NA
"33863","COGOLLO DEL CENGIO",380,101,0,481,"2021","032"
"33864","COLCERESA",18,416,27,461,"2021",NA
"33865","COLERE",1,0,0,1,"2021","078"
"33866","COLI",48,0,0,48,"2021","016"
"33867","COLICO",62,102,57,221,"2021","023"
"33868","COLLE BRIANZA",3,0,3,6,"2021","024"
"33869","COLLE SANTA LUCIA",0,14,0,14,"2021","014"
"33870","COLLE UMBERTO",26,114,3,143,"2021","020"
"33871","COLLECCHIO",0,2848,0,2848,"2021","009"
"33872","COLLEGNO",277,263,5,545,"2021","090"
"33873","COLLERETTO CASTELNUOVO",1,32,0,33,"2021","091"
"33874","COLLERETTO GIACOSA",22,0,0,22,"2021","092"
"33875","COLLI VERDI",136,0,0,136,"2021",NA
"33876","COLLIO",31,62,13,106,"2021","058"
"33877","COLOGNA VENETA",10185,236,0,10421,"2021","027"
"33878","COLOGNE",487,686,1,1174,"2021","059"
"33879","COLOGNO AL SERIO",40,894,15,949,"2021","079"
"33880","COLORINA",61,380,0,441,"2021","023"
"33881","COLORNO",9,1246,0,1255,"2021","010"
"33882","COLTURANO",0,10,0,10,"2021","082"
"33883","COLVERDE",11,90,17,118,"2021",NA
"33884","COLZATE",20,35,0,55,"2021","080"
"33885","COMABBIO",2,0,0,2,"2021",NA
"33886","COMACCHIO",375,209,0,584,"2021","006"
"33887","COMAZZO",58,893,37,988,"2021","020"
"33888","COMELICO SUPERIORE",24,125,3,152,"2021","015"
"33889","COMERIO",3,0,0,3,"2021","055"
"33890","COMEZZANO-CIZZAGO",135,1792,1,1928,"2021","060"
"33891","COMMESSAGGIO",5,11,10,26,"2021","020"
"33892","COMO",8,50,14,72,"2021","075"
"33893","COMPIANO",14,14,0,28,"2021","011"
"33894","COMUN NUOVO",70,0,0,70,"2021","081"
"33895","CONA",15765,0,9,15774,"2021","010"
"33896","CONCAMARISE",0,282,0,282,"2021","029"
"33897","CONCESIO",11,23,0,34,"2021","061"
"33898","CONCORDIA SAGITTARIA",1095,0,0,1095,"2021","011"
"33899","CONCORDIA SULLA SECCHIA",46,237,0,283,"2021","010"
"33900","CONCOREZZO",1,35,0,36,"2021",NA
"33901","CONDOVE",113,19,48,180,"2021","093"
"33902","CONEGLIANO",30,25,5,60,"2021","021"
"33903","CONFIENZA",32,22,0,54,"2021","052"
"33904","CONIOLO",76,0,0,76,"2021","060"
"33905","CONSELICE",472,216,0,688,"2021","008"
"33906","CONSELVE",1265,56,0,1321,"2021","034"
"33907","CONZANO",84,0,0,84,"2021","061"
"33908","COPPARO",72,0,0,72,"2021","007"
"33909","CORBETTA",21,54,10,85,"2021","085"
"33910","CORBOLA",17,195,0,212,"2021","017"
"33911","CORDIGNANO",93,119,0,212,"2021","022"
"33912","CORIANO",48,164,0,212,"2021","003"
"33913","CORIO",104,47,4,155,"2021","094"
"33914","CORNA IMAGNA",36,45,0,81,"2021","082"
"33915","CORNALBA",2,10,0,12,"2021","249"
"33916","CORNAREDO",1,236,7,244,"2021","087"
"33917","CORNATE D'ADDA",24,87,0,111,"2021",NA
"33918","CORNEDO VICENTINO",6,120,0,126,"2021","034"
"33919","CORNEGLIANO LAUDENSE",0,188,0,188,"2021","021"
"33920","CORNELIANO D'ALBA",129,0,0,129,"2021","072"
"33921","CORNIGLIO",27,472,0,499,"2021","012"
"33922","CORNO GIOVINE",192,86,0,278,"2021","022"
"33923","CORNOVECCHIO",110,0,0,110,"2021","023"
"33924","CORNUDA",776,455,0,1231,"2021","023"
"33925","CORREGGIO",2,2098,0,2100,"2021","020"
"33926","CORREZZANA",19,0,0,19,"2021",NA
"33927","CORREZZOLA",4814,28,0,4842,"2021","035"
"33928","CORRIDO",43,14,2,59,"2021","077"
"33929","CORSIONE",10,0,0,10,"2021","044"
"33930","CORTANZE",77,0,0,77,"2021","046"
"33931","CORTAZZONE",14,0,0,14,"2021","047"
"33932","CORTE BRUGNATELLA",116,9,0,125,"2021","017"
"33933","CORTE DE' CORTESI CON CIGNONE",1,5,261,267,"2021","032"
"33934","CORTE DE' FRATI",17,852,82,951,"2021","033"
"33935","CORTE FRANCA",95,53,8,156,"2021","062"
"33936","CORTE PALASIO",5,2111,27,2143,"2021","024"
"33937","CORTEMAGGIORE",180,1988,0,2168,"2021","018"
"33938","CORTEMILIA",219,0,0,219,"2021","073"
"33939","CORTENO GOLGI",7,131,15,153,"2021","063"
"33940","CORTENOVA",6,34,0,40,"2021","025"
"33941","CORTENUOVA",168,1294,0,1462,"2021","083"
"33942","CORTEOLONA E GENZONE",73,65,0,138,"2021",NA
"33943","CORTIGLIONE",1,0,0,1,"2021","048"
"33944","CORTINA D'AMPEZZO",6,32,0,38,"2021","016"
"33945","CORVINO SAN QUIRICO",7,0,0,7,"2021","057"
"33946","CORZANO",115,269,0,384,"2021","064"
"33947","COSIO VALTELLINO",15,630,2,647,"2021","024"
"33948","COSSANO BELBO",372,0,0,372,"2021","074"
"33949","COSSATO",263,148,0,411,"2021","020"
"33950","COSSOGNO",4,0,0,4,"2021","023"
"33951","COSTA DE' NOBILI",38,23,6,67,"2021","058"
"33952","COSTA DI MEZZATE",29,0,0,29,"2021","084"
"33953","COSTA DI ROVIGO",1,333,0,334,"2021","018"
"33954","COSTA MASNAGA",7,0,0,7,"2021","026"
"33955","COSTA SERINA",8,4,0,12,"2021","247"
"33956","COSTA VALLE IMAGNA",4,9,0,13,"2021","085"
"33957","COSTA VESCOVATO",41,0,0,41,"2021","062"
"33958","COSTA VOLPINO",17,43,0,60,"2021","086"
"33959","COSTABISSARA",37,48,4,89,"2021","035"
"33960","COSTERMANO",15,29,0,44,"2021","030"
"33961","COSTIGLIOLE D'ASTI",482,0,0,482,"2021","050"
"33962","COSTIGLIOLE SALUZZO",521,0,14,535,"2021","075"
"33963","COTIGNOLA",81,0,0,81,"2021","009"
"33964","COVO",6,1269,0,1275,"2021","087"
"33965","CRANDOLA VALSASSINA",1,5,4,10,"2021","027"
"33966","CRAVAGLIANA",0,30,0,30,"2021","048"
"33967","CRAVANZANA",1,0,0,1,"2021","076"
"33968","CRAVEGGIA",18,0,0,18,"2021","024"
"33969","CREAZZO",4,24,0,28,"2021","036"
"33970","CREDARO",4,180,0,184,"2021","088"
"33971","CREDERA RUBBIANO",0,1539,41,1580,"2021","034"
"33972","CREMA",289,2014,304,2607,"2021","035"
"33973","CREMELLA",5,0,0,5,"2021","028"
"33974","CREMENO",16,20,13,49,"2021","029"
"33975","CREMIA",1,0,4,5,"2021","083"
"33976","CREMOLINO",104,0,0,104,"2021","063"
"33977","CREMONA",167,1371,1,1539,"2021","036"
"33978","CREMOSANO",28,603,0,631,"2021","037"
"33979","CRESCENTINO",152,0,44,196,"2021","049"
"33980","CRESPADORO",21,57,0,78,"2021","037"
"33981","CRESPIATICA",6,321,0,327,"2021","025"
"33982","CRESPINO",2171,0,0,2171,"2021","019"
"33983","CRESSA",53,250,0,303,"2021","055"
"33984","CREVACUORE",1,0,0,1,"2021","021"
"33985","CREVALCORE",161,32,0,193,"2021","024"
"33986","CREVOLADOSSOLA",33,38,64,135,"2021","025"
"33987","CROCETTA DEL MONTELLO",24,35,0,59,"2021","025"
"33988","CRODO",65,92,7,164,"2021","026"
"33989","CROSIO DELLA VALLE",1,0,0,1,"2021","057"
"33990","CROTTA D'ADDA",4,480,0,484,"2021","038"
"33991","CUASSO AL MONTE",26,0,0,26,"2021","058"
"33992","CUCCIAGO",5,0,0,5,"2021","084"
"33993","CUCEGLIO",58,0,0,58,"2021","096"
"33994","CUGGIONO",586,35,0,621,"2021","096"
"33995","CUMIANA",1325,642,0,1967,"2021","097"
"33996","CUMIGNANO SUL NAVIGLIO",1,1328,0,1329,"2021","039"
"33997","CUNARDO",1,0,0,1,"2021","060"
"33998","CUNEO",8352,841,873,10066,"2021","078"
"33999","CUNICO",1823,0,0,1823,"2021","051"
"34000","CUORGNE'",155,48,13,216,"2021","098"
"34001","CURA CARPIGNANO",7,111,3,121,"2021","060"
"34002","CUREGGIO",19,0,26,45,"2021","058"
"34003","CURIGLIA CON MONTEVIASCO",0,0,2,2,"2021","061"
"34004","CURINO",5,0,0,5,"2021","023"
"34005","CURNO",24,40,0,64,"2021","089"
"34006","CURTAROLO",86,199,0,285,"2021","036"
"34007","CURTATONE",2995,1800,659,5454,"2021","021"
"34008","CUSAGO",0,810,3,813,"2021","097"
"34009","CUSINO",9,0,0,9,"2021","085"
"34010","CUSIO",0,1,0,1,"2021","090"
"34011","CUVEGLIO",3,4,0,7,"2021","062"
"34012","CUVIO",2,95,7,104,"2021","063"
"34013","DAIRAGO",7,41,0,48,"2021","099"
"34014","DALMINE",88,111,0,199,"2021","091"
"34015","DARFO BOARIO TERME",9,283,17,309,"2021","065"
"34016","DAVERIO",15,0,0,15,"2021","064"
"34017","DAZIO",0,16,0,16,"2021","025"
"34018","DELEBIO",16,157,36,209,"2021","026"
"34019","DELLO",726,2310,7,3043,"2021","066"
"34020","DEMONTE",981,97,0,1078,"2021","079"
"34021","DENICE",1,0,0,1,"2021","065"
"34022","DERNICE",15,0,2,17,"2021","066"
"34023","DEROVERE",21,272,2,295,"2021","040"
"34024","DERVIO",1,0,0,1,"2021","030"
"34025","DESANA",25,0,0,25,"2021","054"
"34026","DESENZANO DEL GARDA",55,1610,526,2191,"2021","067"
"34027","DESIO",16,0,0,16,"2021",NA
"34028","DIANO D'ALBA",62,0,0,62,"2021","080"
"34029","DIVIGNANO",43,0,0,43,"2021","060"
"34030","DIZZASCO",0,6,0,6,"2021","087"
"34031","DOGLIANI",1734,0,0,1734,"2021","081"
"34032","DOLO",678,297,0,975,"2021","012"
"34033","DOMASO",0,4,2,6,"2021","089"
"34034","DOMODOSSOLA",14,22,13,49,"2021","028"
"34035","DONATO",127,0,35,162,"2021","024"
"34036","DONGO",2,2,6,10,"2021","090"
"34037","DORMELLETTO",4,0,0,4,"2021","062"
"34038","DORNO",15,14,0,29,"2021","061"
"34039","DORZANO",3,0,0,3,"2021","025"
"34040","DOSOLO",0,346,120,466,"2021","022"
"34041","DOSSENA",64,112,4,180,"2021","092"
"34042","DOSSO DEL LIRO",3,2,17,22,"2021","092"
"34043","DOVADOLA",165,0,0,165,"2021","011"
"34044","DOVERA",126,1299,0,1425,"2021","041"
"34045","DOZZA",7,22,0,29,"2021","025"
"34046","DRONERO",2200,243,24,2467,"2021","082"
"34047","DRUENTO",611,33,0,644,"2021","099"
"34048","DRUOGNO",17,4,3,24,"2021","029"
"34049","DUBINO",220,453,17,690,"2021","027"
"34050","DUE CARRARE",188,0,0,188,"2021","106"
"34051","DUEVILLE",395,620,0,1015,"2021","038"
"34052","DUMENZA",3,0,10,13,"2021","065"
"34053","DUNO",1,0,0,1,"2021",NA
"34054","DUSINO SAN MICHELE",332,51,0,383,"2021","052"
"34055","EDOLO",8,72,14,94,"2021","068"
"34056","ELLO",1,0,0,1,"2021","033"
"34057","ELVA",20,0,20,40,"2021","083"
"34058","ENDINE GAIANO",88,97,0,185,"2021","093"
"34059","ENEGO",7,160,0,167,"2021","039"
"34060","ENTRACQUE",247,0,0,247,"2021","084"
"34061","ENTRATICO",23,38,0,61,"2021","094"
"34062","ENVIE",1620,347,221,2188,"2021","085"
"34063","ERACLEA",4009,324,0,4333,"2021","013"
"34064","ERBA",42,378,2,422,"2021","095"
"34065","ERBE'",240,39,0,279,"2021","032"
"34066","ERBEZZO",32,643,0,675,"2021","033"
"34067","ERBUSCO",282,26,0,308,"2021","069"
"34068","ESINE",0,167,14,181,"2021","070"
"34069","ESINO LARIO",4,0,19,23,"2021","035"
"34070","ESTE",668,52,0,720,"2021","037"
"34071","EUPILIO",25,0,53,78,"2021","097"
"34072","EXILLES",1,0,0,1,"2021",NA
"34073","FABBRICA CURONE",3,21,0,24,"2021","067"
"34074","FABBRICO",0,322,0,322,"2021","021"
"34075","FAEDO VALTELLINO",7,27,0,34,"2021","028"
"34076","FAENZA",207,86,0,293,"2021","010"
"34077","FAGGETO LARIO",2,0,5,7,"2021","098"
"34078","FAGNANO OLONA",14,2,0,16,"2021","067"
"34079","FALCADE",5,24,1,30,"2021","019"
"34080","FALOPPIO",2,0,2,4,"2021","099"
"34081","FANANO",29,521,0,550,"2021","011"
"34082","FARA GERA D'ADDA",13,652,0,665,"2021","096"
"34083","FARA NOVARESE",4,0,0,4,"2021","065"
"34084","FARA OLIVANA CON SOLA",44,194,0,238,"2021","097"
"34085","FARA VICENTINO",524,409,106,1039,"2021","040"
"34086","FARIGLIANO",528,0,0,528,"2021","086"
"34087","FARINI",56,89,0,145,"2021","019"
"34088","FARRA DI SOLIGO",56,24,11,91,"2021","026"
"34089","FAULE",46,0,135,181,"2021","087"
"34090","FAVRIA",397,657,88,1142,"2021","101"
"34091","FEISOGLIO",73,0,0,73,"2021","088"
"34092","FELETTO",23,2,0,25,"2021","102"
"34093","FELINO",10,1168,0,1178,"2021","013"
"34094","FELIZZANO",20,0,0,20,"2021","068"
"34095","FELTRE",185,1123,2,1310,"2021","021"
"34096","FENEGRO'",24,5,51,80,"2021","100"
"34097","FENESTRELLE",34,0,0,34,"2021","103"
"34098","FERNO",0,0,9,9,"2021","068"
"34099","FERRARA",209,133,0,342,"2021","008"
"34100","FERRARA DI MONTE BALDO",26,17,1,44,"2021","034"
"34101","FERRERA DI VARESE",16,0,0,16,"2021","069"
"34102","FERRERA ERBOGNONE",23,0,0,23,"2021","062"
"34103","FERRERE",897,0,0,897,"2021","053"
"34104","FERRIERE",113,1,0,114,"2021","020"
"34105","FIANO",18,0,0,18,"2021","104"
"34106","FICAROLO",27,0,0,27,"2021","021"
"34107","FIDENZA",142,4093,0,4235,"2021","014"
"34108","FIESCO",6,690,0,696,"2021","043"
"34109","FIESSE",698,468,283,1449,"2021","071"
"34110","FIESSO D'ARTICO",5,35,0,40,"2021","014"
"34111","FIESSO UMBERTIANO",117,0,0,117,"2021","022"
"34112","FIGINO SERENZA",91,61,1,153,"2021","101"
"34113","FILAGO",133,0,0,133,"2021","098"
"34114","FINALE EMILIA",11,72,0,83,"2021","012"
"34115","FINO DEL MONTE",2,42,0,44,"2021","099"
"34116","FINO MORNASCO",11,0,0,11,"2021","102"
"34117","FIORANO AL SERIO",3,8,0,11,"2021","100"
"34118","FIORANO CANAVESE",17,0,0,17,"2021","105"
"34119","FIORANO MODENESE",8,76,0,84,"2021","013"
"34120","FIORENZUOLA D'ARDA",138,2088,0,2226,"2021","021"
"34121","FISCAGLIA",1643,89,0,1732,"2021",NA
"34122","FIUMALBO",93,54,0,147,"2021","014"
"34123","FLERO",436,214,135,785,"2021","072"
"34124","FOBELLO",11,0,1,12,"2021","057"
"34125","FOGLIZZO",157,0,0,157,"2021","106"
"34126","FOLLINA",306,77,0,383,"2021","027"
"34127","FOMBIO",0,561,0,561,"2021","026"
"34128","FONTANELICE",149,108,1,258,"2021","026"
"34129","FONTANELLA",3340,2152,0,5492,"2021","101"
"34130","FONTANELLATO",27,2272,0,2299,"2021","015"
"34131","FONTANELLE",74,414,4,492,"2021","028"
"34132","FONTANETO D'AGOGNA",8,138,0,146,"2021","066"
"34133","FONTANETTO PO",2,0,0,2,"2021","058"
"34134","FONTANILE",2,0,0,2,"2021","054"
"34135","FONTANIVA",230,355,2,587,"2021","038"
"34136","FONTE",406,624,13,1043,"2021","029"
"34137","FONTENO",11,0,0,11,"2021","102"
"34138","FONTEVIVO",0,1858,0,1858,"2021","016"
"34139","FONZASO",36,53,0,89,"2021","022"
"34140","FOPPOLO",2,12,0,14,"2021","103"
"34141","FORCOLA",15,150,0,165,"2021","029"
"34142","FORESTO SPARSO",19,60,0,79,"2021","104"
"34143","FORLI'",349,75,0,424,"2021","012"
"34144","FORLIMPOPOLI",10,0,0,10,"2021","013"
"34145","FORMAZZA",2,15,3,20,"2021","031"
"34146","FORMIGARA",6,1383,120,1509,"2021","044"
"34147","FORMIGINE",14,1971,0,1985,"2021","015"
"34148","FORMIGLIANA",23,0,0,23,"2021","059"
"34149","FORNO CANAVESE",39,0,0,39,"2021","107"
"34150","FORNOVO DI TARO",11,715,0,726,"2021","017"
"34151","FORNOVO SAN GIOVANNI",34,689,0,723,"2021","105"
"34152","FORTUNAGO",35,0,0,35,"2021","064"
"34153","FOSSALTA DI PIAVE",3,0,0,3,"2021","015"
"34154","FOSSALTA DI PORTOGRUARO",1,776,0,777,"2021","016"
"34155","FOSSANO",19224,4473,1199,24896,"2021","089"
"34156","FOSSO'",124,20,0,144,"2021","017"
"34157","FOZA",45,9,39,93,"2021","041"
"34158","FRABOSA SOPRANA",377,0,179,556,"2021","090"
"34159","FRABOSA SOTTANA",65,39,35,139,"2021","091"
"34160","FRACONALTO",38,0,0,38,"2021","069"
"34161","FRASCAROLO",287,5,0,292,"2021","065"
"34162","FRASSINELLE POLESINE",195,0,0,195,"2021","023"
"34163","FRASSINELLO MONFERRATO",62,0,0,62,"2021","072"
"34164","FRASSINETO PO",40,0,0,40,"2021","073"
"34165","FRASSINETTO",75,4,0,79,"2021","108"
"34166","FRASSINO",17,0,0,17,"2021","092"
"34167","FRASSINORO",75,153,0,228,"2021","016"
"34168","FRATTA POLESINE",354,104,0,458,"2021","024"
"34169","FREGONA",11,28,3,42,"2021","030"
"34170","FRESONARA",18,0,0,18,"2021","074"
"34171","FRINCO",335,0,0,335,"2021","055"
"34172","FRONT",58,0,17,75,"2021","109"
"34173","FROSSASCO",1980,14,107,2101,"2021","110"
"34174","FRUGAROLO",125,137,0,262,"2021","075"
"34175","FUBINE MONFERRATO",228,0,0,228,"2021",NA
"34176","FUIPIANO VALLE IMAGNA",16,44,0,60,"2021","106"
"34177","FUMANE",13,42,0,55,"2021","035"
"34178","FUSIGNANO",2,0,0,2,"2021","011"
"34179","FUSINE",2,52,0,54,"2021","030"
"34180","GABBIONETA-BINANUOVA",29,669,0,698,"2021","045"
"34181","GABIANO",35,0,0,35,"2021","077"
"34182","GADESCO-PIEVE DELMONA",135,573,0,708,"2021","046"
"34183","GAGGIANO",2,523,3,528,"2021","103"
"34184","GAGGIO MONTANO",273,309,0,582,"2021","027"
"34185","GAGLIANICO",1,0,0,1,"2021","026"
"34186","GAIARINE",767,0,0,767,"2021","031"
"34187","GAIBA",10,0,0,10,"2021","025"
"34188","GAIOLA",12,0,0,12,"2021","093"
"34189","GALBIATE",42,14,5,61,"2021","036"
"34190","GALEATA",235,0,6,241,"2021","014"
"34191","GALGAGNANO",0,826,0,826,"2021","027"
"34192","GALLARATE",12,0,18,30,"2021","070"
"34193","GALLIATE",10,87,0,97,"2021","068"
"34194","GALLIATE LOMBARDO",17,0,0,17,"2021","071"
"34195","GALLIERA",0,7,0,7,"2021","028"
"34196","GALLIERA VENETA",3030,143,0,3173,"2021","039"
"34197","GALLIO",3,192,3,198,"2021","042"
"34198","GALZIGNANO TERME",10,0,0,10,"2021","040"
"34199","GAMALERO",13,0,0,13,"2021","078"
"34200","GAMBARA",4975,2929,129,8033,"2021","073"
"34201","GAMBASCA",4,0,0,4,"2021","094"
"34202","GAMBOLO'",87,142,0,229,"2021","068"
"34203","GAMBUGLIANO",0,45,33,78,"2021","044"
"34204","GANDELLINO",18,18,0,36,"2021","107"
"34205","GANDINO",51,167,0,218,"2021","108"
"34206","GANDOSSO",13,0,0,13,"2021","109"
"34207","GARBAGNA",70,0,0,70,"2021","079"
"34208","GARBAGNA NOVARESE",1,0,0,1,"2021","069"
"34209","GARBAGNATE MILANESE",7,0,0,7,"2021",NA
"34210","GARBAGNATE MONASTERO",4,0,0,4,"2021","037"
"34211","GARDONE RIVIERA",2,0,2,4,"2021","074"
"34212","GARDONE VAL TROMPIA",30,0,0,30,"2021","075"
"34213","GARESSIO",204,0,22,226,"2021","095"
"34214","GARGNANO",26,3,7,36,"2021","076"
"34215","GARLASCO",10,2,0,12,"2021","069"
"34216","GARZENO",8,4,20,32,"2021","106"
"34217","GARZIGLIANA",258,0,0,258,"2021","111"
"34218","GASSINO TORINESE",34,0,0,34,"2021","112"
"34219","GATTATICO",8,3062,0,3070,"2021","022"
"34220","GATTEO",3,0,0,3,"2021","016"
"34221","GATTICO-VERUNO",10,264,102,376,"2021",NA
"34222","GATTINARA",76,0,0,76,"2021","061"
"34223","GAVARDO",80,514,54,648,"2021","077"
"34224","GAVELLO",126,0,0,126,"2021",NA
"34225","GAVERINA TERME",11,41,0,52,"2021","110"
"34226","GAVI",16,0,0,16,"2021","081"
"34227","GAVIRATE",44,0,0,44,"2021","072"
"34228","GAZOLDO DEGLI IPPOLITI",603,106,3,712,"2021","024"
"34229","GAZZADA SCHIANNO",5,0,7,12,"2021","073"
"34230","GAZZANIGA",15,39,0,54,"2021","111"
"34231","GAZZO",37,2785,0,2822,"2021","041"
"34232","GAZZO VERONESE",610,260,0,870,"2021","037"
"34233","GAZZOLA",234,1786,0,2020,"2021","022"
"34234","GAZZUOLO",384,25,4,413,"2021","025"
"34235","GEMMANO",20,66,0,86,"2021","004"
"34236","GENIVOLTA",66,1831,36,1933,"2021","047"
"34237","GENOLA",1765,2366,233,4364,"2021","096"
"34238","GERA LARIO",18,264,7,289,"2021","107"
"34239","GERENZANO",111,112,0,223,"2021","075"
"34240","GERMAGNANO",12,0,0,12,"2021","113"
"34241","GERMAGNO",2,0,0,2,"2021","032"
"34242","GERMIGNAGA",8,95,0,103,"2021","076"
"34243","GERRE DE' CAPRIOLI",0,571,0,571,"2021","048"
"34244","GESSATE",10,415,0,425,"2021","106"
"34245","GHEDI",3654,7153,26,10833,"2021","078"
"34246","GHEMME",31,0,14,45,"2021","073"
"34247","GHIFFA",1,0,8,9,"2021","033"
"34248","GHISALBA",1,813,0,814,"2021","113"
"34249","GHISLARENGO",36,0,0,36,"2021","062"
"34250","GIAGLIONE",25,0,0,25,"2021","114"
"34251","GIANICO",51,116,212,379,"2021","079"
"34252","GIAVENO",166,430,149,745,"2021","115"
"34253","GIAVERA DEL MONTELLO",963,116,0,1079,"2021","032"
"34254","GIGNESE",6,0,0,6,"2021","034"
"34255","GIUSSAGO",4,127,0,131,"2021","072"
"34256","GIUSSANO",3,0,0,3,"2021",NA
"34257","GIVOLETTO",26,0,0,26,"2021","116"
"34258","GODEGA DI SANT'URBANO",34,60,29,123,"2021","033"
"34259","GODIASCO",6,0,0,6,"2021","073"
"34260","GOITO",3638,5500,1123,10261,"2021","026"
"34261","GOLASECCA",28,0,0,28,"2021","077"
"34262","GOLFERENZO",0,0,28,28,"2021","074"
"34263","GOMBITO",3,1134,0,1137,"2021","049"
"34264","GONZAGA",16724,4601,4613,25938,"2021","027"
"34265","GORDONA",70,124,39,233,"2021","032"
"34266","GORGO AL MONTICANO",79,267,0,346,"2021","034"
"34267","GORGONZOLA",27,229,0,256,"2021","108"
"34268","GORLA MAGGIORE",3,204,0,207,"2021","078"
"34269","GORLA MINORE",68,0,0,68,"2021","079"
"34270","GORLAGO",80,301,0,381,"2021","114"
"34271","GORLE",2,0,0,2,"2021","115"
"34272","GORNATE-OLONA",16,0,2,18,"2021","080"
"34273","GORNO",13,76,0,89,"2021","116"
"34274","GORZEGNO",73,0,0,73,"2021","097"
"34275","GOSALDO",5,0,0,5,"2021",NA
"34276","GOSSOLENGO",0,729,0,729,"2021","023"
"34277","GOTTASECCA",36,0,0,36,"2021","098"
"34278","GOTTOLENGO",13927,1257,81,15265,"2021","080"
"34279","GOVONE",287,0,0,287,"2021","099"
"34280","GOZZANO",1,0,0,1,"2021","076"
"34281","GRAFFIGNANA",41,269,38,348,"2021","028"
"34282","GRAGLIA",68,21,85,174,"2021","028"
"34283","GRAGNANO TREBBIENSE",17,3990,0,4007,"2021","024"
"34284","GRANA",62,0,0,62,"2021","056"
"34285","GRANAROLO DELL'EMILIA",235,222,0,457,"2021","030"
"34286","GRANDOLA ED UNITI",0,10,46,56,"2021","111"
"34287","GRANOZZO CON MONTICELLO",0,56,0,56,"2021","077"
"34288","GRANTOLA",56,0,0,56,"2021","081"
"34289","GRANTORTO",70,816,0,886,"2021","042"
"34290","GRANZE",876,0,0,876,"2021","043"
"34291","GRASSOBBIO",5,120,0,125,"2021","117"
"34292","GRAVEDONA ED UNITI",6,19,44,69,"2021","249"
"34293","GRAVELLONA LOMELLINA",0,27,9,36,"2021","075"
"34294","GRAVELLONA TOCE",20,0,0,20,"2021","035"
"34295","GRAVERE",8,0,0,8,"2021","117"
"34296","GRAZZANO BADOGLIO",387,0,0,387,"2021","057"
"34297","GREMIASCO",41,0,0,41,"2021","083"
"34298","GREZZANA",105,449,15,569,"2021","038"
"34299","GRIANTE",5,0,9,14,"2021","113"
"34300","GRIGNASCO",13,0,0,13,"2021","079"
"34301","GRINZANE CAVOUR",11,0,0,11,"2021","100"
"34302","GRISIGNANO DI ZOCCO",29,470,0,499,"2021","046"
"34303","GRIZZANA MORANDI",66,0,0,66,"2021","031"
"34304","GROMO",34,88,0,122,"2021","118"
"34305","GRONDONA",6,0,0,6,"2021","085"
"34306","GRONE",15,25,0,40,"2021","119"
"34307","GRONTARDO",149,2079,0,2228,"2021","050"
"34308","GROPELLO CAIROLI",32,0,0,32,"2021","076"
"34309","GROPPARELLO",91,16,0,107,"2021","025"
"34310","GROSCAVALLO",8,0,0,8,"2021","118"
"34311","GROSIO",18,214,1,233,"2021","033"
"34312","GROSOTTO",6,72,3,81,"2021","034"
"34313","GROSSO",41,0,0,41,"2021","119"
"34314","GRUARO",12,163,0,175,"2021","018"
"34315","GRUGLIASCO",77,0,50,127,"2021","120"
"34316","GRUMELLO CREMONESE ED UNITI",247,2182,1,2430,"2021","051"
"34317","GRUMELLO DEL MONTE",26,105,0,131,"2021","120"
"34318","GRUMOLO DELLE ABBADESSE",23,184,0,207,"2021","047"
"34319","GUALTIERI",1337,473,0,1810,"2021","023"
"34320","GUANZATE",9,0,14,23,"2021","114"
"34321","GUARDA VENETA",675,0,0,675,"2021","028"
"34322","GUARDABOSONE",54,7,0,61,"2021","066"
"34323","GUARDAMIGLIO",6,543,21,570,"2021","029"
"34324","GUARENE",269,0,0,269,"2021","101"
"34325","GUASTALLA",30,1184,3,1217,"2021","024"
"34326","GUDO VISCONTI",10,0,2,12,"2021","112"
"34327","GUIDIZZOLO",1333,797,316,2446,"2021","028"
"34328","GUIGLIA",6,540,0,546,"2021","017"
"34329","GUSSAGO",30,1037,136,1203,"2021","081"
"34330","GUSSOLA",0,53,11,64,"2021","052"
"34331","IDRO",2,0,8,10,"2021","082"
"34332","IGLIANO",59,0,25,84,"2021","102"
"34333","ILLASI",11,44,0,55,"2021","039"
"34334","IMBERSAGO",0,0,1,1,"2021","039"
"34335","IMOLA",83,0,0,83,"2021","032"
"34336","INARZO",15,0,0,15,"2021","082"
"34337","INCISA SCAPACCINO",37,0,0,37,"2021","058"
"34338","INCUDINE",0,0,3,3,"2021","083"
"34339","INDUNO OLONA",25,112,0,137,"2021","083"
"34340","INTROBIO",8,17,105,130,"2021","040"
"34341","INVERIGO",130,0,36,166,"2021","118"
"34342","INVERNO E MONTELEONE",63,190,28,281,"2021","077"
"34343","INVERSO PINASCA",37,0,0,37,"2021","122"
"34344","INVERUNO",2,47,16,65,"2021","113"
"34345","INVORIO",57,58,0,115,"2021","082"
"34346","INZAGO",305,609,80,994,"2021","114"
"34347","IRMA",9,0,0,9,"2021","084"
"34348","ISASCA",14,0,0,14,"2021","103"
"34349","ISEO",27,30,0,57,"2021","085"
"34350","ISOLA D'ASTI",453,0,0,453,"2021","059"
"34351","ISOLA DELLA SCALA",6712,449,0,7161,"2021","040"
"34352","ISOLA DI FONDRA",3,28,0,31,"2021","121"
"34353","ISOLA DOVARESE",0,619,0,619,"2021","053"
"34354","ISOLA RIZZA",2182,412,0,2594,"2021","041"
"34355","ISOLA VICENTINA",1956,696,25,2677,"2021","048"
"34356","ISOLABELLA",24,480,0,504,"2021","123"
"34357","ISORELLA",10979,404,6,11389,"2021","086"
"34358","ISPRA",55,214,0,269,"2021","084"
"34359","ISSIGLIO",88,26,17,131,"2021","124"
"34360","ISSO",13,1087,0,1100,"2021","122"
"34361","ISTRANA",2353,356,11,2720,"2021","035"
"34362","IVREA",316,208,18,542,"2021","125"
"34363","IZANO",2,1021,0,1023,"2021","054"
"34364","JERAGO CON ORAGO",2,0,0,2,"2021","085"
"34365","JESOLO",3,83,0,86,"2021",NA
"34366","JOLANDA DI SAVOIA",4233,0,0,4233,"2021","010"
"34367","LA CASSA",1,259,0,260,"2021","126"
"34368","LA LOGGIA",195,0,110,305,"2021","127"
"34369","LA MORRA",38,0,0,38,"2021","105"
"34370","LA VALLE AGORDINA",10,21,5,36,"2021","027"
"34371","LA VALLETTA BRIANZA",12,15,3,30,"2021",NA
"34372","LACCHIARELLA",31,42,0,73,"2021","115"
"34373","LAGNASCO",29,0,82,111,"2021","104"
"34374","LAGOSANTO",38,0,0,38,"2021","011"
"34375","LAINATE",8,0,0,8,"2021","116"
"34376","LAINO",4,1,0,5,"2021","120"
"34377","LAMA MOCOGNO",54,389,0,443,"2021","018"
"34378","LAMBRUGO",0,115,0,115,"2021","121"
"34379","LAMON",7,40,0,47,"2021","026"
"34380","LAMPORO",25,0,0,25,"2021","067"
"34381","LANDRIANO",5,230,0,235,"2021","078"
"34382","LANGHIRANO",0,916,15,931,"2021","018"
"34383","LANGOSCO",2,0,0,2,"2021","079"
"34384","LANZADA",23,61,7,91,"2021","036"
"34385","LANZO TORINESE",129,0,12,141,"2021","128"
"34386","LASNIGO",0,26,0,26,"2021","123"
"34387","LASTEBASSE",1,0,0,1,"2021",NA
"34388","LAURIANO",22,0,0,22,"2021","129"
"34389","LAVENA PONTE TRESA",2,0,0,2,"2021","086"
"34390","LAVENONE",19,0,1,20,"2021","087"
"34391","LAZISE",22,6,0,28,"2021","043"
"34392","LAZZATE",0,0,13,13,"2021",NA
"34393","LECCO",16,28,12,56,"2021","042"
"34394","LEFFE",13,109,0,122,"2021","124"
"34395","LEGGIUNO",3,0,0,3,"2021","088"
"34396","LEGNAGO",80,24,105,209,"2021","044"
"34397","LEGNANO",0,78,0,78,"2021","118"
"34398","LEGNARO",199,50,0,249,"2021","044"
"34399","LEINI'",816,594,103,1513,"2021","130"
"34400","LEMIE",8,0,0,8,"2021","131"
"34401","LENDINARA",587,125,0,712,"2021","029"
"34402","LENNA",4,9,0,13,"2021","125"
"34403","LENO",5163,7477,933,13573,"2021","088"
"34404","LENTA",0,10,0,10,"2021","068"
"34405","LENTATE SUL SEVESO",0,200,7,207,"2021",NA
"34406","LEQUIO BERRIA",17,0,0,17,"2021","106"
"34407","LEQUIO TANARO",1988,0,0,1988,"2021","107"
"34408","LERMA",1,0,0,1,"2021","088"
"34409","LESA",2,0,0,2,"2021","084"
"34410","LESEGNO",1431,0,0,1431,"2021","108"
"34411","LESIGNANO DE' BAGNI",36,1532,0,1568,"2021","019"
"34412","LESMO",4,197,2,203,"2021",NA
"34413","LESSOLO",104,8,0,112,"2021","132"
"34414","LESSONA",12,0,0,12,"2021","029"
"34415","LEVICE",57,0,0,57,"2021","109"
"34416","LEZZENO",0,0,3,3,"2021","126"
"34417","LIERNA",4,4,2,10,"2021","043"
"34418","LIGNANA",1,0,0,1,"2021","070"
"34419","LIMANA",66,118,0,184,"2021","029"
"34420","LIMENA",257,639,49,945,"2021","045"
"34421","LIMIDO COMASCO",2,25,0,27,"2021","128"
"34422","LIMONE PIEMONTE",33,0,0,33,"2021","110"
"34423","LINAROLO",13,365,0,378,"2021","081"
"34424","LIPOMO",1,0,0,1,"2021",NA
"34425","LIRIO",39,0,0,39,"2021","082"
"34426","LISCATE",4,0,0,4,"2021","122"
"34427","LISIO",49,0,0,49,"2021","111"
"34428","LISSONE",265,0,0,265,"2021",NA
"34429","LIVIGNO",60,295,1,356,"2021","037"
"34430","LIVINALLONGO DEL COL DI LANA",7,58,0,65,"2021","030"
"34431","LIVO",2,6,0,8,"2021","130"
"34432","LIVORNO FERRARIS",2,64,0,66,"2021","071"
"34433","LIVRAGA",55,1038,103,1196,"2021","030"
"34434","LIZZANO IN BELVEDERE",13,83,21,117,"2021","033"
"34435","LOAZZOLO",4,0,1,5,"2021","060"
"34436","LOCANA",122,35,0,157,"2021","134"
"34437","LOCATE DI TRIULZI",0,1058,5,1063,"2021","125"
"34438","LOCATE VARESINO",11,7,0,18,"2021","131"
"34439","LOCATELLO",31,20,0,51,"2021","127"
"34440","LODI",764,1563,11,2338,"2021","031"
"34441","LODI VECCHIO",1,1477,0,1478,"2021","032"
"34442","LODRINO",9,8,0,17,"2021","090"
"34443","LOGRATO",1324,726,13,2063,"2021","091"
"34444","LOIANO",47,209,0,256,"2021","034"
"34445","LOMAGNA",3,0,0,3,"2021","044"
"34446","LOMAZZO",1,0,0,1,"2021","133"
"34447","LOMBARDORE",72,7,0,79,"2021","135"
"34448","LOMBRIASCO",85,132,0,217,"2021","136"
"34449","LOMELLO",25,176,0,201,"2021","083"
"34450","LONATE CEPPINO",1,257,0,258,"2021","089"
"34451","LONATE POZZOLO",6,0,6,12,"2021","090"
"34452","LONATO DEL GARDA",2526,5336,606,8468,"2021",NA
"34453","LONGARE",66,166,0,232,"2021","051"
"34454","LONGARONE",16,0,0,16,"2021","031"
"34455","LONGHENA",0,410,0,410,"2021","093"
"34456","LONGIANO",20,0,0,20,"2021","018"
"34457","LONIGO",5154,450,0,5604,"2021","052"
"34458","LORANZE'",32,0,0,32,"2021","137"
"34459","LOREGGIA",259,415,0,674,"2021","046"
"34460","LOREGLIA",5,0,0,5,"2021","038"
"34461","LORENZAGO DI CADORE",0,3,0,3,"2021","032"
"34462","LOREO",1014,56,0,1070,"2021","030"
"34463","LORIA",6531,24,0,6555,"2021","036"
"34464","LOSINE",0,5,0,5,"2021","094"
"34465","LOVERE",3,47,0,50,"2021","128"
"34466","LOVERO",4,5,0,9,"2021","038"
"34467","LOZIO",0,5,0,5,"2021","095"
"34468","LOZZA",0,108,0,108,"2021","091"
"34469","LOZZO ATESTINO",958,1,0,959,"2021","047"
"34470","LU E CUCCARO MONFERRATO",65,0,0,65,"2021",NA
"34471","LUGAGNANO VAL D'ARDA",45,150,0,195,"2021","026"
"34472","LUGO",454,70,0,524,"2021","012"
"34473","LUGO DI VICENZA",18,110,0,128,"2021","053"
"34474","LUINO",3,17,0,20,"2021","092"
"34475","LUISAGO",3,0,11,14,"2021","135"
"34476","LUMEZZANE",15,0,0,15,"2021","096"
"34477","LURAGO D'ERBA",2,0,8,10,"2021","136"
"34478","LURAGO MARINONE",0,180,0,180,"2021","137"
"34479","LURANO",32,11,0,43,"2021","129"
"34480","LURATE CACCIVIO",26,122,0,148,"2021","138"
"34481","LUSERNA SAN GIOVANNI",420,62,55,537,"2021","139"
"34482","LUSERNETTA",75,0,0,75,"2021","140"
"34483","LUSIA",19,0,0,19,"2021","031"
"34484","LUSIANA CONCO",29,262,8,299,"2021",NA
"34485","LUSIGLIE'",101,0,0,101,"2021","141"
"34486","LUZZANA",18,0,0,18,"2021","130"
"34487","LUZZARA",1756,1416,0,3172,"2021","026"
"34488","MACCAGNO CON PINO E VEDDASCA",0,25,0,25,"2021",NA
"34489","MACCASTORNA",0,41,589,630,"2021","033"
"34490","MACELLO",1470,367,146,1983,"2021","142"
"34491","MACLODIO",20,208,0,228,"2021","097"
"34492","MACRA",2,0,0,2,"2021",NA
"34493","MACUGNAGA",4,9,0,13,"2021","039"
"34494","MADESIMO",0,8,0,8,"2021","035"
"34495","MADIGNANO",89,806,0,895,"2021","055"
"34496","MADONE",10,0,0,10,"2021","131"
"34497","MADONNA DEL SASSO",24,0,0,24,"2021","040"
"34498","MAGASA",6,14,0,20,"2021","098"
"34499","MAGENTA",37,812,16,865,"2021","130"
"34500","MAGGIORA",96,60,0,156,"2021","088"
"34501","MAGHERNO",0,129,0,129,"2021","085"
"34502","MAGLIANO ALFIERI",383,0,0,383,"2021","113"
"34503","MAGLIANO ALPI",481,99,0,580,"2021","114"
"34504","MAGNACAVALLO",9,266,580,855,"2021","029"
"34505","MAGNAGO",55,0,0,55,"2021","131"
"34506","MAGNANO",36,6,0,42,"2021","030"
"34507","MAIOLO",125,0,0,125,"2021","022"
"34508","MAIRAGO",0,396,0,396,"2021","034"
"34509","MAIRANO",11,584,0,595,"2021","099"
"34510","MALAGNINO",190,682,0,872,"2021","056"
"34511","MALCESINE",13,91,0,104,"2021","045"
"34512","MALEGNO",23,25,6,54,"2021","100"
"34513","MALEO",178,1394,0,1572,"2021","035"
"34514","MALESCO",22,0,5,27,"2021","041"
"34515","MALGESSO",80,0,0,80,"2021","095"
"34516","MALNATE",32,61,0,93,"2021","096"
"34517","MALO",2083,215,0,2298,"2021","055"
"34518","MALONNO",17,170,52,239,"2021","101"
"34519","MALVICINO",6,0,0,6,"2021","090"
"34520","MANDELLO DEL LARIO",7,0,9,16,"2021","046"
"34521","MANDELLO VITTA",1,0,0,1,"2021","090"
"34522","MANERBA DEL GARDA",13,0,8,21,"2021","102"
"34523","MANERBIO",855,1145,0,2000,"2021","103"
"34524","MANGO",7,0,0,7,"2021","115"
"34525","MANSUE'",52,201,9,262,"2021","037"
"34526","MANTELLO",2,138,0,140,"2021","039"
"34527","MANTOVA",685,873,148,1706,"2021","030"
"34528","MAPELLO",6,0,27,33,"2021","132"
"34529","MARANELLO",47,523,0,570,"2021","019"
"34530","MARANO DI VALPOLICELLA",11,53,18,82,"2021","046"
"34531","MARANO SUL PANARO",36,779,0,815,"2021","020"
"34532","MARANO TICINO",2,233,0,235,"2021","091"
"34533","MARANO VICENTINO",234,298,35,567,"2021","056"
"34534","MARCALLO CON CASONE",0,348,0,348,"2021","134"
"34535","MARCARIA",3164,3310,359,6833,"2021","031"
"34536","MARCHENO",5,19,0,24,"2021","104"
"34537","MARCIGNAGO",1,0,0,1,"2021","086"
"34538","MARCON",511,9,0,520,"2021","020"
"34539","MARENE",3459,2179,104,5742,"2021","117"
"34540","MARENO DI PIAVE",1141,130,4,1275,"2021","038"
"34541","MARENTINO",88,0,0,88,"2021","144"
"34542","MARETTO",212,0,0,212,"2021","062"
"34543","MARGARITA",836,0,0,836,"2021","118"
"34544","MARGNO",2,8,1,11,"2021","047"
"34545","MARIANA MANTOVANA",105,360,63,528,"2021","032"
"34546","MARIANO COMENSE",797,39,4,840,"2021","143"
"34547","MARMENTINO",6,29,6,41,"2021","105"
"34548","MARMIROLO",3311,3088,2823,9222,"2021","033"
"34549","MARMORA",0,0,112,112,"2021","119"
"34550","MARONE",27,0,16,43,"2021","106"
"34551","MAROSTICA",102,493,13,608,"2021","057"
"34552","MARSAGLIA",93,0,0,93,"2021","120"
"34553","MARTELLAGO",25,20,0,45,"2021","021"
"34554","MARTINENGO",218,2635,0,2853,"2021","133"
"34555","MARTINIANA PO",171,0,41,212,"2021","121"
"34556","MARUDO",1,126,0,127,"2021","036"
"34557","MARZABOTTO",22,101,0,123,"2021","036"
"34558","MARZANO",131,348,0,479,"2021","087"
"34559","MARZIO",3,0,3,6,"2021","099"
"34560","MASATE",119,66,0,185,"2021","136"
"34561","MASCIAGO PRIMO",55,0,0,55,"2021","100"
"34562","MASER",3962,33,0,3995,"2021","039"
"34563","MASERA",55,10,2,67,"2021","042"
"34564","MASERA' DI PADOVA",236,149,0,385,"2021","048"
"34565","MASERADA SUL PIAVE",2447,115,11,2573,"2021","040"
"34566","MASI",92,0,0,92,"2021","049"
"34567","MASI TORELLO",4,91,0,95,"2021","012"
"34568","MASIO",1022,0,0,1022,"2021","091"
"34569","MASSA LOMBARDA",18,0,0,18,"2021","013"
"34570","MASSALENGO",0,123,0,123,"2021","037"
"34571","MASSANZAGO",563,162,0,725,"2021","050"
"34572","MASSAZZA",34,0,0,34,"2021","031"
"34573","MASSELLO",10,0,0,10,"2021","145"
"34574","MASSERANO",45,0,0,45,"2021","032"
"34575","MASSINO VISCONTI",8,0,0,8,"2021","093"
"34576","MASSIOLA",4,0,0,4,"2021","043"
"34577","MATHI",203,0,96,299,"2021","146"
"34578","MATTIE",2,0,9,11,"2021","147"
"34579","MAZZANO",56,473,282,811,"2021","107"
"34580","MAZZE'",972,2,2,976,"2021","148"
"34581","MAZZO DI VALTELLINA",8,31,4,43,"2021","040"
"34582","MEANA DI SUSA",2,0,0,2,"2021","149"
"34583","MEDA",1,0,0,1,"2021",NA
"34584","MEDE",39,0,0,39,"2021","088"
"34585","MEDESANO",146,1444,0,1590,"2021","020"
"34586","MEDICINA",20,116,0,136,"2021","037"
"34587","MEDIGLIA",9,1597,10,1616,"2021","139"
"34588","MEDOLAGO",10,0,0,10,"2021","250"
"34589","MEDOLE",404,1891,402,2697,"2021","034"
"34590","MEDOLLA",0,523,0,523,"2021","021"
"34591","MEDUNA DI LIVENZA",15,13,0,28,"2021","041"
"34592","MEGLIADINO SAN VITALE",2415,0,0,2415,"2021","052"
"34593","MELAZZO",149,0,0,149,"2021","092"
"34594","MELDOLA",146,0,0,146,"2021","019"
"34595","MELEGNANO",0,190,0,190,"2021","140"
"34596","MELETI",126,138,2,266,"2021","038"
"34597","MELLE",258,0,33,291,"2021","122"
"34598","MELLO",24,33,2,59,"2021","041"
"34599","MELZO",0,306,13,319,"2021","142"
"34600","MENAGGIO",5,0,0,5,"2021","145"
"34601","MENCONICO",17,0,0,17,"2021","089"
"34602","MEOLO",537,129,0,666,"2021","022"
"34603","MERANA",30,0,0,30,"2021","093"
"34604","MERATE",33,269,4,306,"2021","048"
"34605","MERCATO SARACENO",186,18,0,204,"2021","020"
"34606","MERCENASCO",331,0,0,331,"2021","150"
"34607","MERGOZZO",22,0,0,22,"2021","044"
"34608","MERLARA",837,0,0,837,"2021","053"
"34609","MERLINO",0,1300,0,1300,"2021","039"
"34610","MERONE",27,23,0,50,"2021","147"
"34611","MESE",27,35,33,95,"2021","043"
"34612","MESENZANA",0,24,0,24,"2021","102"
"34613","MESERO",1,50,0,51,"2021","144"
"34614","MESOLA",943,259,0,1202,"2021","014"
"34615","MESTRINO",147,70,0,217,"2021","054"
"34616","MEZZANA BIGLI",82,0,0,82,"2021","090"
"34617","MEZZANE DI SOTTO",0,20,0,20,"2021","047"
"34618","MEZZENILE",44,0,17,61,"2021","152"
"34619","MEZZOLDO",0,20,0,20,"2021","134"
"34620","MEZZOMERICO",14,0,0,14,"2021","097"
"34621","MIAGLIANO",5,0,0,5,"2021","034"
"34622","MIANE",6,8,0,14,"2021","042"
"34623","MIASINO",0,0,29,29,"2021","098"
"34624","MIAZZINA",1,0,0,1,"2021","045"
"34625","MILANO",336,102,150,588,"2021","146"
"34626","MILZANO",1,964,0,965,"2021","108"
"34627","MINERBE",1836,172,148,2156,"2021","048"
"34628","MINERBIO",34,0,0,34,"2021","038"
"34629","MIRA",2344,248,9,2601,"2021","023"
"34630","MIRABELLO MONFERRATO",74,0,0,74,"2021","094"
"34631","MIRADOLO TERME",8,0,54,62,"2021","093"
"34632","MIRANDOLA",349,1401,0,1750,"2021","022"
"34633","MIRANO",1160,754,0,1914,"2021","024"
"34634","MISANO ADRIATICO",7,0,0,7,"2021","005"
"34635","MISANO DI GERA D'ADDA",11,244,3,258,"2021","135"
"34636","MISSAGLIA",11,498,3,512,"2021","049"
"34637","MODENA",49,2123,0,2172,"2021","023"
"34638","MODIGLIANA",78,0,0,78,"2021","022"
"34639","MOGLIA",4671,1305,946,6922,"2021","035"
"34640","MOGLIANO VENETO",1241,363,162,1766,"2021","043"
"34641","MOIO DE' CALVI",3,9,0,12,"2021","136"
"34642","MOIOLA",12,0,28,40,"2021","123"
"34643","MOLINELLA",2110,280,0,2390,"2021","039"
"34644","MOLLIA",7,0,0,7,"2021","078"
"34645","MOLTENO",7,24,3,34,"2021","051"
"34646","MOMBALDONE",46,0,1,47,"2021","064"
"34647","MOMBARCARO",101,0,0,101,"2021","124"
"34648","MOMBARUZZO",4,0,0,4,"2021","065"
"34649","MOMBASIGLIO",86,0,0,86,"2021","125"
"34650","MOMBELLO DI TORINO",41,0,0,41,"2021","153"
"34651","MOMBELLO MONFERRATO",8,0,0,8,"2021","097"
"34652","MOMBERCELLI",48,0,0,48,"2021","066"
"34653","MOMO",188,492,12,692,"2021","100"
"34654","MOMPERONE",2,0,0,2,"2021","098"
"34655","MONALE",20,0,0,20,"2021","067"
"34656","MONASTERO BORMIDA",380,0,0,380,"2021","068"
"34657","MONASTERO DI LANZO",7,0,1,8,"2021","155"
"34658","MONASTERO DI VASCO",425,0,47,472,"2021","126"
"34659","MONASTEROLO CASOTTO",23,0,0,23,"2021","127"
"34660","MONASTEROLO DEL CASTELLO",6,27,0,33,"2021","137"
"34661","MONASTEROLO DI SAVIGLIANO",512,256,111,879,"2021","128"
"34662","MONASTIER DI TREVISO",1980,43,57,2080,"2021","044"
"34663","MONCALIERI",138,418,0,556,"2021","156"
"34664","MONCALVO",107,0,0,107,"2021","069"
"34665","MONCENISIO",4,0,0,4,"2021","157"
"34666","MONCHIERO",201,0,0,201,"2021","129"
"34667","MONCHIO DELLE CORTI",28,166,0,194,"2021","022"
"34668","MONCRIVELLO",78,237,0,315,"2021","079"
"34669","MONCUCCO TORINESE",51,0,0,51,"2021","070"
"34670","MONDAINO",2,0,0,2,"2021","006"
"34671","MONDOVI'",5706,13,366,6085,"2021","130"
"34672","MONESIGLIO",86,0,0,86,"2021","131"
"34673","MONFORTE D'ALBA",263,0,0,263,"2021","132"
"34674","MONFUMO",25,180,4,209,"2021","045"
"34675","MONGARDINO",25,0,0,25,"2021","071"
"34676","MONGHIDORO",30,92,0,122,"2021","040"
"34677","MONGIARDINO LIGURE",37,0,17,54,"2021","100"
"34678","MONGRANDO",111,137,0,248,"2021","035"
"34679","MONGUZZO",10,0,0,10,"2021","153"
"34680","MONNO",5,49,6,60,"2021","110"
"34681","MONSELICE",209,51,0,260,"2021","055"
"34682","MONTA'",281,0,0,281,"2021","133"
"34683","MONTABONE",58,0,0,58,"2021","072"
"34684","MONTACUTO",2,0,0,2,"2021","102"
"34685","MONTAFIA",26,0,0,26,"2021","073"
"34686","MONTAGNA IN VALTELLINA",17,82,0,99,"2021","044"
"34687","MONTAGNANA",1693,0,19,1712,"2021","056"
"34688","MONTALDO DI MONDOVI'",98,0,15,113,"2021","134"
"34689","MONTALDO SCARAMPI",30,0,0,30,"2021","074"
"34690","MONTALDO TORINESE",622,0,0,622,"2021","158"
"34691","MONTALENGHE",2,0,0,2,"2021","159"
"34692","MONTALTO DORA",33,0,0,33,"2021","160"
"34693","MONTALTO PAVESE",77,0,0,77,"2021","094"
"34694","MONTANARO",212,142,0,354,"2021","161"
"34695","MONTANASO LOMBARDO",81,959,0,1040,"2021","040"
"34696","MONTANERA",2009,981,124,3114,"2021","136"
"34697","MONTANO LUCINO",6,0,13,19,"2021","154"
"34698","MONTE CREMASCO",246,119,0,365,"2021","058"
"34699","MONTE DI MALO",585,108,0,693,"2021","063"
"34700","MONTE ISOLA",23,0,0,23,"2021","111"
"34701","MONTE MARENZO",6,0,0,6,"2021","052"
"34702","MONTE SAN PIETRO",106,209,0,315,"2021","042"
"34703","MONTEBELLO DELLA BATTAGLIA",0,24,0,24,"2021","095"
"34704","MONTEBELLO VICENTINO",342,0,6,348,"2021","060"
"34705","MONTEBELLUNA",3965,568,3,4536,"2021","046"
"34706","MONTECALVO VERSIGGIA",1,0,0,1,"2021",NA
"34707","MONTECCHIA DI CROSARA",3,4,0,7,"2021","049"
"34708","MONTECCHIO EMILIA",3,1711,0,1714,"2021","027"
"34709","MONTECCHIO MAGGIORE",139,42,0,181,"2021","061"
"34710","MONTECCHIO PRECALCINO",188,159,0,347,"2021","062"
"34711","MONTECHIARO D'ACQUI",62,0,0,62,"2021","106"
"34712","MONTECHIARO D'ASTI",354,0,0,354,"2021","075"
"34713","MONTECHIARUGOLO",23,3518,0,3541,"2021","023"
"34714","MONTECRESTESE",93,24,11,128,"2021","046"
"34715","MONTECRETO",13,590,0,603,"2021","024"
"34716","MONTEFIORE CONCA",21,1,0,22,"2021","008"
"34717","MONTEFIORINO",44,311,0,355,"2021","025"
"34718","MONTEFORTE D'ALPONE",813,2,0,815,"2021","050"
"34719","MONTEGALDA",39,279,0,318,"2021","064"
"34720","MONTEGALDELLA",14,396,1,411,"2021","065"
"34721","MONTEGIOCO",19,0,0,19,"2021","107"
"34722","MONTEGRIDOLFO",2,0,0,2,"2021","009"
"34723","MONTEGRINO VALTRAVAGLIA",5,0,0,5,"2021","103"
"34724","MONTEGROSSO D'ASTI",21,0,0,21,"2021","076"
"34725","MONTEGROTTO TERME",6,21,0,27,"2021","057"
"34726","MONTELUPO ALBESE",87,0,0,87,"2021","137"
"34727","MONTEMAGNO",93,0,0,93,"2021","077"
"34728","MONTEMALE DI CUNEO",191,0,0,191,"2021","138"
"34729","MONTERENZIO",323,190,0,513,"2021","041"
"34730","MONTEROSSO GRANA",6,102,0,108,"2021","139"
"34731","MONTESCANO",1,0,0,1,"2021","097"
"34732","MONTESCUDO-MONTE COLOMBO",207,0,0,207,"2021",NA
"34733","MONTESE",100,1337,0,1437,"2021","026"
"34734","MONTESEGALE",7,0,0,7,"2021","098"
"34735","MONTEU DA PO",94,0,0,94,"2021","162"
"34736","MONTEU ROERO",468,0,0,468,"2021","140"
"34737","MONTEVECCHIA",9,0,0,9,"2021","053"
"34738","MONTEVIALE",60,0,0,60,"2021","066"
"34739","MONTEZEMOLO",29,0,0,29,"2021","141"
"34740","MONTICELLI BRUSATI",15,227,5,247,"2021","112"
"34741","MONTICELLI D'ONGINA",245,753,0,998,"2021","027"
"34742","MONTICELLI PAVESE",1446,507,0,1953,"2021","099"
"34743","MONTICELLO BRIANZA",18,0,132,150,"2021","054"
"34744","MONTICELLO CONTE OTTO",213,736,38,987,"2021","067"
"34745","MONTICELLO D'ALBA",76,0,0,76,"2021","142"
"34746","MONTICHIARI",9779,7701,58,17538,"2021","113"
"34747","MONTIGLIO MONFERRATO",182,0,0,182,"2021","121"
"34748","MONTIRONE",4001,263,0,4264,"2021","114"
"34749","MONTODINE",73,1145,0,1218,"2021","059"
"34750","MONTORFANO",1,0,0,1,"2021","157"
"34751","MONTORSO VICENTINO",682,124,5,811,"2021","068"
"34752","MONTU' BECCARIA",1,0,0,1,"2021","100"
"34753","MONVALLE",18,0,0,18,"2021","104"
"34754","MONZA",50,46,0,96,"2021",NA
"34755","MONZAMBANO",1308,673,200,2181,"2021","036"
"34756","MONZUNO",41,33,0,74,"2021","044"
"34757","MORANO SUL PO",2,0,0,2,"2021","109"
"34758","MORANSENGO",224,0,0,224,"2021","079"
"34759","MORAZZONE",13,82,32,127,"2021","105"
"34760","MORBEGNO",15,86,1,102,"2021","045"
"34761","MORBELLO",1,0,0,1,"2021","110"
"34762","MORENGO",53,48,0,101,"2021","140"
"34763","MORETTA",2005,447,186,2638,"2021","143"
"34764","MORFASSO",135,8,0,143,"2021","028"
"34765","MORGANO",1884,5,0,1889,"2021","047"
"34766","MORIAGO DELLA BATTAGLIA",2021,72,0,2093,"2021","048"
"34767","MORIMONDO",49,1702,0,1751,"2021","150"
"34768","MORIONDO TORINESE",327,0,0,327,"2021","163"
"34769","MORNAGO",22,0,0,22,"2021","106"
"34770","MORNESE",37,0,0,37,"2021","111"
"34771","MORNICO AL SERIO",407,599,6,1012,"2021","141"
"34772","MORNICO LOSANA",16,0,0,16,"2021","101"
"34773","MOROZZO",2383,568,375,3326,"2021","144"
"34774","MORSASCO",120,0,0,120,"2021","112"
"34775","MORTARA",41,0,0,41,"2021","102"
"34776","MORTERONE",2,0,35,37,"2021","055"
"34777","MOSCAZZANO",0,1500,0,1500,"2021","060"
"34778","MOTTA BALUFFI",5,85,0,90,"2021","061"
"34779","MOTTA DI LIVENZA",18,18,0,36,"2021","049"
"34780","MOTTA VISCONTI",3,0,0,3,"2021","151"
"34781","MOTTALCIATA",88,53,0,141,"2021","037"
"34782","MOTTEGGIANA",28,1322,726,2076,"2021","037"
"34783","MOZZANICA",118,603,0,721,"2021","142"
"34784","MOZZATE",13,98,0,111,"2021","159"
"34785","MOZZECANE",3455,1262,0,4717,"2021","051"
"34786","MUGGIÒ",7,0,0,7,"2021",NA
"34787","MULAZZANO",10,999,0,1009,"2021","041"
"34788","MURA",23,11,11,45,"2021","115"
"34789","MURAZZANO",277,0,7,284,"2021","145"
"34790","MURELLO",411,1300,191,1902,"2021","146"
"34791","MURISENGO",333,0,0,333,"2021","113"
"34792","MUSCOLINE",59,573,10,642,"2021","116"
"34793","MUSILE DI PIAVE",22,8,0,30,"2021","025"
"34794","MUSSO",4,0,5,9,"2021","160"
"34795","MUSSOLENTE",234,196,0,430,"2021","070"
"34796","MUZZANO",29,0,1,30,"2021","038"
"34797","NANTO",271,223,0,494,"2021","071"
"34798","NARZOLE",1695,161,0,1856,"2021","147"
"34799","NAVE",29,181,40,250,"2021","117"
"34800","NEBBIUNO",34,0,26,60,"2021","103"
"34801","NEGRAR",9,65,0,74,"2021","052"
"34802","NEIVE",21,0,0,21,"2021","148"
"34803","NEMBRO",44,6,0,50,"2021","144"
"34804","NERVESA DELLA BATTAGLIA",578,182,32,792,"2021","050"
"34805","NERVIANO",6,136,15,157,"2021","154"
"34806","NESSO",0,6,0,6,"2021","161"
"34807","NETRO",93,47,10,150,"2021","039"
"34808","NEVIANO DEGLI ARDUINI",42,1987,0,2029,"2021","024"
"34809","NIARDO",38,122,23,183,"2021","118"
"34810","NIBIONNO",2,0,0,2,"2021","056"
"34811","NICHELINO",27,0,17,44,"2021","164"
"34812","NICORVO",1,0,0,1,"2021","103"
"34813","NIELLA BELBO",127,0,0,127,"2021","150"
"34814","NIELLA TANARO",684,0,0,684,"2021","151"
"34815","NIZZA MONFERRATO",55,3,0,58,"2021","080"
"34816","NOALE",378,71,6,455,"2021","026"
"34817","NOASCA",0,0,28,28,"2021","165"
"34818","NOCETO",35,3688,0,3723,"2021","025"
"34819","NOGARA",2980,395,0,3375,"2021","053"
"34820","NOGAROLE ROCCA",311,328,0,639,"2021","054"
"34821","NOGAROLE VICENTINO",11,16,0,27,"2021","072"
"34822","NOLE",212,41,132,385,"2021","166"
"34823","NONANTOLA",9,149,0,158,"2021","027"
"34824","NONE",901,1272,289,2462,"2021","168"
"34825","NONIO",16,0,0,16,"2021",NA
"34826","NOSATE",12,0,0,12,"2021","155"
"34827","NOVA MILANESE",0,76,0,76,"2021",NA
"34828","NOVAFELTRIA",1075,226,0,1301,"2021","023"
"34829","NOVALESA",50,16,2,68,"2021","169"
"34830","NOVARA",46,300,0,346,"2021","106"
"34831","NOVATE MEZZOLA",1,0,20,21,"2021","046"
"34832","NOVE",24,232,0,256,"2021","073"
"34833","NOVEDRATE",966,0,0,966,"2021","163"
"34834","NOVELLARA",3434,2428,0,5862,"2021","028"
"34835","NOVELLO",976,0,0,976,"2021","152"
"34836","NOVENTA DI PIAVE",2,7,0,9,"2021","027"
"34837","NOVENTA PADOVANA",14,0,0,14,"2021","058"
"34838","NOVENTA VICENTINA",4039,0,0,4039,"2021","074"
"34839","NOVI DI MODENA",486,811,0,1297,"2021","028"
"34840","NOVI LIGURE",436,0,0,436,"2021","114"
"34841","NOVIGLIO",17,414,0,431,"2021","158"
"34842","NUVOLENTO",11,1057,0,1068,"2021","119"
"34843","NUVOLERA",1350,373,0,1723,"2021","120"
"34844","OCCHIEPPO INFERIORE",4,104,0,108,"2021","040"
"34845","OCCHIEPPO SUPERIORE",34,50,41,125,"2021","041"
"34846","OCCHIOBELLO",7,81,0,88,"2021","033"
"34847","OCCIMIANO",32,0,0,32,"2021","115"
"34848","ODALENGO GRANDE",82,0,0,82,"2021","116"
"34849","ODERZO",35,237,0,272,"2021","051"
"34850","ODOLO",8,0,1,9,"2021","121"
"34851","OFFANENGO",300,794,2,1096,"2021","062"
"34852","OFFLAGA",598,4129,0,4727,"2021","122"
"34853","OGGEBBIO",5,0,0,5,"2021","049"
"34854","OGGIONA CON SANTO STEFANO",0,29,0,29,"2021","107"
"34855","OGGIONO",36,1,15,52,"2021","057"
"34856","OGLIANICO",126,284,0,410,"2021","170"
"34857","OLDENICO",1,0,0,1,"2021","089"
"34858","OLEGGIO",261,1081,0,1342,"2021","108"
"34859","OLGIATE COMASCO",28,47,33,108,"2021","165"
"34860","OLGIATE MOLGORA",16,75,0,91,"2021","058"
"34861","OLGIATE OLONA",3,0,0,3,"2021","108"
"34862","OLGINATE",7,0,0,7,"2021","059"
"34863","OLIVA GESSI",4,0,0,4,"2021",NA
"34864","OLIVETO LARIO",6,0,0,6,"2021","060"
"34865","OLMENETA",9,518,0,527,"2021","063"
"34866","OLMO AL BREMBO",1,5,0,6,"2021","145"
"34867","OLMO GENTILE",40,0,9,49,"2021","081"
"34868","OLTRE IL COLLE",16,72,0,88,"2021","146"
"34869","OLTRESSENDA ALTA",5,42,0,47,"2021","147"
"34870","OLTRONA DI SAN MAMETTE",15,0,0,15,"2021","169"
"34871","OME",12,9,0,21,"2021","123"
"34872","OMEGNA",49,0,0,49,"2021","050"
"34873","ONCINO",0,0,133,133,"2021","154"
"34874","ONETA",5,40,0,45,"2021","148"
"34875","ONO SAN PIETRO",1,8,2,11,"2021","124"
"34876","ONORE",8,20,0,28,"2021","149"
"34877","OPERA",0,99,0,99,"2021","159"
"34878","OPPEANO",5491,691,0,6182,"2021","055"
"34879","ORBASSANO",536,0,10,546,"2021","171"
"34880","ORGIANO",470,15,0,485,"2021","075"
"34881","ORIGGIO",73,0,18,91,"2021","109"
"34882","ORIO LITTA",0,105,10,115,"2021","042"
"34883","ORMEA",94,0,25,119,"2021","155"
"34884","ORMELLE",17,90,0,107,"2021","052"
"34885","ORNAGO",5,54,0,59,"2021",NA
"34886","ORNAVASSO",30,0,0,30,"2021","051"
"34887","ORNICA",2,8,0,10,"2021","151"
"34888","ORSAGO",5,94,0,99,"2021","053"
"34889","ORSARA BORMIDA",13,0,0,13,"2021","119"
"34890","ORSENIGO",8,48,12,68,"2021","170"
"34891","ORTA SAN GIULIO",4,0,0,4,"2021","112"
"34892","ORZINUOVI",522,5032,34,5588,"2021","125"
"34893","ORZIVECCHI",9,831,0,840,"2021","126"
"34894","OSASCO",385,0,95,480,"2021","173"
"34895","OSASIO",313,119,107,539,"2021","174"
"34896","OSIO SOPRA",48,582,0,630,"2021","152"
"34897","OSIO SOTTO",2,0,0,2,"2021","153"
"34898","OSNAGO",196,88,0,284,"2021","061"
"34899","OSPEDALETTO EUGANEO",375,0,0,375,"2021","059"
"34900","OSPEDALETTO LODIGIANO",0,873,0,873,"2021","043"
"34901","OSPITALETTO",253,242,0,495,"2021","127"
"34902","OSSAGO LODIGIANO",34,1571,0,1605,"2021","044"
"34903","OSSIMO",6,5,5,16,"2021","128"
"34904","OSSONA",39,0,0,39,"2021","164"
"34905","OSTELLATO",4975,0,0,4975,"2021","017"
"34906","OSTIANO",341,1335,0,1676,"2021","064"
"34907","OSTIGLIA",36,73,16,125,"2021","038"
"34908","OTTIGLIO",90,0,0,90,"2021","120"
"34909","OTTOBIANO",0,15,0,15,"2021","106"
"34910","OTTONE",96,0,0,96,"2021","030"
"34911","OULX",54,0,2,56,"2021","175"
"34912","OVADA",15,0,0,15,"2021","121"
"34913","OVIGLIO",33,16,0,49,"2021","122"
"34914","OZEGNA",224,0,0,224,"2021","176"
"34915","OZZANO DELL'EMILIA",188,256,0,444,"2021","046"
"34916","OZZANO MONFERRATO",65,0,0,65,"2021","123"
"34917","OZZERO",2,52,74,128,"2021","165"
"34918","PADENGHE SUL GARDA",51,0,18,69,"2021","129"
"34919","PADERNO D'ADDA",0,17,0,17,"2021","062"
"34920","PADERNO DUGNANO",7,0,0,7,"2021","166"
"34921","PADERNO FRANCIACORTA",2,137,139,278,"2021","130"
"34922","PADERNO PONCHIELLI",4,2233,122,2359,"2021","065"
"34923","PADOVA",619,282,48,949,"2021","060"
"34924","PAESANA",787,11,0,798,"2021","157"
"34925","PAESE",1977,511,169,2657,"2021","055"
"34926","PAGNO",48,0,0,48,"2021","158"
"34927","PAGNONA",0,8,1,9,"2021","063"
"34928","PAISCO LOVENO",0,14,2,16,"2021","131"
"34929","PAITONE",19,28,0,47,"2021","132"
"34930","PALADINA",8,0,0,8,"2021","155"
"34931","PALAGANO",72,534,0,606,"2021","029"
"34932","PALANZANO",12,467,0,479,"2021","026"
"34933","PALAZZAGO",108,48,0,156,"2021","156"
"34934","PALAZZO CANAVESE",23,0,0,23,"2021","177"
"34935","PALAZZO PIGNANO",3,842,0,845,"2021","066"
"34936","PALAZZOLO SULL'OGLIO",1363,1364,117,2844,"2021","133"
"34937","PALAZZOLO VERCELLESE",17,0,0,17,"2021","090"
"34938","PALESTRO",2,0,31,33,"2021","107"
"34939","PALLANZENO",56,0,0,56,"2021","052"
"34940","PALOSCO",436,475,0,911,"2021","157"
"34941","PALU'",116,0,0,116,"2021","056"
"34942","PAMPARATO",47,0,0,47,"2021","159"
"34943","PANCALIERI",192,42,0,234,"2021","178"
"34944","PANDINO",10,3781,0,3791,"2021","067"
"34945","PANTIGLIATE",4,0,0,4,"2021","167"
"34946","PAPOZZE",5,61,0,66,"2021","034"
"34947","PARABIAGO",71,32,23,126,"2021","168"
"34948","PARATICO",5,48,0,53,"2021","134"
"34949","PARELLA",1,0,0,1,"2021",NA
"34950","PARETO",41,2,0,43,"2021","125"
"34951","PARLASCO",2,0,0,2,"2021","064"
"34952","PARMA",239,10123,0,10362,"2021","027"
"34953","PARODI LIGURE",46,0,45,91,"2021","126"
"34954","PAROLDO",19,0,5,24,"2021","160"
"34955","PARONA",1,0,0,1,"2021","109"
"34956","PARRE",17,78,0,95,"2021","158"
"34957","PARUZZARO",44,28,0,72,"2021","114"
"34958","PARZANICA",5,8,0,13,"2021","159"
"34959","PASPARDO",3,5,1,9,"2021","135"
"34960","PASSERANO MARMORITO",148,0,0,148,"2021","082"
"34961","PASSIRANO",40,169,0,209,"2021","136"
"34962","PASTRENGO",0,156,0,156,"2021","057"
"34963","PASTURO",47,126,50,223,"2021","065"
"34964","PAULLO",0,543,0,543,"2021","169"
"34965","PAVAROLO",55,0,0,55,"2021","180"
"34966","PAVIA",51,283,8,342,"2021","110"
"34967","PAVONE CANAVESE",147,0,1,148,"2021","181"
"34968","PAVONE DEL MELLA",2853,278,5,3136,"2021","137"
"34969","PAVULLO NEL FRIGNANO",160,3908,0,4068,"2021","030"
"34970","PECETTO DI VALENZA",19,0,0,19,"2021","128"
"34971","PECETTO TORINESE",101,0,0,101,"2021","183"
"34972","PEDAVENA",3,103,3,109,"2021","036"
"34973","PEDEMONTE",0,3,7,10,"2021","076"
"34974","PEDEROBBA",65,156,0,221,"2021","056"
"34975","PEDRENGO",11,273,17,301,"2021","160"
"34976","PEGLIO",2,8,9,19,"2021","178"
"34977","PEGOGNAGA",1193,2506,1988,5687,"2021","039"
"34978","PEIA",6,24,0,30,"2021","161"
"34979","PELLEGRINO PARMENSE",110,752,0,862,"2021","028"
"34980","PENANGO",45,0,0,45,"2021","083"
"34981","PENNABILLI",281,0,0,281,"2021","024"
"34982","PERLEDO",1,0,0,1,"2021","067"
"34983","PERLETTO",173,0,0,173,"2021","161"
"34984","PERLO",27,0,0,27,"2021","162"
"34985","PERNUMIA",342,157,0,499,"2021","061"
"34986","PEROSA ARGENTINA",72,10,3,85,"2021","184"
"34987","PEROSA CANAVESE",132,204,0,336,"2021","185"
"34988","PERRERO",26,0,0,26,"2021","186"
"34989","PERSICO DOSIMO",6,1882,59,1947,"2021","068"
"34990","PERTENGO",1,0,0,1,"2021","091"
"34991","PERTICA ALTA",7,15,5,27,"2021","139"
"34992","PERTICA BASSA",22,46,24,92,"2021","140"
"34993","PERTUSIO",60,0,0,60,"2021","187"
"34994","PESCANTINA",108,58,0,166,"2021","058"
"34995","PESCAROLO ED UNITI",52,996,0,1048,"2021","069"
"34996","PESCHIERA BORROMEO",46,260,1,307,"2021","171"
"34997","PESSANO CON BORNAGO",56,155,0,211,"2021","172"
"34998","PESSINA CREMONESE",433,3110,133,3676,"2021","070"
"34999","PESSINETTO",1,0,0,1,"2021","188"
"35000","PETTENASCO",7,0,0,7,"2021","116"
"35001","PETTINENGO",3,17,0,20,"2021","042"
"35002","PETTORAZZA GRIMANI",176,186,0,362,"2021","035"
"35003","PEVERAGNO",1035,474,36,1545,"2021","163"
"35004","PEZZAZE",24,33,0,57,"2021","141"
"35005","PEZZOLO VALLE UZZONE",65,0,0,65,"2021","164"
"35006","PIACENZA",530,1226,0,1756,"2021","032"
"35007","PIACENZA D'ADIGE",661,0,0,661,"2021","062"
"35008","PIADENA DRIZZONA",67,955,0,1022,"2021",NA
"35009","PIAN CAMUNO",0,284,1,285,"2021","142"
"35010","PIANCOGNO",0,89,6,95,"2021","206"
"35011","PIANELLO DEL LARIO",8,0,8,16,"2021","183"
"35012","PIANELLO VAL TIDONE",387,102,0,489,"2021","033"
"35013","PIANENGO",4,299,0,303,"2021","072"
"35014","PIANEZZA",267,371,198,836,"2021","189"
"35015","PIANEZZE",186,123,0,309,"2021","077"
"35016","PIANFEI",797,60,20,877,"2021","165"
"35017","PIANICO",12,85,0,97,"2021","162"
"35018","PIANIGA",44,4,0,48,"2021","028"
"35019","PIANORO",143,143,0,286,"2021","047"
"35020","PIANTEDO",5,293,3,301,"2021","048"
"35021","PIARIO",26,0,0,26,"2021","163"
"35022","PIASCO",224,286,57,567,"2021","166"
"35023","PIATEDA",29,70,0,99,"2021","049"
"35024","PIATTO",19,0,0,19,"2021","043"
"35025","PIAZZA BREMBANA",2,0,0,2,"2021","164"
"35026","PIAZZATORRE",5,5,0,10,"2021","165"
"35027","PIAZZOLA SUL BRENTA",2865,1078,0,3943,"2021","063"
"35028","PIAZZOLO",0,2,0,2,"2021","166"
"35029","PIEA",71,0,0,71,"2021","084"
"35030","PIEDIMULERA",0,31,0,31,"2021","053"
"35031","PIERANICA",57,39,0,96,"2021","073"
"35032","PIETRA DE' GIORGI",10,0,0,10,"2021","111"
"35033","PIEVE D'OLMI",1,2074,0,2075,"2021","074"
"35034","PIEVE DEL CAIRO",5,85,0,90,"2021","113"
"35035","PIEVE DEL GRAPPA",698,837,12,1547,"2021",NA
"35036","PIEVE DI CADORE",0,13,0,13,"2021","039"
"35037","PIEVE DI SOLIGO",25,123,3,151,"2021","057"
"35038","PIEVE EMANUELE",0,438,136,574,"2021","173"
"35039","PIEVE FISSIRAGA",110,1237,0,1347,"2021","045"
"35040","PIEVE PORTO MORONE",139,0,0,139,"2021","114"
"35041","PIEVE SAN GIACOMO",0,1895,0,1895,"2021","075"
"35042","PIEVE VERGONTE",46,4,83,133,"2021","054"
"35043","PIEVEPELAGO",35,76,0,111,"2021","031"
"35044","PINAROLO PO",2019,0,0,2019,"2021","115"
"35045","PINASCA",129,0,39,168,"2021","190"
"35046","PINCARA",461,0,0,461,"2021","036"
"35047","PINEROLO",2007,139,158,2304,"2021","191"
"35048","PINO TORINESE",469,0,65,534,"2021","192"
"35049","PIOBESI TORINESE",422,1051,254,1727,"2021","193"
"35050","PIODE",0,9,16,25,"2021","097"
"35051","PIOLTELLO",1,0,0,1,"2021","175"
"35052","PIOMBINO DESE",4513,191,3,4707,"2021","064"
"35053","PIOSSASCO",510,948,75,1533,"2021","194"
"35054","PIOVA' MASSAIA",238,0,0,238,"2021","086"
"35055","PIOVE DI SACCO",3905,147,0,4052,"2021","065"
"35056","PIOVENE ROCCHETTE",1824,105,1,1930,"2021","078"
"35057","PIOZZANO",204,0,0,204,"2021","034"
"35058","PIOZZO",356,0,0,356,"2021","169"
"35059","PISCINA",1587,0,0,1587,"2021","195"
"35060","PISOGNE",8,197,13,218,"2021","143"
"35061","PIUBEGA",4782,995,147,5924,"2021","041"
"35062","PIURO",13,168,1,182,"2021","050"
"35063","PIVERONE",70,66,0,136,"2021","196"
"35064","PIZZIGHETTONE",66,3106,0,3172,"2021","076"
"35065","PLESIO",2,0,0,2,"2021","185"
"35066","POCAPAGLIA",121,52,0,173,"2021","170"
"35067","PODENZANO",79,700,0,779,"2021","035"
"35068","POGGIO RENATICO",14,476,0,490,"2021","018"
"35069","POGGIO RUSCO",331,1055,12,1398,"2021","042"
"35070","POGGIO TORRIANA",391,0,0,391,"2021",NA
"35071","POGGIRIDENTI",8,0,0,8,"2021","051"
"35072","POGNANO",88,278,39,405,"2021","167"
"35073","POGNO",1,0,0,1,"2021",NA
"35074","POIRINO",3816,660,0,4476,"2021","197"
"35075","POJANA MAGGIORE",1214,27,0,1241,"2021","079"
"35076","POLAVENO",15,44,0,59,"2021","144"
"35077","POLESINE ZIBELLO",25,1555,0,1580,"2021",NA
"35078","POLINAGO",34,724,0,758,"2021","032"
"35079","POLLONE",182,48,2,232,"2021","046"
"35080","POLONGHERA",215,122,36,373,"2021","171"
"35081","POLPENAZZE DEL GARDA",15,93,0,108,"2021","145"
"35082","POLVERARA",2,30,0,32,"2021","066"
"35083","POMARETTO",48,0,18,66,"2021","198"
"35084","POMARO MONFERRATO",3,0,243,246,"2021","131"
"35085","POMBIA",6,63,0,69,"2021","121"
"35086","POMPIANO",16,1467,0,1483,"2021","146"
"35087","POMPONESCO",43,439,22,504,"2021","043"
"35088","PONCARALE",407,554,255,1216,"2021","147"
"35089","PONDERANO",63,34,40,137,"2021","047"
"35090","PONNA",2,3,3,8,"2021","187"
"35091","PONSO",33,0,0,33,"2021","067"
"35092","PONT-CANAVESE",41,32,0,73,"2021","199"
"35093","PONTE DELL'OLIO",160,131,0,291,"2021","036"
"35094","PONTE DI LEGNO",6,3,1,10,"2021","148"
"35095","PONTE DI PIAVE",47,37,2,86,"2021","058"
"35096","PONTE IN VALTELLINA",5,8,0,13,"2021","052"
"35097","PONTE LAMBRO",10,8,0,18,"2021","188"
"35098","PONTE NELLE ALPI",19,123,1,143,"2021","040"
"35099","PONTE NIZZA",117,33,0,150,"2021","117"
"35100","PONTE NOSSA",0,9,0,9,"2021","168"
"35101","PONTE SAN NICOLO'",8,49,0,57,"2021","069"
"35102","PONTE SAN PIETRO",10,0,0,10,"2021","170"
"35103","PONTECCHIO POLESINE",1843,0,0,1843,"2021","038"
"35104","PONTECHIANALE",188,0,0,188,"2021","172"
"35105","PONTECURONE",3,0,0,3,"2021","132"
"35106","PONTELONGO",367,0,0,367,"2021","068"
"35107","PONTENURE",46,164,0,210,"2021","037"
"35108","PONTERANICA",1,0,0,1,"2021","169"
"35109","PONTESTURA",7,0,0,7,"2021","133"
"35110","PONTEVICO",255,3639,315,4209,"2021","149"
"35111","PONTI",61,0,7,68,"2021","134"
"35112","PONTI SUL MINCIO",147,379,33,559,"2021","044"
"35113","PONTIDA",24,0,0,24,"2021","171"
"35114","PONTIROLO NUOVO",234,520,0,754,"2021","172"
"35115","PONTOGLIO",869,1475,0,2344,"2021","150"
"35116","PONZANO MONFERRATO",52,0,0,52,"2021","135"
"35117","PONZANO VENETO",328,173,0,501,"2021","059"
"35118","PONZONE",26,0,20,46,"2021","136"
"35119","PORLEZZA",7,25,18,50,"2021","189"
"35120","PORTACOMARO",51,0,0,51,"2021","087"
"35121","PORTE",15,0,0,15,"2021","200"
"35122","PORTICO E SAN BENEDETTO",48,0,0,48,"2021","031"
"35123","PORTO CERESIO",2,0,0,2,"2021","113"
"35124","PORTO MANTOVANO",2068,826,1574,4468,"2021","045"
"35125","PORTO TOLLE",12,0,0,12,"2021","039"
"35126","PORTO VALTRAVAGLIA",20,0,10,30,"2021","114"
"35127","PORTO VIRO",3948,0,0,3948,"2021","052"
"35128","PORTOBUFFOLE'",0,0,2,2,"2021","060"
"35129","PORTOGRUARO",1082,85,0,1167,"2021","029"
"35130","PORTOMAGGIORE",1384,417,0,1801,"2021","019"
"35131","PORTULA",2,0,0,2,"2021","048"
"35132","POSINA",0,9,0,9,"2021","080"
"35133","POSSAGNO",9,16,0,25,"2021","061"
"35134","POSTALESIO",2,0,0,2,"2021","053"
"35135","POSTUA",1,0,0,1,"2021","102"
"35136","POVE DEL GRAPPA",21,0,0,21,"2021","081"
"35137","POVEGLIANO",137,155,5,297,"2021","062"
"35138","POVEGLIANO VERONESE",2860,495,0,3355,"2021","060"
"35139","POVIGLIO",7,1521,0,1528,"2021","029"
"35140","POZZAGLIO ED UNITI",30,2367,218,2615,"2021","077"
"35141","POZZO D'ADDA",249,0,0,249,"2021","177"
"35142","POZZOL GROPPO",30,0,0,30,"2021","137"
"35143","POZZOLENGO",558,413,32,1003,"2021","151"
"35144","POZZOLEONE",105,2243,30,2378,"2021","082"
"35145","POZZOLO FORMIGARO",32,248,0,280,"2021","138"
"35146","POZZONOVO",1952,0,0,1952,"2021","070"
"35147","POZZUOLO MARTESANA",6,200,15,221,"2021","178"
"35148","PRADALUNGA",37,0,0,37,"2021","173"
"35149","PRADLEVES",0,6,0,6,"2021","173"
"35150","PRAGELATO",7,0,2,9,"2021","201"
"35151","PRALBOINO",1848,786,29,2663,"2021","152"
"35152","PRALI",49,0,0,49,"2021","202"
"35153","PRALORMO",1191,445,0,1636,"2021","203"
"35154","PRALUNGO",75,1,18,94,"2021","049"
"35155","PRAMAGGIORE",9,7,0,16,"2021","030"
"35156","PRAMOLLO",7,0,0,7,"2021","204"
"35157","PRAROSTINO",46,7,0,53,"2021","205"
"35158","PRASCO",20,0,0,20,"2021","139"
"35159","PRATA CAMPORTACCIO",23,142,69,234,"2021","054"
"35160","PRATIGLIONE",16,0,0,16,"2021","207"
"35161","PRATO SESIA",0,11,0,11,"2021","122"
"35162","PRAY",74,0,0,74,"2021","050"
"35163","PRAZZO",196,24,38,258,"2021","174"
"35164","PREDAPPIO",206,31,0,237,"2021","032"
"35165","PREDORE",26,0,0,26,"2021","174"
"35166","PREDOSA",300,119,0,419,"2021","140"
"35167","PREGANZIOL",23,205,0,228,"2021","063"
"35168","PREGNANA MILANESE",8,106,0,114,"2021","179"
"35169","PREMANA",5,4,2,11,"2021","069"
"35170","PREMENO",2,0,0,2,"2021","055"
"35171","PREMIA",37,162,4,203,"2021","056"
"35172","PREMILCUORE",323,0,33,356,"2021","033"
"35173","PREMOLO",9,11,0,20,"2021","175"
"35174","PREMOSELLO-CHIOVENDA",16,0,0,16,"2021","057"
"35175","PRESEGLIE",67,0,2,69,"2021","153"
"35176","PRESSANA",4350,2,18,4370,"2021","061"
"35177","PREVALLE",20,582,9,611,"2021","155"
"35178","PRIERO",54,0,0,54,"2021","175"
"35179","PRIGNANO SULLA SECCHIA",127,1335,0,1462,"2021","033"
"35180","PRIMALUNA",23,43,6,72,"2021","070"
"35181","PRIOCCA",570,0,0,570,"2021","176"
"35182","PRIOLA",94,0,0,94,"2021","177"
"35183","PROSERPIO",1,2,0,3,"2021","192"
"35184","PROVAGLIO D'ISEO",117,196,0,313,"2021","156"
"35185","PROVAGLIO VAL SABBIA",21,0,8,29,"2021","157"
"35186","PRUNETTO",72,0,0,72,"2021","178"
"35187","PUEGNAGO SUL GARDA",10,112,0,122,"2021","158"
"35188","PUMENENGO",1633,1009,0,2642,"2021","177"
"35189","PUSIANO",0,0,1,1,"2021","193"
"35190","QUAREGNA CERRETO",213,0,0,213,"2021",NA
"35191","QUARGNENTO",692,0,0,692,"2021","141"
"35192","QUARNA SOPRA",4,0,0,4,"2021","058"
"35193","QUARNA SOTTO",11,0,0,11,"2021","059"
"35194","QUARONA",4,16,0,20,"2021","107"
"35195","QUARTO D'ALTINO",5,0,0,5,"2021","031"
"35196","QUASSOLO",37,20,18,75,"2021","209"
"35197","QUATTORDIO",120,0,0,120,"2021","142"
"35198","QUATTRO CASTELLA",22,1331,0,1353,"2021","030"
"35199","QUERO VAS",5,70,14,89,"2021",NA
"35200","QUINCINETTO",30,41,0,71,"2021","210"
"35201","QUINGENTOLE",908,48,61,1017,"2021","046"
"35202","QUINTANO",2,437,0,439,"2021","078"
"35203","QUINTO DI TREVISO",171,160,5,336,"2021","064"
"35204","QUINTO VERCELLESE",3,0,0,3,"2021","108"
"35205","QUINTO VICENTINO",32,559,0,591,"2021","083"
"35206","QUINZANO D'OGLIO",268,3033,0,3301,"2021","159"
"35207","QUISTELLO",164,1586,472,2222,"2021","047"
"35208","RACCONIGI",2091,2003,182,4276,"2021","179"
"35209","RANCIO VALCUVIA",4,0,0,4,"2021","115"
"35210","RANCO",0,0,28,28,"2021","116"
"35211","RANICA",28,17,0,45,"2021","178"
"35212","RANZANICO",8,22,0,30,"2021","179"
"35213","RASURA",0,8,0,8,"2021","055"
"35214","RAVENNA",1102,1312,0,2414,"2021","014"
"35215","RE",23,0,0,23,"2021","060"
"35216","REANO",27,0,1,28,"2021","211"
"35217","RECOARO TERME",63,108,2,173,"2021","084"
"35218","REDAVALLE",80,0,0,80,"2021","120"
"35219","REDONDESCO",151,750,989,1890,"2021","048"
"35220","REFRANCORE",19,0,0,19,"2021","089"
"35221","REFRONTOLO",8,21,1,30,"2021","065"
"35222","REGGIO NELL'EMILIA",91,10779,2,10872,"2021","033"
"35223","REGGIOLO",696,2706,0,3402,"2021","032"
"35224","REMEDELLO",7125,2453,233,9811,"2021","160"
"35225","RENATE",5,0,1,6,"2021",NA
"35226","RESANA",2344,51,9,2404,"2021","066"
"35227","REVELLO",7081,1940,248,9269,"2021","180"
"35228","REVIGLIASCO D'ASTI",236,0,0,236,"2021","090"
"35229","REVINE LAGO",25,0,0,25,"2021","067"
"35230","REZZATO",397,709,0,1106,"2021","161"
"35231","RHO",6,587,0,593,"2021","182"
"35232","RIBORDONE",10,0,0,10,"2021","212"
"35233","RICCIONE",2,0,0,2,"2021","013"
"35234","RICENGO",19,2714,5,2738,"2021","079"
"35235","RIESE PIO X",7240,434,6,7680,"2021","068"
"35236","RIFREDDO",1171,10,32,1213,"2021","181"
"35237","RIMELLA",2,4,0,6,"2021","113"
"35238","RIMINI",70,107,0,177,"2021","014"
"35239","RIO SALICETO",961,331,0,1292,"2021","034"
"35240","RIOLO TERME",336,0,0,336,"2021","015"
"35241","RIOLUNATO",60,14,0,74,"2021","035"
"35242","RIPALTA ARPINA",0,421,0,421,"2021","080"
"35243","RIPALTA CREMASCA",2,290,0,292,"2021","081"
"35244","RIPALTA GUERINA",2,529,0,531,"2021","082"
"35245","RIVA DEL PO",1752,106,0,1858,"2021",NA
"35246","RIVA DI SOLTO",2,0,0,2,"2021","180"
"35247","RIVA PRESSO CHIERI",3181,143,167,3491,"2021","215"
"35248","RIVALBA",66,0,0,66,"2021","213"
"35249","RIVALTA DI TORINO",100,0,0,100,"2021","214"
"35250","RIVAMONTE AGORDINO",0,15,0,15,"2021","043"
"35251","RIVANAZZANO",65,0,0,65,"2021","122"
"35252","RIVARA",157,133,0,290,"2021","216"
"35253","RIVAROLO CANAVESE",1059,267,591,1917,"2021","217"
"35254","RIVAROLO DEL RE ED UNITI",3897,372,0,4269,"2021","083"
"35255","RIVAROLO MANTOVANO",47,1237,132,1416,"2021","050"
"35256","RIVAROSSA",3,156,0,159,"2021","218"
"35257","RIVERGARO",75,1164,0,1239,"2021","038"
"35258","RIVOLI",1449,36,40,1525,"2021","219"
"35259","RIVOLI VERONESE",150,3,4,157,"2021","062"
"35260","RIVOLTA D'ADDA",2084,2443,265,4792,"2021","084"
"35261","ROANA",25,379,0,404,"2021","085"
"35262","ROASCIO",5,0,0,5,"2021","184"
"35263","ROASIO",10,0,0,10,"2021","116"
"35264","ROATTO",127,0,0,127,"2021","091"
"35265","ROBASSOMERO",43,92,25,160,"2021","220"
"35266","ROBBIO",3,195,0,198,"2021","123"
"35267","ROBECCHETTO CON INDUNO",229,229,0,458,"2021","183"
"35268","ROBECCO D'OGLIO",0,3197,0,3197,"2021","085"
"35269","ROBECCO PAVESE",6,0,0,6,"2021","124"
"35270","ROBECCO SUL NAVIGLIO",54,723,65,842,"2021","184"
"35271","ROBELLA",421,0,0,421,"2021","092"
"35272","ROBILANTE",233,0,0,233,"2021","185"
"35273","ROBURENT",26,0,0,26,"2021","186"
"35274","ROCCA CANAVESE",118,0,0,118,"2021","221"
"35275","ROCCA CIGLIE'",8,0,0,8,"2021","188"
"35276","ROCCA D'ARAZZO",279,0,0,279,"2021","093"
"35277","ROCCA DE' BALDI",2760,954,761,4475,"2021","189"
"35278","ROCCA GRIMALDA",5,0,0,5,"2021","147"
"35279","ROCCA PIETORE",0,10,0,10,"2021","044"
"35280","ROCCA SAN CASCIANO",114,1,0,115,"2021","036"
"35281","ROCCA SUSELLA",2,0,0,2,"2021",NA
"35282","ROCCABIANCA",0,1271,0,1271,"2021","030"
"35283","ROCCABRUNA",87,44,89,220,"2021","187"
"35284","ROCCAFORTE LIGURE",52,0,0,52,"2021","146"
"35285","ROCCAFORTE MONDOVI'",1104,0,16,1120,"2021","190"
"35286","ROCCAFRANCA",1905,1866,18,3789,"2021","162"
"35287","ROCCASPARVERA",462,0,0,462,"2021","191"
"35288","ROCCAVERANO",113,0,0,113,"2021","094"
"35289","ROCCAVIONE",29,0,0,29,"2021","192"
"35290","ROCCHETTA LIGURE",24,0,0,24,"2021","148"
"35291","ROCCHETTA PALAFEA",4,0,0,4,"2021","095"
"35292","ROCCHETTA TANARO",370,0,0,370,"2021","096"
"35293","RODANO",49,28,0,77,"2021","185"
"35294","RODDI",80,34,0,114,"2021","194"
"35295","RODDINO",77,0,0,77,"2021","195"
"35296","RODELLO",99,0,0,99,"2021","196"
"35297","RODENGO-SAIANO",36,245,130,411,"2021","163"
"35298","RODERO",0,5,2,7,"2021",NA
"35299","RODIGO",722,1349,1182,3253,"2021","051"
"35300","ROE' VOLCIANO",9,0,0,9,"2021","164"
"35301","ROGENO",17,272,0,289,"2021","072"
"35302","ROGNANO",10,0,0,10,"2021","127"
"35303","ROGNO",15,83,0,98,"2021","182"
"35304","ROGOLO",2,22,0,24,"2021","056"
"35305","ROLETTO",108,87,0,195,"2021","222"
"35306","ROLO",40,233,0,273,"2021","035"
"35307","ROMAGNANO SESIA",22,0,0,22,"2021","130"
"35308","ROMAGNESE",102,0,0,102,"2021","128"
"35309","ROMANENGO",2,2274,0,2276,"2021","086"
"35310","ROMANO CANAVESE",24,0,0,24,"2021","223"
"35311","ROMANO D'EZZELINO",173,538,0,711,"2021","086"
"35312","ROMANO DI LOMBARDIA",87,3330,67,3484,"2021","183"
"35313","ROMENTINO",17,0,0,17,"2021","131"
"35314","RONAGO",2,28,0,30,"2021","199"
"35315","RONCA'",4,0,0,4,"2021","063"
"35316","RONCADE",2111,70,0,2181,"2021","069"
"35317","RONCADELLE",238,736,0,974,"2021","165"
"35318","RONCARO",1,0,0,1,"2021","129"
"35319","RONCELLO",1,0,0,1,"2021",NA
"35320","RONCO ALL'ADIGE",6946,0,0,6946,"2021","064"
"35321","RONCO BIELLESE",28,42,0,70,"2021","053"
"35322","RONCO BRIANTINO",0,164,0,164,"2021",NA
"35323","RONCOBELLO",2,0,0,2,"2021",NA
"35324","RONCOFERRARO",3225,816,293,4334,"2021","052"
"35325","RONCOFREDDO",21,54,0,75,"2021","037"
"35326","RONCOLA",20,42,0,62,"2021","185"
"35327","RONSECCO",6,0,0,6,"2021",NA
"35328","ROPPOLO",7,0,0,7,"2021","054"
"35329","RORA'",27,0,0,27,"2021","226"
"35330","ROSA'",53,731,3,787,"2021","087"
"35331","ROSATE",3691,486,0,4177,"2021","188"
"35332","ROSIGNANO MONFERRATO",64,0,0,64,"2021","149"
"35333","ROSOLINA",8,0,0,8,"2021","040"
"35334","ROSSA",10,19,0,29,"2021","121"
"35335","ROSSANA",127,37,0,164,"2021","197"
"35336","ROSSANO VENETO",353,232,11,596,"2021","088"
"35337","ROSTA",27,0,84,111,"2021","228"
"35338","ROTA D'IMAGNA",8,54,0,62,"2021","186"
"35339","ROTTOFRENO",610,1259,0,1869,"2021","039"
"35340","ROTZO",121,0,2,123,"2021","089"
"35341","ROURE",8,0,0,8,"2021","227"
"35342","ROVASENDA",10,0,0,10,"2021","122"
"35343","ROVATO",1837,2436,20,4293,"2021","166"
"35344","ROVELLASCA",4,66,0,70,"2021","201"
"35345","ROVERBELLA",13811,872,104,14787,"2021","053"
"35346","ROVERCHIARA",4097,0,48,4145,"2021","065"
"35347","ROVERE' VERONESE",260,1222,0,1482,"2021","067"
"35348","ROVEREDO DI GUA'",1505,48,16,1569,"2021","066"
"35349","ROVESCALA",10,0,0,10,"2021","131"
"35350","ROVETTA",39,124,0,163,"2021","187"
"35351","ROVIGO",1556,6,0,1562,"2021","041"
"35352","ROVOLON",137,22,33,192,"2021","071"
"35353","RUBANO",54,30,0,84,"2021","072"
"35354","RUBIANA",17,0,0,17,"2021","229"
"35355","RUBIERA",13,402,0,415,"2021","036"
"35356","RUDIANO",286,1256,0,1542,"2021","167"
"35357","RUEGLIO",91,0,3,94,"2021","230"
"35358","RUFFIA",415,183,59,657,"2021","198"
"35359","RUSSI",10,0,0,10,"2021","016"
"35360","SABBIO CHIESE",14,72,9,95,"2021","168"
"35361","SABBIONETA",4,50,0,54,"2021","054"
"35362","SACCOLONGO",56,494,0,550,"2021","073"
"35363","SAGLIANO MICCA",101,0,0,101,"2021","056"
"35364","SALA BAGANZA",2,129,23,154,"2021","031"
"35365","SALA BIELLESE",11,0,0,11,"2021","057"
"35366","SALA BOLOGNESE",347,0,0,347,"2021","050"
"35367","SALA COMACINA",3,0,0,3,"2021","203"
"35368","SALA MONFERRATO",77,0,0,77,"2021","150"
"35369","SALARA",3,0,0,3,"2021","042"
"35370","SALASSA",28,0,0,28,"2021","231"
"35371","SALBERTRAND",56,0,0,56,"2021","232"
"35372","SALCEDO",981,62,0,1043,"2021","090"
"35373","SALE DELLE LANGHE",197,0,0,197,"2021","199"
"35374","SALE MARASINO",29,7,24,60,"2021","169"
"35375","SALE SAN GIOVANNI",66,0,0,66,"2021","200"
"35376","SALERANO CANAVESE",3,0,0,3,"2021",NA
"35377","SALERANO SUL LAMBRO",1,262,0,263,"2021","046"
"35378","SALGAREDA",863,176,0,1039,"2021","070"
"35379","SALICETO",57,0,0,57,"2021","201"
"35380","SALIZZOLE",2634,372,68,3074,"2021","068"
"35381","SALMOUR",243,0,0,243,"2021","202"
"35382","SALO'",2,36,2,40,"2021","170"
"35383","SALSOMAGGIORE TERME",12,954,0,966,"2021","032"
"35384","SALTRIO",1,40,0,41,"2021","117"
"35385","SALUDECIO",78,0,0,78,"2021","015"
"35386","SALUGGIA",547,163,0,710,"2021","128"
"35387","SALUSSOLA",594,6,0,600,"2021","058"
"35388","SALUZZO",3270,3444,587,7301,"2021","203"
"35389","SALVIROLA",710,35,3,748,"2021","087"
"35390","SALZANO",310,27,2,339,"2021","032"
"35391","SAMARATE",25,0,0,25,"2021","118"
"35392","SAMBUCO",47,0,0,47,"2021","204"
"35393","SAMOLACO",124,837,61,1022,"2021","057"
"35394","SAMPEYRE",280,85,0,365,"2021","205"
"35395","SAN BARTOLOMEO VAL CAVARGNA",2,0,1,3,"2021","204"
"35396","SAN BASSANO",5,1790,0,1795,"2021","088"
"35397","SAN BELLINO",1444,0,0,1444,"2021","043"
"35398","SAN BENEDETTO BELBO",34,0,0,34,"2021","206"
"35399","SAN BENEDETTO PO",994,2356,388,3738,"2021","055"
"35400","SAN BENEDETTO VAL DI SAMBRO",263,72,1,336,"2021","051"
"35401","SAN BENIGNO CANAVESE",180,0,3,183,"2021","236"
"35402","SAN BERNARDINO VERBANO",2,0,0,2,"2021","061"
"35403","SAN BIAGIO DI CALLALTA",587,0,0,587,"2021","071"
"35404","SAN BONIFACIO",2030,0,0,2030,"2021","069"
"35405","SAN CARLO CANAVESE",220,150,128,498,"2021","237"
"35406","SAN CESARIO SUL PANARO",38,743,0,781,"2021","036"
"35407","SAN CIPRIANO PO",3,0,0,3,"2021","133"
"35408","SAN CLEMENTE",17,0,0,17,"2021","016"
"35409","SAN COLOMBANO AL LAMBRO",27,319,0,346,"2021","191"
"35410","SAN COLOMBANO BELMONTE",5,17,0,22,"2021","238"
"35411","SAN DAMIANO D'ASTI",4235,0,0,4235,"2021","097"
"35412","SAN DAMIANO MACRA",45,0,0,45,"2021","207"
"35413","SAN DANIELE PO",19,1640,0,1659,"2021","089"
"35414","SAN DIDERO",0,6,0,6,"2021","239"
"35415","SAN DONA' DI PIAVE",253,291,0,544,"2021","033"
"35416","SAN DONATO MILANESE",0,0,3,3,"2021","192"
"35417","SAN FELICE DEL BENACO",11,0,0,11,"2021","171"
"35418","SAN FELICE SUL PANARO",0,929,0,929,"2021","037"
"35419","SAN FERMO DELLA BATTAGLIA",43,0,18,61,"2021","206"
"35420","SAN FIOR",25,18,2,45,"2021","072"
"35421","SAN FIORANO",0,153,0,153,"2021","047"
"35422","SAN FRANCESCO AL CAMPO",636,311,0,947,"2021","240"
"35423","SAN GENESIO ED UNITI",2,615,0,617,"2021","135"
"35424","SAN GERMANO CHISONE",77,8,2,87,"2021","242"
"35425","SAN GERMANO VERCELLESE",6,0,0,6,"2021","131"
"35426","SAN GERVASIO BRESCIANO",1,277,0,278,"2021","172"
"35427","SAN GIACOMO DELLE SEGNATE",332,296,125,753,"2021","056"
"35428","SAN GIACOMO VERCELLESE",1925,0,0,1925,"2021","035"
"35429","SAN GILLIO",123,64,1,188,"2021","243"
"35430","SAN GIORGIO BIGARELLO",2069,395,327,2791,"2021",NA
"35431","SAN GIORGIO CANAVESE",304,22,0,326,"2021","244"
"35432","SAN GIORGIO DELLE PERTICHE",221,73,0,294,"2021","075"
"35433","SAN GIORGIO DI PIANO",15,0,0,15,"2021","052"
"35434","SAN GIORGIO IN BOSCO",274,749,5,1028,"2021","076"
"35435","SAN GIORGIO MONFERRATO",17,0,0,17,"2021","153"
"35436","SAN GIORGIO PIACENTINO",195,704,0,899,"2021","040"
"35437","SAN GIORGIO SCARAMPI",73,0,0,73,"2021","098"
"35438","SAN GIORIO DI SUSA",4,34,1,39,"2021","245"
"35439","SAN GIOVANNI BIANCO",46,24,0,70,"2021","188"
"35440","SAN GIOVANNI DEL DOSSO",0,252,196,448,"2021","058"
"35441","SAN GIOVANNI ILARIONE",844,1,0,845,"2021","070"
"35442","SAN GIOVANNI IN CROCE",0,478,1,479,"2021","090"
"35443","SAN GIOVANNI IN MARIGNANO",6,0,0,6,"2021","017"
"35444","SAN GIOVANNI IN PERSICETO",30,764,0,794,"2021","053"
"35445","SAN GIOVANNI LUPATOTO",760,75,0,835,"2021","071"
"35446","SAN GIULIANO MILANESE",43,568,116,727,"2021","195"
"35447","SAN GIUSTO CANAVESE",115,35,0,150,"2021","246"
"35448","SAN GREGORIO NELLE ALPI",11,62,0,73,"2021","045"
"35449","SAN LAZZARO DI SAVENA",4,0,0,4,"2021","054"
"35450","SAN LEO",309,317,1,627,"2021","025"
"35451","SAN MARTINO ALFIERI",8,0,0,8,"2021","099"
"35452","SAN MARTINO BUON ALBERGO",167,1005,0,1172,"2021","073"
"35453","SAN MARTINO CANAVESE",59,0,0,59,"2021","247"
"35454","SAN MARTINO DALL'ARGINE",1,1275,1,1277,"2021","059"
"35455","SAN MARTINO DEL LAGO",15,0,0,15,"2021","091"
"35456","SAN MARTINO DI LUPARI",3630,317,2,3949,"2021","077"
"35457","SAN MARTINO IN RIO",0,1060,0,1060,"2021","037"
"35458","SAN MARTINO IN STRADA",0,972,3,975,"2021","048"
"35459","SAN MARTINO SICCOMARIO",16,0,0,16,"2021","137"
"35460","SAN MARZANO OLIVETO",24,0,0,24,"2021","100"
"35461","SAN MAURIZIO CANAVESE",120,340,211,671,"2021","248"
"35462","SAN MAURIZIO D'OPAGLIO",10,0,0,10,"2021","133"
"35463","SAN MAURO DI SALINE",84,393,0,477,"2021","074"
"35464","SAN MAURO TORINESE",3,0,0,3,"2021","249"
"35465","SAN MICHELE AL TAGLIAMENTO",3051,37,0,3088,"2021","034"
"35466","SAN MICHELE MONDOVI'",197,0,0,197,"2021","210"
"35467","SAN NAZZARO SESIA",133,0,0,133,"2021","134"
"35468","SAN NAZZARO VAL CAVARGNA",4,0,6,10,"2021","207"
"35469","SAN NICOLO' DI COMELICO",2,10,0,12,"2021","046"
"35470","SAN PAOLO",224,2919,22,3165,"2021","138"
"35471","SAN PAOLO D'ARGON",28,0,0,28,"2021","189"
"35472","SAN PAOLO SOLBRITO",17,0,0,17,"2021","101"
"35473","SAN PELLEGRINO TERME",62,38,0,100,"2021","190"
"35474","SAN PIETRO DI CADORE",0,45,0,45,"2021","047"
"35475","SAN PIETRO DI FELETTO",40,14,11,65,"2021","073"
"35476","SAN PIETRO DI MORUBIO",2,0,0,2,"2021","075"
"35477","SAN PIETRO IN CASALE",3,447,0,450,"2021","055"
"35478","SAN PIETRO IN CERRO",101,989,0,1090,"2021","041"
"35479","SAN PIETRO IN GU",749,3078,0,3827,"2021","078"
"35480","SAN PIETRO MOSEZZO",1,0,0,1,"2021","135"
"35481","SAN PIETRO MUSSOLINO",19,0,0,19,"2021","094"
"35482","SAN PIETRO VAL LEMINA",9,0,0,9,"2021","250"
"35483","SAN PIETRO VIMINARIO",33,35,0,68,"2021","079"
"35484","SAN POLO D'ENZA",4,667,0,671,"2021","038"
"35485","SAN POLO DI PIAVE",979,62,0,1041,"2021","074"
"35486","SAN PONSO",2,34,0,36,"2021","251"
"35487","SAN POSSIDONIO",0,445,0,445,"2021","038"
"35488","SAN PROSPERO",0,360,0,360,"2021","039"
"35489","SAN RAFFAELE CIMENA",37,0,0,37,"2021","252"
"35490","SAN ROCCO AL PORTO",135,731,17,883,"2021","049"
"35491","SAN SALVATORE MONFERRATO",179,0,0,179,"2021","154"
"35492","SAN SEBASTIANO CURONE",15,0,0,15,"2021","155"
"35493","SAN SEBASTIANO DA PO",201,0,0,201,"2021","253"
"35494","SAN SECONDO DI PINEROLO",482,16,75,573,"2021","254"
"35495","SAN SECONDO PARMENSE",1,1449,0,1450,"2021","033"
"35496","SAN SIRO",1,0,3,4,"2021","248"
"35497","SAN VENDEMIANO",61,103,0,164,"2021","076"
"35498","SAN VITO DI LEGUZZANO",385,148,0,533,"2021","096"
"35499","SAN VITTORE OLONA",38,35,0,73,"2021","201"
"35500","SAN ZENO DI MONTAGNA",189,118,94,401,"2021","079"
"35501","SAN ZENO NAVIGLIO",0,860,0,860,"2021","173"
"35502","SAN ZENONE AL LAMBRO",0,899,0,899,"2021","202"
"35503","SAN ZENONE DEGLI EZZELINI",2731,418,5,3154,"2021","077"
"35504","SANDIGLIANO",73,90,16,179,"2021","059"
"35505","SANDRIGO",838,1650,30,2518,"2021","091"
"35506","SANFRE'",715,0,0,715,"2021","208"
"35507","SANFRONT",2641,177,38,2856,"2021","209"
"35508","SANGANO",51,0,20,71,"2021","241"
"35509","SANGIANO",0,51,0,51,"2021","141"
"35510","SANGUINETTO",3,201,0,204,"2021","072"
"35511","SANNAZZARO DE' BURGONDI",0,36,0,36,"2021","138"
"35512","SANT'AGATA BOLOGNESE",1,691,0,692,"2021","056"
"35513","SANT'AGATA FELTRIA",224,34,0,258,"2021","026"
"35514","SANT'AGATA FOSSILI",30,0,0,30,"2021","156"
"35515","SANT'AGATA SUL SANTERNO",23,0,0,23,"2021","017"
"35516","SANT'ALBANO STURA",4613,1065,139,5817,"2021","211"
"35517","SANT'AMBROGIO DI TORINO",76,24,0,100,"2021","255"
"35518","SANT'AMBROGIO DI VALPOLICELLA",3,53,0,56,"2021","077"
"35519","SANT'ANGELO DI PIOVE DI SACCO",313,61,0,374,"2021","082"
"35520","SANT'ANGELO LODIGIANO",30,385,0,415,"2021","050"
"35521","SANT'ANGELO LOMELLINA",0,531,0,531,"2021","144"
"35522","SANT'ANNA D'ALFAEDO",163,1329,134,1626,"2021","078"
"35523","SANT'ANTONINO DI SUSA",9,58,23,90,"2021","256"
"35524","SANT'ELENA",58,0,0,58,"2021","083"
"35525","SANT'ILARIO D'ENZA",3,677,0,680,"2021","039"
"35526","SANT'OMOBONO TERME",111,62,0,173,"2021","192"
"35527","SANT'URBANO",695,0,0,695,"2021","084"
"35528","SANTA BRIGIDA",7,15,0,22,"2021","191"
"35529","SANTA CRISTINA E BISSONE",6,274,0,280,"2021","139"
"35530","SANTA GIULETTA",9,0,0,9,"2021","140"
"35531","SANTA GIUSTINA",137,120,0,257,"2021","048"
"35532","SANTA GIUSTINA IN COLLE",1500,339,0,1839,"2021","080"
"35533","SANTA LUCIA DI PIAVE",27,49,8,84,"2021","075"
"35534","SANTA MARGHERITA DI STAFFORA",32,0,18,50,"2021","142"
"35535","SANTA MARIA DELLA VERSA",2,0,0,2,"2021","143"
"35536","SANTA MARIA DI SALA",67,146,10,223,"2021","035"
"35537","SANTA MARIA HOE'",6,0,0,6,"2021","074"
"35538","SANTA MARIA MAGGIORE",27,9,36,72,"2021","062"
"35539","SANTA SOFIA",249,0,1,250,"2021","043"
"35540","SANTA VITTORIA D'ALBA",46,0,0,46,"2021","212"
"35541","SANTARCANGELO DI ROMAGNA",27,0,0,27,"2021","018"
"35542","SANTENA",409,0,0,409,"2021","257"
"35543","SANTHIA'",412,34,0,446,"2021","133"
"35544","SANTO STEFANO BELBO",7,0,0,7,"2021","213"
"35545","SANTO STEFANO DI CADORE",2,19,0,21,"2021","050"
"35546","SANTO STEFANO LODIGIANO",135,399,3,537,"2021","051"
"35547","SANTO STEFANO ROERO",79,0,0,79,"2021","214"
"35548","SANTO STEFANO TICINO",0,0,61,61,"2021","200"
"35549","SANTO STINO DI LIVENZA",3841,102,1,3944,"2021","036"
"35550","SANTORSO",426,135,0,561,"2021","095"
"35551","SAONARA",281,0,0,281,"2021","085"
"35552","SARCEDO",1606,364,0,1970,"2021","097"
"35553","SAREGO",352,28,0,380,"2021","098"
"35554","SAREZZO",14,34,0,48,"2021","174"
"35555","SARMATO",0,303,0,303,"2021","042"
"35556","SARMEDE",48,19,12,79,"2021","078"
"35557","SARNICO",5,0,0,5,"2021","193"
"35558","SARONNO",6,0,0,6,"2021","119"
"35559","SARSINA",236,0,0,236,"2021","044"
"35560","SASSO MARCONI",54,92,0,146,"2021","057"
"35561","SASSUOLO",80,429,0,509,"2021","040"
"35562","SAUZE D'OULX",88,0,0,88,"2021","259"
"35563","SAUZE DI CESANA",22,0,12,34,"2021","258"
"35564","SAVIGLIANO",11525,4946,207,16678,"2021","215"
"35565","SAVIGNANO SUL PANARO",64,49,0,113,"2021","041"
"35566","SAVIGNANO SUL RUBICONE",61,0,0,61,"2021","045"
"35567","SAVIORE DELL'ADAMELLO",4,26,6,36,"2021","175"
"35568","SCAGNELLO",179,0,0,179,"2021","216"
"35569","SCALDASOLE",0,18,0,18,"2021","147"
"35570","SCALENGHE",1831,2371,211,4413,"2021","260"
"35571","SCANDIANO",29,1313,0,1342,"2021","040"
"35572","SCANDOLARA RAVARA",0,902,0,902,"2021","092"
"35573","SCANDOLARA RIPA D'OGLIO",35,708,215,958,"2021","093"
"35574","SCANZOROSCIATE",36,0,0,36,"2021","194"
"35575","SCARMAGNO",5,18,0,23,"2021","261"
"35576","SCARNAFIGI",1280,1635,86,3001,"2021","217"
"35577","SCHIAVON",1869,1862,0,3731,"2021","099"
"35578","SCHIGNANO",22,10,2,34,"2021","211"
"35579","SCHILPARIO",0,64,0,64,"2021","195"
"35580","SCHIO",437,219,0,656,"2021","100"
"35581","SCIOLZE",158,0,0,158,"2021","262"
"35582","SCOPELLO",18,10,0,28,"2021","135"
"35583","SCORZE'",3777,27,0,3804,"2021","037"
"35584","SECUGNAGO",0,1365,0,1365,"2021","052"
"35585","SEDICO",1210,149,1,1360,"2021","053"
"35586","SEDRIANO",18,822,0,840,"2021","204"
"35587","SEDRINA",26,14,0,40,"2021","196"
"35588","SEGRATE",26,0,0,26,"2021","205"
"35589","SEGUSINO",15,65,1,81,"2021","079"
"35590","SELLERO",4,22,3,29,"2021","176"
"35591","SELVA DI CADORE",0,4,0,4,"2021","054"
"35592","SELVA DI PROGNO",55,449,63,567,"2021","080"
"35593","SELVAZZANO DENTRO",35,0,22,57,"2021","086"
"35594","SENAGO",2,0,0,2,"2021",NA
"35595","SENIGA",1696,2126,0,3822,"2021","177"
"35596","SENNA COMASCO",7,0,37,44,"2021","212"
"35597","SENNA LODIGIANA",0,969,0,969,"2021","053"
"35598","SEREGNO",5,0,0,5,"2021",NA
"35599","SEREN DEL GRAPPA",84,48,204,336,"2021","055"
"35600","SERGNANO",20,1756,0,1776,"2021","094"
"35601","SERIATE",130,79,0,209,"2021","198"
"35602","SERINA",13,100,0,113,"2021","199"
"35603","SERLE",21,31,23,75,"2021","178"
"35604","SERMIDE E FELONICA",0,317,0,317,"2021",NA
"35605","SERNAGLIA DELLA BATTAGLIA",666,0,1,667,"2021","080"
"35606","SERNIO",5,0,0,5,"2021","059"
"35607","SEROLE",58,1,2,61,"2021","104"
"35608","SERRALUNGA D'ALBA",23,0,0,23,"2021","218"
"35609","SERRALUNGA DI CREA",11,0,0,11,"2021","159"
"35610","SERRAMAZZONI",28,1617,0,1645,"2021","042"
"35611","SERRAVALLE A PO",70,0,152,222,"2021","062"
"35612","SERRAVALLE LANGHE",121,0,0,121,"2021","219"
"35613","SERRAVALLE SCRIVIA",13,0,0,13,"2021","160"
"35614","SERRAVALLE SESIA",12,0,0,12,"2021","137"
"35615","SESTO CALENDE",32,0,1,33,"2021","120"
"35616","SESTO ED UNITI",1,2231,0,2232,"2021","095"
"35617","SESTOLA",40,366,0,406,"2021","043"
"35618","SETTALA",35,359,19,413,"2021","210"
"35619","SETTIME",140,0,0,140,"2021","106"
"35620","SETTIMO MILANESE",11,332,6,349,"2021","211"
"35621","SETTIMO ROTTARO",11,23,0,34,"2021","264"
"35622","SETTIMO TORINESE",457,429,45,931,"2021","265"
"35623","SETTIMO VITTONE",129,125,7,261,"2021","266"
"35624","SEZZADIO",33,0,0,33,"2021","161"
"35625","SILEA",6,123,0,129,"2021","081"
"35626","SILLAVENGO",32,0,123,155,"2021","138"
"35627","SILVANO D'ORBA",3,0,0,3,"2021","162"
"35628","SINIO",8,12,0,20,"2021","220"
"35629","SIRONE",7,87,5,99,"2021","075"
"35630","SIRTORI",5,0,0,5,"2021","076"
"35631","SISSA TRECASALI",10,846,0,856,"2021",NA
"35632","SIZIANO",53,87,0,140,"2021","150"
"35633","SIZZANO",173,7,68,248,"2021","139"
"35634","SOAVE",87,0,0,87,"2021","081"
"35635","SOGLIANO AL RUBICONE",211,29,0,240,"2021","046"
"35636","SOIANO DEL LAGO",3,0,4,7,"2021","180"
"35637","SOLAGNA",5,12,0,17,"2021","101"
"35638","SOLARO",0,23,0,23,"2021","213"
"35639","SOLAROLO RAINERIO",0,265,0,265,"2021","096"
"35640","SOLBIATE CON CAGNO",2,146,0,148,"2021",NA
"35641","SOLERO",355,0,0,355,"2021","163"
"35642","SOLESINO",4,0,0,4,"2021","087"
"35643","SOLFERINO",635,289,158,1082,"2021","063"
"35644","SOLIERA",19,1096,0,1115,"2021","044"
"35645","SOLIGNANO",16,238,0,254,"2021","035"
"35646","SOLONGHELLO",125,0,0,125,"2021","164"
"35647","SOLTO COLLINA",27,0,0,27,"2021","200"
"35648","SOMAGLIA",1,1283,0,1284,"2021","054"
"35649","SOMANO",62,0,0,62,"2021","221"
"35650","SOMMA LOMBARDO",25,30,0,55,"2021","123"
"35651","SOMMACAMPAGNA",1620,363,55,2038,"2021","082"
"35652","SOMMARIVA DEL BOSCO",1470,627,160,2257,"2021","222"
"35653","SOMMARIVA PERNO",19,0,0,19,"2021","223"
"35654","SOMMO",8,0,0,8,"2021","151"
"35655","SONA",1947,561,9,2517,"2021","083"
"35656","SONCINO",837,5357,127,6321,"2021","097"
"35657","SONDALO",17,93,17,127,"2021","060"
"35658","SONDRIO",18,46,0,64,"2021","061"
"35659","SONGAVAZZO",1,0,0,1,"2021","201"
"35660","SONICO",2,78,10,90,"2021","181"
"35661","SORAGNA",18,1705,0,1723,"2021","036"
"35662","SORBOLO MEZZANI",5,1869,0,1874,"2021",NA
"35663","SORDEVOLO",84,38,0,122,"2021","063"
"35664","SORDIO",0,248,0,248,"2021","055"
"35665","SORESINA",64,1226,174,1464,"2021","098"
"35666","SORGA'",981,27,0,1008,"2021","084"
"35667","SORICO",6,14,94,114,"2021","216"
"35668","SORISO",8,0,0,8,"2021","140"
"35669","SORISOLE",61,89,0,150,"2021","202"
"35670","SORMANO",52,0,0,52,"2021","217"
"35671","SOSPIRO",72,406,0,478,"2021","099"
"35672","SOSPIROLO",6,101,0,107,"2021","056"
"35673","SOSSANO",51,385,0,436,"2021","102"
"35674","SOSTEGNO",1,15,0,16,"2021","064"
"35675","SOTTO IL MONTE GIOVANNI XXIII",105,0,0,105,"2021","203"
"35676","SOVERE",59,36,0,95,"2021","204"
"35677","SOVERZENE",3,0,0,3,"2021","057"
"35678","SOVICO",1,0,0,1,"2021",NA
"35679","SOVIZZO",461,71,3,535,"2021","103"
"35680","SOVRAMONTE",59,83,0,142,"2021","058"
"35681","SOZZAGO",2,0,0,2,"2021","141"
"35682","SPARONE",33,62,0,95,"2021","267"
"35683","SPESSA",10,0,0,10,"2021","152"
"35684","SPIGNO MONFERRATO",154,6,45,205,"2021","165"
"35685","SPILAMBERTO",1962,1301,0,3263,"2021","045"
"35686","SPINEA",33,152,2,187,"2021","038"
"35687","SPINEDA",9,801,0,810,"2021","101"
"35688","SPINETO SCRIVIA",103,0,0,103,"2021","166"
"35689","SPINO D'ADDA",913,2108,0,3021,"2021","102"
"35690","SPINONE AL LAGO",4,0,0,4,"2021","205"
"35691","SPIRANO",5,1076,0,1081,"2021","206"
"35692","SPRESIANO",25,205,0,230,"2021","082"
"35693","STAGNO LOMBARDO",3,6750,0,6753,"2021","103"
"35694","STANGHELLA",434,0,0,434,"2021","088"
"35695","STAZZANO",5,0,0,5,"2021","167"
"35696","STAZZONA",4,5,0,9,"2021","218"
"35697","STEZZANO",220,456,0,676,"2021","207"
"35698","STIENTA",60,0,0,60,"2021","045"
"35699","STRA",11,0,0,11,"2021","039"
"35700","STRADELLA",0,34,0,34,"2021","153"
"35701","STRAMBINELLO",35,0,0,35,"2021",NA
"35702","STRAMBINO",178,0,0,178,"2021","269"
"35703","STRESA",90,0,0,90,"2021","064"
"35704","STREVI",25,0,0,25,"2021","168"
"35705","STRONA",1,0,0,1,"2021","065"
"35706","STROPPO",11,0,0,11,"2021","224"
"35707","STROZZA",6,0,0,6,"2021","208"
"35708","SUARDI",8,0,0,8,"2021","154"
"35709","SUEGLIO",0,0,1,1,"2021","077"
"35710","SUELLO",3,0,10,13,"2021","078"
"35711","SUISIO",1,109,0,110,"2021","209"
"35712","SULBIATE",31,0,0,31,"2021",NA
"35713","SULZANO",32,215,2,249,"2021","182"
"35714","SUMIRAGO",76,47,0,123,"2021","124"
"35715","SUNO",47,337,0,384,"2021","143"
"35716","SUSA",241,0,0,241,"2021","270"
"35717","SUSEGANA",765,48,2,815,"2021","083"
"35718","SUSTINENTE",648,656,264,1568,"2021","064"
"35719","SUZZARA",2215,1216,2005,5436,"2021","065"
"35720","TACENO",2,0,15,17,"2021","079"
"35721","TAGLIO DI PO",7801,0,0,7801,"2021","046"
"35722","TAGLIOLO MONFERRATO",50,0,0,50,"2021","169"
"35723","TAIBON AGORDINO",0,27,0,27,"2021","059"
"35724","TAINO",46,138,0,184,"2021","125"
"35725","TALAMELLO",1,0,0,1,"2021","027"
"35726","TALAMONA",14,183,18,215,"2021","063"
"35727","TALEGGIO",64,23,0,87,"2021","210"
"35728","TAMBRE",9,136,7,152,"2021","060"
"35729","TARANTASCA",2694,809,0,3503,"2021","225"
"35730","TARTANO",11,26,0,37,"2021","064"
"35731","TARZO",25,0,2,27,"2021","084"
"35732","TAVAGNASCO",137,0,0,137,"2021","271"
"35733","TAVAZZANO CON VILLAVESCO",0,1235,0,1235,"2021","056"
"35734","TAVERNOLA BERGAMASCA",5,3,0,8,"2021","211"
"35735","TAVERNOLE SUL MELLA",13,41,4,58,"2021","183"
"35736","TAVIGLIANO",4,0,0,4,"2021","066"
"35737","TEGLIO",65,238,17,320,"2021","065"
"35738","TELGATE",1943,155,0,2098,"2021","212"
"35739","TEMU'",10,7,16,33,"2021","184"
"35740","TEOLO",33,36,0,69,"2021","089"
"35741","TERDOBBIATE",6,156,0,162,"2021","144"
"35742","TERENZO",41,788,0,829,"2021","038"
"35743","TERNO D'ISOLA",10,0,0,10,"2021","213"
"35744","TERRANOVA DEI PASSERINI",0,233,252,485,"2021","057"
"35745","TERRASSA PADOVANA",1538,0,0,1538,"2021","090"
"35746","TERRAZZO",4,0,0,4,"2021","085"
"35747","TERRE DEL RENO",0,0,1,1,"2021",NA
"35748","TERRUGGIA",29,0,0,29,"2021","171"
"35749","TERZO",16,0,0,16,"2021","172"
"35750","TEZZE SUL BRENTA",95,226,0,321,"2021","104"
"35751","THIENE",493,372,0,865,"2021","105"
"35752","TICENGO",1,411,0,412,"2021","104"
"35753","TIGLIOLE",736,0,0,736,"2021","108"
"35754","TIGNALE",14,0,2,16,"2021","185"
"35755","TIRANO",3,17,3,23,"2021","066"
"35756","TIZZANO VAL PARMA",2,787,0,789,"2021","039"
"35757","TOANO",47,1945,0,1992,"2021","041"
"35758","TOCENO",31,4,14,49,"2021","065"
"35759","TOLLEGNO",41,0,0,41,"2021","068"
"35760","TOMBOLO",1218,12,0,1230,"2021","091"
"35761","TONCO",720,0,0,720,"2021","109"
"35762","TONENGO",84,0,0,84,"2021","110"
"35763","TONEZZA DEL CIMONE",1,0,1,2,"2021","106"
"35764","TORBOLE CASAGLIA",10,877,0,887,"2021","186"
"35765","TORINO",172,0,6,178,"2021","272"
"35766","TORLINO VIMERCATI",0,320,0,320,"2021","105"
"35767","TORNACO",0,110,0,110,"2021",NA
"35768","TORNATA",4,173,0,177,"2021","106"
"35769","TORNOLO",78,3,0,81,"2021","040"
"35770","TORRAZZA COSTE",18,0,0,18,"2021","155"
"35771","TORRAZZA PIEMONTE",199,0,0,199,"2021","273"
"35772","TORRAZZO",5,0,0,5,"2021","069"
"35773","TORRE BERETTI E CASTELLARO",7,363,0,370,"2021","156"
"35774","TORRE BOLDONE",5,0,0,5,"2021","214"
"35775","TORRE BORMIDA",8,0,0,8,"2021","226"
"35776","TORRE D'ISOLA",0,912,0,912,"2021","159"
"35777","TORRE DE' BUSI",9,0,0,9,"2021","080"
"35778","TORRE DE' NEGRI",14,11,135,160,"2021","158"
"35779","TORRE DE' PICENARDI",93,2652,0,2745,"2021","107"
"35780","TORRE DE' ROVERI",8,0,0,8,"2021","216"
"35781","TORRE DI MOSTO",7,584,0,591,"2021","041"
"35782","TORRE DI SANTA MARIA",13,6,8,27,"2021","067"
"35783","TORRE MONDOVI'",1,0,0,1,"2021","227"
"35784","TORRE PALLAVICINA",224,320,0,544,"2021","217"
"35785","TORRE PELLICE",81,0,26,107,"2021","275"
"35786","TORRE SAN GIORGIO",79,9,18,106,"2021","228"
"35787","TORREBELVICINO",983,9,0,992,"2021","107"
"35788","TORREGLIA",6,0,0,6,"2021","092"
"35789","TORRESINA",3,0,0,3,"2021","229"
"35790","TORREVECCHIA PIA",79,11,12,102,"2021","160"
"35791","TORRI DEL BENACO",5,0,0,5,"2021",NA
"35792","TORRI DI QUARTESOLO",43,138,0,181,"2021","108"
"35793","TORRICELLA VERZATE",1,0,0,1,"2021",NA
"35794","TORRILE",0,2522,0,2522,"2021","041"
"35795","TORTONA",3113,48,0,3161,"2021","174"
"35796","TOSCOLANO-MADERNO",4,0,0,4,"2021","187"
"35797","TOVO DI SANT'AGATA",8,67,1,76,"2021","068"
"35798","TRADATE",28,0,0,28,"2021","127"
"35799","TRANA",55,8,15,78,"2021","276"
"35800","TRAONA",77,191,0,268,"2021","069"
"35801","TRAREGO VIGGIONA",6,0,0,6,"2021","066"
"35802","TRASQUERA",20,0,5,25,"2021","067"
"35803","TRAVAGLIATO",610,457,0,1067,"2021","188"
"35804","TRAVEDONA-MONATE",6,0,7,13,"2021","128"
"35805","TRAVERSELLA",29,23,13,65,"2021","278"
"35806","TRAVERSETOLO",82,936,0,1018,"2021","042"
"35807","TRAVES",10,0,0,10,"2021","279"
"35808","TRAVO",46,21,0,67,"2021","043"
"35809","TREBASELEGHE",6650,93,1,6744,"2021","093"
"35810","TRECATE",0,95,0,95,"2021","149"
"35811","TRECENTA",465,167,0,632,"2021","047"
"35812","TREDOZIO",117,0,0,117,"2021","049"
"35813","TREGNAGO",561,126,0,687,"2021","087"
"35814","TREMEZZINA",23,15,38,76,"2021",NA
"35815","TREMOSINE",17,429,5,451,"2021","189"
"35816","TRENZANO",421,1449,120,1990,"2021","190"
"35817","TRESCORE BALNEARIO",34,62,12,108,"2021","218"
"35818","TRESCORE CREMASCO",18,532,0,550,"2021","109"
"35819","TRESIGNANA",1,0,0,1,"2021",NA
"35820","TRESIVIO",16,17,0,33,"2021","070"
"35821","TREVENZUOLO",474,1055,0,1529,"2021","088"
"35822","TREVIGLIO",913,1749,9,2671,"2021","219"
"35823","TREVIGNANO",1968,163,0,2131,"2021","085"
"35824","TREVILLE",13,0,0,13,"2021","175"
"35825","TREVIOLO",97,88,0,185,"2021","220"
"35826","TREVISO",525,123,13,661,"2021","086"
"35827","TREVISO BRESCIANO",7,39,2,48,"2021","191"
"35828","TREZZO SULL'ADDA",6,382,0,388,"2021","221"
"35829","TREZZO TINELLA",12,0,0,12,"2021","231"
"35830","TREZZONE",1,0,2,3,"2021","226"
"35831","TRIBANO",2,0,0,2,"2021","094"
"35832","TRIBIANO",1,58,0,59,"2021","222"
"35833","TRIGOLO",0,1098,0,1098,"2021","110"
"35834","TRINITA'",2696,529,404,3629,"2021","232"
"35835","TRINO",10,154,0,164,"2021","148"
"35836","TRISOBBIO",71,0,0,71,"2021","176"
"35837","TRISSINO",88,273,0,361,"2021","110"
"35838","TRIUGGIO",6,318,21,345,"2021",NA
"35839","TROFARELLO",604,67,0,671,"2021","280"
"35840","TROMELLO",28,443,206,677,"2021","164"
"35841","TRONTANO",9,14,0,23,"2021","068"
"35842","TRONZANO VERCELLESE",204,0,0,204,"2021","150"
"35843","TROVO",3,43,0,46,"2021","165"
"35844","TRUCCAZZANO",35,1816,16,1867,"2021","224"
"35845","TURANO LODIGIANO",67,2103,0,2170,"2021","058"
"35846","TURBIGO",0,42,0,42,"2021","226"
"35847","UBIALE CLANEZZO",10,0,0,10,"2021","221"
"35848","UBOLDO",3,0,0,3,"2021","130"
"35849","UGGIATE-TREVANO",10,50,7,67,"2021","228"
"35850","URAGO D'OGLIO",307,1232,18,1557,"2021","192"
"35851","URBANA",1008,0,0,1008,"2021","095"
"35852","URGNANO",176,155,0,331,"2021","222"
"35853","USMATE VELATE",10,28,2,40,"2021",NA
"35854","USSEAUX",8,31,56,95,"2021","281"
"35855","USSEGLIO",1,0,0,1,"2021","282"
"35856","VAIANO CREMASCO",189,657,0,846,"2021","111"
"35857","VAIE",14,48,0,62,"2021","283"
"35858","VAILATE",31,371,3,405,"2021","112"
"35859","VAL BREMBILLA",87,62,0,149,"2021",NA
"35860","VAL DELLA TORRE",230,0,19,249,"2021","284"
"35861","VAL DI CHY",33,9,0,42,"2021",NA
"35862","VAL DI ZOLDO",21,0,0,21,"2021",NA
"35863","VAL LIONA",369,176,0,545,"2021",NA
"35864","VAL MASINO",2,9,0,11,"2021","074"
"35865","VAL REZZO",24,0,13,37,"2021","233"
"35866","VALBONDIONE",1,13,0,14,"2021","223"
"35867","VALBREMBO",81,0,0,81,"2021","224"
"35868","VALBRENTA",25,29,4,58,"2021",NA
"35869","VALBRONA",6,0,1,7,"2021","229"
"35870","VALCHIUSA",110,122,37,269,"2021",NA
"35871","VALDAGNO",42,123,5,170,"2021","111"
"35872","VALDASTICO",680,1,0,681,"2021","112"
"35873","VALDENGO",40,19,0,59,"2021","071"
"35874","VALDIDENTRO",29,122,29,180,"2021","071"
"35875","VALDIERI",7,0,0,7,"2021","233"
"35876","VALDILANA",80,69,24,173,"2021",NA
"35877","VALDISOTTO",35,135,20,190,"2021","072"
"35878","VALDOBBIADENE",62,335,9,406,"2021","087"
"35879","VALDUGGIA",5,0,0,5,"2021","152"
"35880","VALEGGIO",58,0,0,58,"2021","167"
"35881","VALEGGIO SUL MINCIO",2126,2315,47,4488,"2021","089"
"35882","VALENZA",102,0,0,102,"2021","177"
"35883","VALERA FRATTA",12,258,152,422,"2021","059"
"35884","VALFENERA",958,103,267,1328,"2021","112"
"35885","VALFURVA",30,104,2,136,"2021","073"
"35886","VALGANNA",16,0,0,16,"2021","131"
"35887","VALGIOIE",1,0,0,1,"2021",NA
"35888","VALGOGLIO",17,46,0,63,"2021","225"
"35889","VALGRANA",366,0,0,366,"2021","234"
"35890","VALGREGHENTINO",8,0,0,8,"2021","082"
"35891","VALLADA AGORDINA",0,12,0,12,"2021","062"
"35892","VALLE CANNOBINA",1,0,0,1,"2021",NA
"35893","VALLE DI CADORE",1,0,0,1,"2021","063"
"35894","VALLE LOMELLINA",21,810,0,831,"2021","168"
"35895","VALLE SAN NICOLAO",8,0,0,8,"2021","074"
"35896","VALLEVE",0,5,0,5,"2021","226"
"35897","VALLI DEL PASUBIO",5,7,0,12,"2021","113"
"35898","VALLIO TERME",5,0,0,5,"2021","193"
"35899","VALLO TORINESE",17,0,0,17,"2021","286"
"35900","VALMADRERA",18,0,16,34,"2021","083"
"35901","VALMOREA",1,33,0,34,"2021","232"
"35902","VALMOZZOLA",45,31,0,76,"2021","044"
"35903","VALPERGA",201,111,16,328,"2021","287"
"35904","VALSAMOGGIA",288,823,0,1111,"2021",NA
"35905","VALSOLDA",4,5,3,12,"2021","234"
"35906","VALSTRONA",16,0,0,16,"2021","069"
"35907","VALTORTA",0,32,0,32,"2021","229"
"35908","VALVARRONE",2,0,1,3,"2021",NA
"35909","VALVESTINO",0,25,0,25,"2021","194"
"35910","VANZAGO",39,0,0,39,"2021","229"
"35911","VAPRIO D'ADDA",11,451,4,466,"2021","230"
"35912","VARALLO",18,50,0,68,"2021","156"
"35913","VARANO DE' MELEGARI",55,332,0,387,"2021","045"
"35914","VARESE",57,95,5,157,"2021","133"
"35915","VARISELLA",132,0,0,132,"2021","289"
"35916","VARSI",8,447,0,455,"2021","046"
"35917","VARZI",102,11,0,113,"2021","171"
"35918","VARZO",8,11,8,27,"2021","071"
"35919","VAUDA CANAVESE",45,0,0,45,"2021","290"
"35920","VAZZOLA",1394,72,4,1470,"2021","088"
"35921","VEDANO OLONA",3,227,0,230,"2021","134"
"35922","VEDELAGO",19250,520,122,19892,"2021","089"
"35923","VEDESETA",6,146,0,152,"2021","230"
"35924","VEGGIANO",378,73,0,451,"2021","096"
"35925","VEGLIO",1,0,0,1,"2021","075"
"35926","VELESO",0,0,13,13,"2021","236"
"35927","VELLEZZO BELLINI",11,394,8,413,"2021","173"
"35928","VELO D'ASTICO",995,16,0,1011,"2021","115"
"35929","VELO VERONESE",481,1556,40,2077,"2021","090"
"35930","VENARIA REALE",64,15,191,270,"2021","292"
"35931","VENASCA",46,0,0,46,"2021","237"
"35932","VENAUS",7,18,38,63,"2021","291"
"35933","VENEGONO INFERIORE",0,77,0,77,"2021","136"
"35934","VENEGONO SUPERIORE",8,0,0,8,"2021","137"
"35935","VENEZIA",1555,204,0,1759,"2021","042"
"35936","VENIANO",62,67,0,129,"2021","238"
"35937","VENTASSO",66,370,0,436,"2021",NA
"35938","VERANO BRIANZA",1,0,0,1,"2021",NA
"35939","VERBANIA",60,0,3,63,"2021","072"
"35940","VERCANA",5,7,0,12,"2021","239"
"35941","VERCEIA",13,0,4,17,"2021","075"
"35942","VERCELLI",92,227,0,319,"2021","158"
"35943","VERDELLINO",0,70,0,70,"2021","232"
"35944","VERDELLO",261,59,0,320,"2021","233"
"35945","VERDERIO",40,0,73,113,"2021",NA
"35946","VERDUNO",77,0,0,77,"2021","238"
"35947","VERGATO",62,0,0,62,"2021","059"
"35948","VERGHERETO",642,1,0,643,"2021","050"
"35949","VERGIATE",24,0,0,24,"2021","138"
"35950","VERMEZZO CON ZELO",4,632,0,636,"2021",NA
"35951","VERNANTE",244,49,0,293,"2021","239"
"35952","VERNASCA",65,60,0,125,"2021","044"
"35953","VERNATE",12,83,0,95,"2021","236"
"35954","VEROLANUOVA",1122,1926,87,3135,"2021","195"
"35955","VEROLAVECCHIA",11,3764,0,3775,"2021","196"
"35956","VEROLENGO",568,42,0,610,"2021","293"
"35957","VERONA",3619,708,0,4327,"2021","091"
"35958","VERONELLA",4961,234,0,5195,"2021","092"
"35959","VERRETTO",4,0,0,4,"2021","174"
"35960","VERRONE",33,0,0,33,"2021","076"
"35961","VERRUA SAVOIA",595,0,0,595,"2021","294"
"35962","VERTEMATE CON MINOPRIO",3,0,0,3,"2021","242"
"35963","VERTOVA",13,42,0,55,"2021","234"
"35964","VERUCCHIO",178,0,0,178,"2021","020"
"35965","VERVIO",27,38,0,65,"2021","076"
"35966","VERZUOLO",1,0,0,1,"2021","240"
"35967","VESCOVANA",6,0,0,6,"2021","097"
"35968","VESCOVATO",2885,1558,0,4443,"2021","113"
"35969","VESIME",536,0,0,536,"2021","113"
"35970","VESPOLATE",12,98,0,110,"2021","158"
"35971","VESTENANOVA",443,184,0,627,"2021","093"
"35972","VESTIGNE'",5,117,0,122,"2021","295"
"35973","VESTONE",6,0,0,6,"2021","197"
"35974","VETTO",12,384,0,396,"2021","042"
"35975","VEZZA D'ALBA",2,0,0,2,"2021","241"
"35976","VEZZA D'OGLIO",2,133,37,172,"2021","198"
"35977","VEZZANO SUL CROSTOLO",6,102,0,108,"2021","043"
"35978","VIADANA",273,1408,1,1682,"2021","066"
"35979","VIADANICA",8,30,0,38,"2021","235"
"35980","VIALE",294,0,0,294,"2021","114"
"35981","VIALFRE'",17,0,2,19,"2021","296"
"35982","VIANO",2,737,0,739,"2021","044"
"35983","VIARIGI",26,0,0,26,"2021","115"
"35984","VICENZA",137,887,0,1024,"2021","116"
"35985","VICOFORTE",495,0,0,495,"2021","242"
"35986","VIDIGULFO",13,290,0,303,"2021","176"
"35987","VIDOR",2,411,8,421,"2021","090"
"35988","VIDRACCO",3,0,0,3,"2021","298"
"35989","VIGANO SAN MARTINO",9,0,0,9,"2021","236"
"35990","VIGASIO",625,808,3,1436,"2021","094"
"35991","VIGEVANO",41,0,10,51,"2021","177"
"35992","VIGGIU'",18,0,0,18,"2021","139"
"35993","VIGHIZZOLO D'ESTE",123,20,0,143,"2021","098"
"35994","VIGLIANO BIELLESE",4,0,0,4,"2021","077"
"35995","VIGLIANO D'ASTI",64,0,0,64,"2021","116"
"35996","VIGNALE MONFERRATO",227,0,0,227,"2021","179"
"35997","VIGNATE",0,284,56,340,"2021","237"
"35998","VIGNOLA",1,91,0,92,"2021","046"
"35999","VIGNOLE BORBERA",15,0,0,15,"2021","180"
"36000","VIGNOLO",1430,0,0,1430,"2021","243"
"36001","VIGO DI CADORE",6,10,0,16,"2021","065"
"36002","VIGODARZERE",327,59,0,386,"2021","099"
"36003","VIGOLO",4,196,0,200,"2021","237"
"36004","VIGOLZONE",42,573,0,615,"2021","045"
"36005","VIGONE",3214,1177,170,4561,"2021","299"
"36006","VIGONOVO",14,0,0,14,"2021","043"
"36007","VIGONZA",1063,171,0,1234,"2021","100"
"36008","VILLA BARTOLOMEA",321,0,0,321,"2021","095"
"36009","VILLA CARCINA",3,0,0,3,"2021","199"
"36010","VILLA CORTESE",24,0,0,24,"2021","248"
"36011","VILLA D'ADDA",10,0,0,10,"2021","238"
"36012","VILLA D'ALME'",125,6,0,131,"2021","239"
"36013","VILLA D'OGNA",1,46,0,47,"2021","241"
"36014","VILLA DEL CONTE",725,668,0,1393,"2021","101"
"36015","VILLA DI CHIAVENNA",1,15,1,17,"2021","077"
"36016","VILLA DI SERIO",17,0,0,17,"2021","240"
"36017","VILLA DI TIRANO",16,212,7,235,"2021","078"
"36018","VILLA ESTENSE",191,0,0,191,"2021","102"
"36019","VILLA GUARDIA",100,0,39,139,"2021","245"
"36020","VILLA MINOZZO",37,743,0,780,"2021","045"
"36021","VILLA SAN SECONDO",5,0,0,5,"2021","119"
"36022","VILLACHIARA",437,3271,11,3719,"2021","200"
"36023","VILLADEATI",11,0,0,11,"2021","182"
"36024","VILLADOSE",21,2,83,106,"2021","048"
"36025","VILLADOSSOLA",12,0,0,12,"2021","075"
"36026","VILLAFALLETTO",2275,789,255,3319,"2021","244"
"36027","VILLAFRANCA D'ASTI",229,0,0,229,"2021","117"
"36028","VILLAFRANCA DI VERONA",8941,3347,115,12403,"2021","096"
"36029","VILLAFRANCA PADOVANA",698,2171,70,2939,"2021","103"
"36030","VILLAFRANCA PIEMONTE",2382,2191,308,4881,"2021","300"
"36031","VILLAGA",146,206,0,352,"2021","117"
"36032","VILLALVERNIA",2,0,0,2,"2021",NA
"36033","VILLAMARZANA",910,92,0,1002,"2021","049"
"36034","VILLANOVA BIELLESE",387,0,0,387,"2021","079"
"36035","VILLANOVA CANAVESE",32,9,9,50,"2021","301"
"36036","VILLANOVA D'ASTI",3942,85,0,4027,"2021","118"
"36037","VILLANOVA DEL GHEBBO",44,0,0,44,"2021","050"
"36038","VILLANOVA DEL SILLARO",0,949,7,956,"2021","060"
"36039","VILLANOVA DI CAMPOSAMPIERO",30,17,1,48,"2021","104"
"36040","VILLANOVA MARCHESANA",0,99,0,99,"2021","051"
"36041","VILLANOVA MONDOVI'",2436,446,155,3037,"2021","245"
"36042","VILLANOVA MONFERRATO",1,64,0,65,"2021","185"
"36043","VILLANOVA SOLARO",280,619,7,906,"2021","246"
"36044","VILLANOVA SULL'ARDA",7,1638,0,1645,"2021","046"
"36045","VILLANTERIO",2,0,197,199,"2021","180"
"36046","VILLANUOVA SUL CLISI",4,0,0,4,"2021","201"
"36047","VILLAR DORA",73,0,27,100,"2021","303"
"36048","VILLAR FOCCHIARDO",10,32,66,108,"2021","305"
"36049","VILLAR PELLICE",218,30,18,266,"2021","306"
"36050","VILLAR PEROSA",9,13,0,22,"2021","307"
"36051","VILLAR SAN COSTANZO",447,238,3,688,"2021","247"
"36052","VILLARBASSE",225,16,2,243,"2021","302"
"36053","VILLAREGGIA",60,0,0,60,"2021","304"
"36054","VILLAROMAGNANO",28,0,0,28,"2021","186"
"36055","VILLASTELLONE",653,500,105,1258,"2021","308"
"36056","VILLATA",12,33,0,45,"2021","164"
"36057","VILLAVERLA",85,1402,0,1487,"2021","118"
"36058","VILLETTE",24,0,33,57,"2021","076"
"36059","VILLIMPENTA",97,28,2,127,"2021","068"
"36060","VILLONGO",11,0,0,11,"2021","242"
"36061","VILLORBA",88,0,0,88,"2021","091"
"36062","VILMINORE DI SCALVE",13,177,0,190,"2021","243"
"36063","VIMERCATE",1,36,0,37,"2021",NA
"36064","VINADIO",212,0,0,212,"2021","248"
"36065","VINCHIO",2,0,0,2,"2021","120"
"36066","VINOVO",358,169,24,551,"2021","309"
"36067","VINZAGLIO",13,37,0,50,"2021","164"
"36068","VIOLA",60,0,0,60,"2021","249"
"36069","VIONE",11,17,1,29,"2021","202"
"36070","VIRLE PIEMONTE",352,219,151,722,"2021","310"
"36071","VISANO",2280,457,13,2750,"2021","203"
"36072","VISCHE",31,0,0,31,"2021","311"
"36073","VISONE",47,0,0,47,"2021","187"
"36074","VISTARINO",43,0,0,43,"2021","181"
"36075","VISTRORIO",16,0,6,22,"2021","312"
"36076","VITTORIO VENETO",131,120,2,253,"2021","092"
"36077","VITTUONE",1,195,0,196,"2021","243"
"36078","VIU'",38,0,5,43,"2021","313"
"36079","VIVERONE",40,0,0,40,"2021","080"
"36080","VIZZOLO PREDABISSI",14,0,60,74,"2021","244"
"36081","VO'",57,73,0,130,"2021","105"
"36082","VOBARNO",27,101,22,150,"2021","204"
"36083","VOCCA",0,19,0,19,"2021","166"
"36084","VODO CADORE",0,0,21,21,"2021","066"
"36085","VOGHERA",60,0,0,60,"2021","182"
"36086","VOGOGNA",15,6,0,21,"2021","077"
"36087","VOLONGO",29,0,0,29,"2021","114"
"36088","VOLPAGO DEL MONTELLO",584,613,19,1216,"2021","093"
"36089","VOLPEDO",2,0,0,2,"2021","188"
"36090","VOLPIANO",281,161,18,460,"2021","314"
"36091","VOLTA MANTOVANA",3322,1343,988,5653,"2021","070"
"36092","VOLTAGGIO",21,0,64,85,"2021","190"
"36093","VOLTAGO AGORDINO",1,0,0,1,"2021",NA
"36094","VOLTIDO",0,282,0,282,"2021","115"
"36095","VOLVERA",1236,363,0,1599,"2021","315"
"36096","VOTTIGNASCO",1688,107,53,1848,"2021","250"
"36097","ZANDOBBIO",8,0,0,8,"2021","244"
"36098","ZANE'",300,128,0,428,"2021","119"
"36099","ZANICA",230,1302,0,1532,"2021","245"
"36100","ZAVATTARELLO",67,0,0,67,"2021","184"
"36101","ZECCONE",8,245,0,253,"2021","185"
"36102","ZELBIO",0,0,10,10,"2021","246"
"36103","ZELO BUON PERSICO",1,1354,0,1355,"2021","061"
"36104","ZEME",58,24,0,82,"2021","186"
"36105","ZENEVREDO",3,0,0,3,"2021","187"
"36106","ZENSON DI PIAVE",9,0,0,9,"2021","094"
"36107","ZERBOLO'",0,171,0,171,"2021","189"
"36108","ZERMEGHEDO",0,51,0,51,"2021","120"
"36109","ZERO BRANCO",296,121,7,424,"2021","095"
"36110","ZEVIO",3903,633,114,4650,"2021","097"
"36111","ZIANO PIACENTINO",77,0,0,77,"2021","048"
"36112","ZIBIDO SAN GIACOMO",40,394,0,434,"2021","247"
"36113","ZIMELLA",8424,509,0,8933,"2021","098"
"36114","ZIMONE",2,0,0,2,"2021",NA
"36115","ZINASCO",38,0,0,38,"2021","190"
"36116","ZOCCA",35,777,0,812,"2021","047"
"36117","ZOGNO",89,61,0,150,"2021","246"
"36118","ZOLA PREDOSA",12,142,0,154,"2021","060"
"36119","ZONE",4,26,0,30,"2021","205"
"36120","ZOPPE' DI CADORE",0,6,0,6,"2021",NA
"36121","ZOVENCEDO",6,0,0,6,"2021","121"
"36122","ZUBIENA",38,0,19,57,"2021","082"
"36123","ZUGLIANO",574,127,20,721,"2021","122"
"36124","ZUMAGLIA",59,0,0,59,"2021","083"
"36125","ABANO TERME",53,152,0,205,"2022","001"
"36126","ABBADIA CERRETO",0,1318,0,1318,"2022","001"
"36127","ABBADIA LARIANA",3,27,6,36,"2022","001"
"36128","ABBIATEGRASSO",56,1577,3,1636,"2022","002"
"36129","ACCEGLIO",130,0,0,130,"2022","001"
"36130","ACQUAFREDDA",1365,88,0,1453,"2022","001"
"36131","ACQUANEGRA CREMONESE",2,996,0,998,"2022","001"
"36132","ACQUANEGRA SUL CHIESE",1023,440,426,1889,"2022","001"
"36133","ACQUI TERME",187,0,0,187,"2022","001"
"36134","ADRARA SAN MARTINO",34,25,0,59,"2022","001"
"36135","ADRARA SAN ROCCO",12,0,0,12,"2022","002"
"36136","ADRIA",2287,147,0,2434,"2022","001"
"36137","ADRO",484,19,0,503,"2022","002"
"36138","AGAZZANO",117,433,0,550,"2022","001"
"36139","AGLIANO TERME",24,0,0,24,"2022","001"
"36140","AGLIE'",360,32,17,409,"2022","001"
"36141","AGNA",226,0,0,226,"2022","002"
"36142","AGNADELLO",4,1890,39,1933,"2022","002"
"36143","AGNOSINE",9,41,4,54,"2022","003"
"36144","AGORDO",2,8,0,10,"2022","001"
"36145","AGRATE CONTURBIA",23,0,0,23,"2022","001"
"36146","AGUGLIARO",344,2,0,346,"2022","001"
"36147","AICURZIO",6,0,22,28,"2022",NA
"36148","AILOCHE",0,6,0,6,"2022","001"
"36149","AIRASCA",716,762,0,1478,"2022","002"
"36150","AIRUNO",6,0,0,6,"2022","002"
"36151","AISONE",34,0,0,34,"2022","002"
"36152","ALA DI STURA",29,0,0,29,"2022","003"
"36153","ALAGNA VALSESIA",55,30,0,85,"2022","002"
"36154","ALANO DI PIAVE",389,51,0,440,"2022","002"
"36155","ALBA",707,0,0,707,"2022","003"
"36156","ALBAIRATE",36,591,6,633,"2022","005"
"36157","ALBANO SANT'ALESSANDRO",2,0,0,2,"2022","003"
"36158","ALBAREDO D'ADIGE",10734,198,0,10932,"2022","002"
"36159","ALBAREDO PER SAN MARCO",3,17,0,20,"2022","001"
"36160","ALBARETO",210,55,0,265,"2022","001"
"36161","ALBARETTO DELLA TORRE",26,0,0,26,"2022","004"
"36162","ALBERA LIGURE",37,0,0,37,"2022","002"
"36163","ALBESE CON CASSANO",0,0,3,3,"2022","004"
"36164","ALBETTONE",2143,766,37,2946,"2022","002"
"36165","ALBIANO D'IVREA",122,29,0,151,"2022","004"
"36166","ALBIATE",295,0,0,295,"2022",NA
"36167","ALBIGNASEGO",111,229,2,342,"2022","003"
"36168","ALBINEA",30,1076,0,1106,"2022","001"
"36169","ALBINO",71,56,0,127,"2022","004"
"36170","ALBIOLO",3,7,0,10,"2022","005"
"36171","ALBIZZATE",8,0,0,8,"2022","002"
"36172","ALBOSAGGIA",46,69,52,167,"2022","002"
"36173","ALBUGNANO",61,0,0,61,"2022","002"
"36174","ALBUZZANO",36,0,0,36,"2022","004"
"36175","ALESSANDRIA",7576,2128,128,9832,"2022","003"
"36176","ALFIANELLO",0,538,3,541,"2022","004"
"36177","ALFIANO NATTA",34,0,0,34,"2022","004"
"36178","ALFONSINE",74,0,0,74,"2022","001"
"36179","ALGUA",14,4,0,18,"2022","248"
"36180","ALICE BEL COLLE",2,0,0,2,"2022","005"
"36181","ALICE CASTELLO",803,30,0,833,"2022","004"
"36182","ALLEGHE",3,0,0,3,"2022","003"
"36183","ALLUVIONI PIOVERA",248,99,0,347,"2022",NA
"36184","ALME'",1,0,0,1,"2022","005"
"36185","ALMENNO SAN BARTOLOMEO",26,0,0,26,"2022","006"
"36186","ALMENNO SAN SALVATORE",3,0,0,3,"2022","007"
"36187","ALMESE",52,21,0,73,"2022","006"
"36188","ALONTE",752,15,0,767,"2022","003"
"36189","ALPAGO",29,203,0,232,"2022",NA
"36190","ALPIGNANO",260,94,35,389,"2022","008"
"36191","ALSENO",9,993,0,1002,"2022","002"
"36192","ALSERIO",3,0,0,3,"2022","006"
"36193","ALTA VAL TIDONE",850,206,0,1056,"2022",NA
"36194","ALTA VALLE INTELVI",40,28,0,68,"2022",NA
"36195","ALTAVILLA MONFERRATO",71,0,0,71,"2022","007"
"36196","ALTAVILLA VICENTINA",110,0,0,110,"2022","004"
"36197","ALTISSIMO",12,41,0,53,"2022","005"
"36198","ALTIVOLE",11315,29,9,11353,"2022","001"
"36199","ALTO RENO TERME",101,0,0,101,"2022",NA
"36200","ALTO SERMENZA",8,14,0,22,"2022",NA
"36201","ALZANO LOMBARDO",16,38,0,54,"2022","008"
"36202","ALZANO SCRIVIA",2,0,0,2,"2022","008"
"36203","ALZATE BRIANZA",9,148,0,157,"2022","007"
"36204","AMBIVERE",1,0,0,1,"2022","009"
"36205","AMENO",27,10,13,50,"2022","002"
"36206","ANDALO VALTELLINO",19,0,0,19,"2022",NA
"36207","ANDEZENO",262,0,0,262,"2022","009"
"36208","ANDORNO MICCA",22,0,59,81,"2022","002"
"36209","ANDRATE",46,0,2,48,"2022","010"
"36210","ANFO",0,21,0,21,"2022","005"
"36211","ANGERA",60,121,17,198,"2022","003"
"36212","ANGOLO TERME",5,50,1,56,"2022","006"
"36213","ANGROGNA",120,0,38,158,"2022","011"
"36214","ANGUILLARA VENETA",8,0,0,8,"2022","004"
"36215","ANNICCO",3,902,292,1197,"2022","003"
"36216","ANNONE DI BRIANZA",30,0,0,30,"2022","003"
"36217","ANNONE VENETO",12,0,3,15,"2022","001"
"36218","ANTEGNATE",784,1753,0,2537,"2022","010"
"36219","ANTIGNANO",39,0,0,39,"2022","003"
"36220","ANTRONA SCHIERANCO",4,0,0,4,"2022","001"
"36221","ANZANO DEL PARCO",1,94,5,100,"2022","009"
"36222","ANZOLA D'OSSOLA",2,202,0,204,"2022","002"
"36223","ANZOLA DELL'EMILIA",9,564,0,573,"2022","001"
"36224","APPIANO GENTILE",61,274,33,368,"2022","010"
"36225","APRICA",0,2,0,2,"2022","004"
"36226","ARAMENGO",204,0,0,204,"2022","004"
"36227","ARCADE",699,54,0,753,"2022","002"
"36228","ARCENE",4,470,0,474,"2022","011"
"36229","ARCISATE",105,945,0,1050,"2022","004"
"36230","ARCOLE",1195,69,0,1264,"2022","004"
"36231","ARCONATE",26,95,0,121,"2022","007"
"36232","ARCORE",25,0,6,31,"2022",NA
"36233","ARCUGNANO",68,1,0,69,"2022","006"
"36234","ARDENNO",15,58,0,73,"2022","005"
"36235","ARDESIO",31,159,0,190,"2022","012"
"36236","ARENA PO",34,463,34,531,"2022","005"
"36237","ARESE",0,142,0,142,"2022","009"
"36238","ARGEGNO",2,0,0,2,"2022","011"
"36239","ARGELATO",102,71,0,173,"2022","002"
"36240","ARGENTA",1555,7,0,1562,"2022","001"
"36241","ARGUELLO",77,0,0,77,"2022","007"
"36242","ARIANO NEL POLESINE",612,172,0,784,"2022","002"
"36243","ARIGNANO",542,0,0,542,"2022","012"
"36244","ARLUNO",26,301,21,348,"2022","010"
"36245","ARMENO",90,83,0,173,"2022","006"
"36246","AROLA",2,0,3,5,"2022","004"
"36247","ARONA",1,0,0,1,"2022","008"
"36248","ARQUA' PETRARCA",127,0,0,127,"2022","005"
"36249","ARQUA' POLESINE",917,0,0,917,"2022","003"
"36250","ARQUATA SCRIVIA",1,0,0,1,"2022","009"
"36251","ARRE",4,6,0,10,"2022","006"
"36252","ARSAGO SEPRIO",6,0,0,6,"2022","005"
"36253","ARSIE'",9,359,0,368,"2022","004"
"36254","ARSIERO",2,11,4,17,"2022","007"
"36255","ARTOGNE",7,354,34,395,"2022","007"
"36256","ARZAGO D'ADDA",252,1166,0,1418,"2022","013"
"36257","ARZERGRANDE",225,121,0,346,"2022","007"
"36258","ARZIGNANO",118,275,2,395,"2022","008"
"36259","ASIAGO",40,1207,52,1299,"2022","009"
"36260","ASIGLIANO VENETO",173,0,0,173,"2022","010"
"36261","ASIGLIANO VERCELLESE",9,0,0,9,"2022","007"
"36262","ASOLA",10016,1693,1214,12923,"2022","002"
"36263","ASOLO",9046,596,68,9710,"2022","003"
"36264","ASSAGO",1,0,0,1,"2022","011"
"36265","ASSO",6,0,6,12,"2022","013"
"36266","ASTI",2343,0,0,2343,"2022","005"
"36267","AURANO",17,0,0,17,"2022","005"
"36268","AURONZO DI CADORE",25,13,0,38,"2022","005"
"36269","AVIATICO",0,17,0,17,"2022","015"
"36270","AVIGLIANA",164,52,8,224,"2022","013"
"36271","AVOLASCA",311,0,0,311,"2022","010"
"36272","AZEGLIO",96,9,75,180,"2022","014"
"36273","AZZANELLO",0,302,0,302,"2022","004"
"36274","AZZANO MELLA",85,986,0,1071,"2022","008"
"36275","AZZANO SAN PAOLO",17,192,0,209,"2022","016"
"36276","AZZATE",19,0,10,29,"2022","006"
"36277","AZZIO",3,137,0,140,"2022","007"
"36278","BACENO",5,29,0,34,"2022","006"
"36279","BADIA CALAVENA",1225,260,0,1485,"2022","005"
"36280","BADIA PAVESE",101,0,0,101,"2022","006"
"36281","BADIA POLESINE",200,0,0,200,"2022","004"
"36282","BAGNACAVALLO",48,0,0,48,"2022","002"
"36283","BAGNARIA",34,0,0,34,"2022","007"
"36284","BAGNASCO",144,0,0,144,"2022","008"
"36285","BAGNATICA",2,61,0,63,"2022","018"
"36286","BAGNO DI ROMAGNA",1653,18,0,1671,"2022","001"
"36287","BAGNOLI DI SOPRA",907,6,0,913,"2022","008"
"36288","BAGNOLO CREMASCO",2,2043,0,2045,"2022","005"
"36289","BAGNOLO IN PIANO",1,535,0,536,"2022","002"
"36290","BAGNOLO MELLA",730,3336,318,4384,"2022","009"
"36291","BAGNOLO PIEMONTE",749,0,139,888,"2022","009"
"36292","BAGNOLO SAN VITO",196,2926,855,3977,"2022","003"
"36293","BAGOLINO",3,259,4,266,"2022","010"
"36294","BAIRO",95,92,5,192,"2022","015"
"36295","BAISO",9,945,0,954,"2022","003"
"36296","BALANGERO",133,11,125,269,"2022","016"
"36297","BALDICHIERI D'ASTI",46,0,0,46,"2022","007"
"36298","BALDISSERO CANAVESE",0,67,0,67,"2022","017"
"36299","BALDISSERO D'ALBA",661,0,0,661,"2022","010"
"36300","BALDISSERO TORINESE",160,0,0,160,"2022","018"
"36301","BALLABIO",5,82,8,95,"2022","004"
"36302","BALME",6,0,0,6,"2022","019"
"36303","BALOCCO",73,0,52,125,"2022","009"
"36304","BANCHETTE",3,0,3,6,"2022","020"
"36305","BANNIO ANZINO",76,0,0,76,"2022","007"
"36306","BAONE",4,0,0,4,"2022","009"
"36307","BARBANIA",14,121,86,221,"2022","021"
"36308","BARBARANO MOSSANO",700,346,0,1046,"2022",NA
"36309","BARBARESCO",10,0,0,10,"2022","011"
"36310","BARBARIGA",1084,1638,62,2784,"2022","011"
"36311","BARBATA",0,822,0,822,"2022","019"
"36312","BARBIANELLO",135,2,0,137,"2022","008"
"36313","BARBONA",261,0,4,265,"2022","010"
"36314","BARDELLO",21,0,0,21,"2022","009"
"36315","BARDI",71,640,0,711,"2022","002"
"36316","BARDOLINO",25,90,0,115,"2022","006"
"36317","BARDONECCHIA",18,0,0,18,"2022","022"
"36318","BAREGGIO",12,142,0,154,"2022","012"
"36319","BARENGO",0,166,0,166,"2022","012"
"36320","BARGE",4562,1597,449,6608,"2022","012"
"36321","BARGHE",5,13,0,18,"2022","012"
"36322","BARIANO",38,378,0,416,"2022","020"
"36323","BARLASSINA",2,0,0,2,"2022",NA
"36324","BARNI",3,4,1,8,"2022","015"
"36325","BAROLO",33,0,0,33,"2022","013"
"36326","BARONE CANAVESE",47,33,0,80,"2022","023"
"36327","BARZAGO",135,0,0,135,"2022","005"
"36328","BARZANO'",2,0,6,8,"2022","006"
"36329","BARZIO",8,45,72,125,"2022","007"
"36330","BASALUZZO",226,0,0,226,"2022","012"
"36331","BASCAPE'",33,970,0,1003,"2022","009"
"36332","BASIGLIO",0,89,0,89,"2022","015"
"36333","BASSANO BRESCIANO",0,129,0,129,"2022","013"
"36334","BASSANO DEL GRAPPA",105,217,10,332,"2022","012"
"36335","BASSIGNANA",1,0,0,1,"2022","013"
"36336","BASTIA MONDOVI'",736,0,7,743,"2022","014"
"36337","BASTIDA PANCARANA",2,0,0,2,"2022","011"
"36338","BASTIGLIA",136,0,0,136,"2022","001"
"36339","BATTAGLIA TERME",7,0,0,7,"2022","011"
"36340","BEDERO VALCUVIA",15,0,0,15,"2022","010"
"36341","BEDIZZOLE",4007,1316,42,5365,"2022","014"
"36342","BEDONIA",379,78,0,457,"2022","003"
"36343","BEDULITA",5,0,0,5,"2022","022"
"36344","BEE",3,0,0,3,"2022","009"
"36345","BEINETTE",810,310,0,1120,"2022","016"
"36346","BELFIORE",2947,0,0,2947,"2022","007"
"36347","BELGIOIOSO",0,130,0,130,"2022","013"
"36348","BELLAGIO",3,70,44,117,"2022","019"
"36349","BELLANO",9,1,4,14,"2022","008"
"36350","BELLARIA-IGEA MARINA",5,0,0,5,"2022","001"
"36351","BELLINO",149,0,0,149,"2022","017"
"36352","BELLINZAGO LOMBARDO",437,1352,9,1798,"2022","016"
"36353","BELLINZAGO NOVARESE",484,763,0,1247,"2022","016"
"36354","BELLUNO",737,245,168,1150,"2022","006"
"36355","BELVEDERE LANGHE",61,0,90,151,"2022","018"
"36356","BENE LARIO",2,0,66,68,"2022","021"
"36357","BENE VAGIENNA",1855,489,0,2344,"2022","019"
"36358","BENEVELLO",67,0,0,67,"2022","020"
"36359","BENNA",4,21,34,59,"2022","003"
"36360","BENTIVOGLIO",11,95,0,106,"2022","005"
"36361","BERBENNO",11,42,0,53,"2022","023"
"36362","BERBENNO DI VALTELLINA",23,150,0,173,"2022","007"
"36363","BERCETO",59,282,0,341,"2022","004"
"36364","BEREGAZZO CON FIGLIARO",4,0,0,4,"2022","022"
"36365","BEREGUARDO",4,417,129,550,"2022","014"
"36366","BERGAMASCO",20,0,0,20,"2022","015"
"36367","BERGAMO",102,101,0,203,"2022","024"
"36368","BERLINGO",1765,269,14,2048,"2022","015"
"36369","BERNAREGGIO",1,12,0,13,"2022",NA
"36370","BERNATE TICINO",0,109,28,137,"2022","019"
"36371","BERNEZZO",311,33,0,344,"2022","022"
"36372","BERTINORO",96,10,0,106,"2022","003"
"36373","BERTONICO",0,2620,0,2620,"2022","002"
"36374","BERZANO DI SAN PIETRO",7,0,0,7,"2022","009"
"36375","BERZO DEMO",3,49,5,57,"2022","016"
"36376","BERZO INFERIORE",5,155,0,160,"2022","017"
"36377","BERZO SAN FERMO",683,85,0,768,"2022","025"
"36378","BESANA IN BRIANZA",726,46,14,786,"2022",NA
"36379","BESANO",18,0,23,41,"2022","011"
"36380","BESATE",150,0,4,154,"2022","022"
"36381","BESENZONE",185,1980,0,2165,"2022","003"
"36382","BESNATE",1,180,0,181,"2022","012"
"36383","BESOZZO",7,55,0,62,"2022","013"
"36384","BETTOLA",583,60,0,643,"2022","004"
"36385","BEURA-CARDEZZA",29,3,4,36,"2022","011"
"36386","BEVILACQUA",54,32,0,86,"2022","008"
"36387","BIANDRONNO",22,0,1,23,"2022","014"
"36388","BIANZANO",5,6,0,11,"2022","026"
"36389","BIANZE'",74,443,0,517,"2022","011"
"36390","BIANZONE",1,13,0,14,"2022","008"
"36391","BIASSONO",9,0,0,9,"2022",NA
"36392","BIBBIANO",49,2589,0,2638,"2022","004"
"36393","BIBIANA",481,0,15,496,"2022","025"
"36394","BIELLA",132,70,107,309,"2022","004"
"36395","BIENNO",5,162,7,174,"2022","018"
"36396","BINAGO",28,184,0,212,"2022","023"
"36397","BIOGLIO",9,0,2,11,"2022","005"
"36398","BIONE",3,9,1,13,"2022","019"
"36399","BISTAGNO",3,0,0,3,"2022","017"
"36400","BISUSCHIO",3,0,0,3,"2022","015"
"36401","BIZZARONE",0,16,7,23,"2022","024"
"36402","BLELLO",0,75,0,75,"2022","027"
"36403","BLESSAGNO",0,0,3,3,"2022","025"
"36404","BOARA PISANI",1,0,0,1,"2022","012"
"36405","BOBBIO",355,71,0,426,"2022","005"
"36406","BOBBIO PELLICE",46,16,122,184,"2022","026"
"36407","BOCCIOLETO",2,7,0,9,"2022","014"
"36408","BOFFALORA D'ADDA",0,193,0,193,"2022","003"
"36409","BOFFALORA SOPRA TICINO",62,94,44,200,"2022","026"
"36410","BOGOGNO",3,0,0,3,"2022",NA
"36411","BOLGARE",63,209,0,272,"2022","028"
"36412","BOLLATE",6,257,0,263,"2022","027"
"36413","BOLLENGO",31,48,14,93,"2022","027"
"36414","BOLOGNA",11,0,18,29,"2022","006"
"36415","BOLTIERE",15,13,0,28,"2022","029"
"36416","BOLZANO NOVARESE",0,9,0,9,"2022","022"
"36417","BOLZANO VICENTINO",135,1258,0,1393,"2022","013"
"36418","BOMPORTO",49,161,0,210,"2022","002"
"36419","BONATE SOPRA",313,0,0,313,"2022","030"
"36420","BONATE SOTTO",42,0,0,42,"2022","031"
"36421","BONAVIGO",3623,34,29,3686,"2022","009"
"36422","BONDENO",686,381,0,1067,"2022","003"
"36423","BONEMERSE",28,190,0,218,"2022","006"
"36424","BORDOLANO",28,705,0,733,"2022","007"
"36425","BORE",95,0,0,95,"2022","005"
"36426","BORETTO",0,249,0,249,"2022","005"
"36427","BORGARO TORINESE",92,36,0,128,"2022","028"
"36428","BORGHETTO DI BORBERA",126,0,0,126,"2022","018"
"36429","BORGHETTO LODIGIANO",18,1788,193,1999,"2022","004"
"36430","BORGHI",29,0,0,29,"2022","004"
"36431","BORGIALLO",6,32,0,38,"2022","029"
"36432","BORGO D'ALE",293,0,0,293,"2022","015"
"36433","BORGO DI TERZO",1,0,0,1,"2022","032"
"36434","BORGO MANTOVANO",15,1033,79,1127,"2022",NA
"36435","BORGO PRIOLO",9,0,0,9,"2022","016"
"36436","BORGO SAN DALMAZZO",478,0,0,478,"2022","025"
"36437","BORGO SAN GIACOMO",1441,3594,106,5141,"2022","020"
"36438","BORGO SAN GIOVANNI",7,1019,0,1026,"2022","005"
"36439","BORGO SAN SIRO",1,916,0,917,"2022","018"
"36440","BORGO TICINO",27,0,0,27,"2022","025"
"36441","BORGO TOSSIGNANO",14,0,0,14,"2022","007"
"36442","BORGO VAL DI TARO",153,232,0,385,"2022","006"
"36443","BORGO VALBELLUNA",149,778,18,945,"2022",NA
"36444","BORGO VENETO",1671,40,0,1711,"2022",NA
"36445","BORGO VERCELLI",3,0,0,3,"2022","017"
"36446","BORGO VIRGILIO",141,4223,2362,6726,"2022",NA
"36447","BORGOCARBONARA",1,488,229,718,"2022",NA
"36448","BORGOFRANCO D'IVREA",190,10,9,209,"2022","030"
"36449","BORGOLAVEZZARO",1,0,0,1,"2022","023"
"36450","BORGOMALE",19,0,0,19,"2022","024"
"36451","BORGOMANERO",128,15,0,143,"2022","024"
"36452","BORGOMASINO",81,0,0,81,"2022","031"
"36453","BORGOMEZZAVALLE",5,0,0,5,"2022",NA
"36454","BORGONE SUSA",32,53,0,85,"2022","032"
"36455","BORGONOVO VAL TIDONE",871,2139,0,3010,"2022","006"
"36456","BORGORATTO ALESSANDRINO",5,0,0,5,"2022","019"
"36457","BORGORATTO MORMOROLO",1,0,0,1,"2022","017"
"36458","BORGORICCO",39,2,3,44,"2022","013"
"36459","BORGOSATOLLO",60,481,57,598,"2022","021"
"36460","BORGOSESIA",25,47,0,72,"2022","016"
"36461","BORMIO",14,344,4,362,"2022","009"
"36462","BORNASCO",145,498,3,646,"2022","019"
"36463","BORNO",3,132,29,164,"2022","022"
"36464","BORRIANA",97,28,4,129,"2022","006"
"36465","BORSO DEL GRAPPA",108,225,31,364,"2022","004"
"36466","BOSCHI SANT'ANNA",68,0,0,68,"2022","010"
"36467","BOSCO CHIESANUOVA",44,1352,0,1396,"2022","011"
"36468","BOSCO MARENGO",55,26,0,81,"2022","021"
"36469","BOSCONERO",84,36,0,120,"2022","033"
"36470","BOSIA",336,0,0,336,"2022","026"
"36471","BOSIO",7,0,2,9,"2022","022"
"36472","BOSISIO PARINI",1,129,1,131,"2022","009"
"36473","BOSSICO",30,51,0,81,"2022","033"
"36474","BOSSOLASCO",39,71,0,110,"2022","027"
"36475","BOTTANUCO",110,945,0,1055,"2022","034"
"36476","BOTTICINO",35,0,0,35,"2022","023"
"36477","BOVEGNO",27,117,7,151,"2022","024"
"36478","BOVES",593,733,153,1479,"2022","028"
"36479","BOVEZZO",1,0,0,1,"2022","025"
"36480","BOVOLENTA",4613,217,0,4830,"2022","014"
"36481","BOVOLONE",3852,360,0,4212,"2022","012"
"36482","BOZZOLO",45,1302,18,1365,"2022","007"
"36483","BRA",3301,1809,108,5218,"2022","029"
"36484","BRACCA",4,0,0,4,"2022","035"
"36485","BRALLO DI PREGOLA",18,0,0,18,"2022","021"
"36486","BRANDICO",0,820,0,820,"2022","026"
"36487","BRANDIZZO",0,0,101,101,"2022","034"
"36488","BRANZI",2,30,0,32,"2022","036"
"36489","BRAONE",1,24,2,27,"2022","027"
"36490","BREBBIA",20,1,0,21,"2022","017"
"36491","BREDA DI PIAVE",71,431,4,506,"2022","005"
"36492","BREGANO",9,0,0,9,"2022","018"
"36493","BREGANZE",409,525,53,987,"2022","014"
"36494","BREGNANO",9,100,0,109,"2022","028"
"36495","BREMBATE",100,160,0,260,"2022","037"
"36496","BREMBATE DI SOPRA",0,254,0,254,"2022","038"
"36497","BREMBIO",55,2562,0,2617,"2022","006"
"36498","BREME",31,0,0,31,"2022","022"
"36499","BRENDOLA",313,104,0,417,"2022","015"
"36500","BRENNA",3,0,0,3,"2022","029"
"36501","BRENO",4,276,7,287,"2022","028"
"36502","BRENTA",4,0,0,4,"2022","019"
"36503","BRENZONE",7,0,0,7,"2022","014"
"36504","BRESCELLO",2,30,0,32,"2022","006"
"36505","BRESCIA",19,596,0,615,"2022","029"
"36506","BRESSANA BOTTARONE",85,0,0,85,"2022","023"
"36507","BRESSANVIDO",16,1802,17,1835,"2022","016"
"36508","BRESSO",6,0,2,8,"2022",NA
"36509","BREZZO DI BEDERO",0,2,0,2,"2022","020"
"36510","BRIAGLIA",46,0,0,46,"2022","030"
"36511","BRICHERASIO",687,64,2,753,"2022","035"
"36512","BRIGA NOVARESE",0,90,0,90,"2022","026"
"36513","BRIGNANO GERA D'ADDA",226,1918,0,2144,"2022","040"
"36514","BRIGNANO-FRASCATA",3,0,0,3,"2022","024"
"36515","BRINZIO",3,0,0,3,"2022","021"
"36516","BRIONA",13,754,0,767,"2022","027"
"36517","BRIONE",12,0,0,12,"2022","030"
"36518","BRIOSCO",19,0,0,19,"2022",NA
"36519","BRISIGHELLA",482,66,0,548,"2022","004"
"36520","BRISSAGO-VALTRAVAGLIA",8,0,0,8,"2022","022"
"36521","BRIVIO",14,32,1,47,"2022","010"
"36522","BROGLIANO",36,32,0,68,"2022","017"
"36523","BRONDELLO",5,0,0,5,"2022","032"
"36524","BRONI",50,0,0,50,"2022","024"
"36525","BROSSASCO",37,0,0,37,"2022","033"
"36526","BROSSO",34,11,12,57,"2022","036"
"36527","BROVELLO-CARPUGNINO",13,0,1,14,"2022","013"
"36528","BROZOLO",123,0,0,123,"2022","037"
"36529","BRUGHERIO",5,178,7,190,"2022",NA
"36530","BRUGINE",3515,91,0,3606,"2022","015"
"36531","BRUINO",73,0,0,73,"2022","038"
"36532","BRUMANO",7,29,0,36,"2022","041"
"36533","BRUNELLO",5,1,0,6,"2022","023"
"36534","BRUNO",15,0,0,15,"2022","010"
"36535","BRUSAPORTO",25,25,0,50,"2022","042"
"36536","BRUSASCO",108,0,0,108,"2022","039"
"36537","BRUSNENGO",9,0,0,9,"2022","007"
"36538","BRUZOLO",67,19,47,133,"2022","040"
"36539","BUBBIANO",0,29,0,29,"2022","035"
"36540","BUBBIO",64,0,0,64,"2022","011"
"36541","BUCCINASCO",23,595,0,618,"2022","036"
"36542","BUDRIO",118,240,0,358,"2022","008"
"36543","BUGLIO IN MONTE",23,177,0,200,"2022","010"
"36544","BULCIAGO",1,129,14,144,"2022","011"
"36545","BULGAROGRASSO",35,237,0,272,"2022","034"
"36546","BURIASCO",1200,817,130,2147,"2022","041"
"36547","BUROLO",31,0,0,31,"2022","042"
"36548","BURONZO",8,8,0,16,"2022","021"
"36549","BUSANO",41,28,0,69,"2022","043"
"36550","BUSCA",4753,1583,443,6779,"2022","034"
"36551","BUSCATE",42,0,0,42,"2022","038"
"36552","BUSNAGO",31,7,0,38,"2022",NA
"36553","BUSSERO",0,415,0,415,"2022","040"
"36554","BUSSETO",3,3885,0,3888,"2022","007"
"36555","BUSSOLENGO",538,79,140,757,"2022","015"
"36556","BUSSOLENO",26,143,30,199,"2022","044"
"36557","BUSTO ARSIZIO",21,168,25,214,"2022","026"
"36558","BUSTO GAROLFO",70,271,0,341,"2022","041"
"36559","BUTTAPIETRA",31,73,0,104,"2022","016"
"36560","BUTTIGLIERA ALTA",51,38,0,89,"2022","045"
"36561","BUTTIGLIERA D'ASTI",1913,77,71,2061,"2022","012"
"36562","CABELLA LIGURE",91,0,0,91,"2022","025"
"36563","CADEGLIANO-VICONAGO",2,0,0,2,"2022","027"
"36564","CADELBOSCO DI SOPRA",13,1777,0,1790,"2022","008"
"36565","CADEO",26,2955,0,2981,"2022","007"
"36566","CADONEGHE",10,0,0,10,"2022","016"
"36567","CADORAGO",6,57,0,63,"2022","036"
"36568","CADREZZATE CON OSMATE",17,0,0,17,"2022",NA
"36569","CAERANO DI SAN MARCO",156,45,0,201,"2022","006"
"36570","CAFASSE",146,38,3,187,"2022","046"
"36571","CAGLIO",24,0,49,73,"2022","037"
"36572","CAINO",8,0,0,8,"2022","031"
"36573","CAIOLO",0,74,0,74,"2022","011"
"36574","CAIRATE",4,0,0,4,"2022","029"
"36575","CALALZO DI CADORE",3,0,0,3,"2022",NA
"36576","CALAMANDRANA",57,0,0,57,"2022","013"
"36577","CALASCA-CASTIGLIONE",14,0,0,14,"2022","014"
"36578","CALCINATE",302,256,0,558,"2022","043"
"36579","CALCINATO",6186,2230,416,8832,"2022","032"
"36580","CALCIO",214,1364,0,1578,"2022","044"
"36581","CALCO",12,201,0,213,"2022","012"
"36582","CALDERARA DI RENO",33,42,0,75,"2022","009"
"36583","CALDOGNO",39,324,126,489,"2022","018"
"36584","CALENDASCO",238,340,0,578,"2022","008"
"36585","CALESTANO",70,349,0,419,"2022","008"
"36586","CALLABIANA",26,0,0,26,"2022","008"
"36587","CALLIANO",175,0,0,175,"2022","014"
"36588","CALOLZIOCORTE",4,0,16,20,"2022","013"
"36589","CALOSSO",3,0,0,3,"2022","015"
"36590","CALTIGNAGA",1252,118,0,1370,"2022","030"
"36591","CALTO",9,0,0,9,"2022","008"
"36592","CALTRANO",1495,1,0,1496,"2022","019"
"36593","CALUSCO D'ADDA",12,0,0,12,"2022","046"
"36594","CALUSO",943,166,0,1109,"2022","047"
"36595","CALVAGESE DELLA RIVIERA",3,193,0,196,"2022","033"
"36596","CALVATONE",0,123,0,123,"2022","009"
"36597","CALVENE",9,42,0,51,"2022","020"
"36598","CALVENZANO",22,596,0,618,"2022","047"
"36599","CALVIGNASCO",1,13,0,14,"2022","042"
"36600","CALVISANO",13634,4540,220,18394,"2022","034"
"36601","CAMAGNA MONFERRATO",21,0,0,21,"2022","026"
"36602","CAMANDONA",7,0,0,7,"2022","009"
"36603","CAMBIAGO",32,98,0,130,"2022","044"
"36604","CAMBIANO",305,0,0,305,"2022","048"
"36605","CAMBIASCA",8,0,0,8,"2022","015"
"36606","CAMBURZANO",60,0,30,90,"2022","010"
"36607","CAMERANA",269,0,0,269,"2022","035"
"36608","CAMERANO CASASCO",21,0,0,21,"2022","016"
"36609","CAMERATA CORNELLO",21,76,0,97,"2022","048"
"36610","CAMERI",57,711,0,768,"2022","032"
"36611","CAMISANO",110,2898,0,3008,"2022","010"
"36612","CAMISANO VICENTINO",215,1270,363,1848,"2022","021"
"36613","CAMPAGNA LUPIA",53,96,0,149,"2022","002"
"36614","CAMPAGNOLA CREMASCA",12,694,72,778,"2022","011"
"36615","CAMPAGNOLA EMILIA",1,607,0,608,"2022","009"
"36616","CAMPEGINE",0,1223,0,1223,"2022","010"
"36617","CAMPERTOGNO",0,48,0,48,"2022","025"
"36618","CAMPIGLIA CERVO",3,5,0,8,"2022","011"
"36619","CAMPIGLIA DEI BERICI",531,120,0,651,"2022","022"
"36620","CAMPIGLIONE-FENILE",532,0,25,557,"2022","049"
"36621","CAMPO SAN MARTINO",366,90,0,456,"2022","020"
"36622","CAMPODARSEGO",751,39,3,793,"2022","017"
"36623","CAMPODORO",75,132,0,207,"2022","018"
"36624","CAMPOGALLIANO",4,288,0,292,"2022","003"
"36625","CAMPOLONGO MAGGIORE",20,2,0,22,"2022","003"
"36626","CAMPONOGARA",108,31,0,139,"2022","004"
"36627","CAMPOSAMPIERO",393,76,0,469,"2022","019"
"36628","CAMPOSANTO",11,0,0,11,"2022",NA
"36629","CAMUGNANO",614,62,0,676,"2022","010"
"36630","CANALE",757,0,0,757,"2022","037"
"36631","CANALE D'AGORDO",1,0,0,1,"2022",NA
"36632","CANARO",539,0,0,539,"2022","009"
"36633","CANDELO",93,35,96,224,"2022","012"
"36634","CANDIA CANAVESE",28,0,0,28,"2022","050"
"36635","CANDIANA",11682,195,0,11877,"2022","021"
"36636","CANDIOLO",67,654,52,773,"2022","051"
"36637","CANELLI",8,0,0,8,"2022","017"
"36638","CANISCHIO",9,22,0,31,"2022","052"
"36639","CANNETO SULL'OGLIO",1960,2807,589,5356,"2022","008"
"36640","CANNOBIO",5,6,0,11,"2022","017"
"36641","CANONICA D'ADDA",9,413,0,422,"2022","049"
"36642","CANOSIO",6,0,0,6,"2022","038"
"36643","CANOSSA",87,215,0,302,"2022","018"
"36644","CANTALUPA",34,0,0,34,"2022","053"
"36645","CANTALUPO LIGURE",17,0,0,17,"2022","028"
"36646","CANTARANA",46,0,0,46,"2022","018"
"36647","CANTELLO",84,144,0,228,"2022","030"
"36648","CANTOIRA",82,7,16,105,"2022","054"
"36649","CANTU'",163,265,7,435,"2022","041"
"36650","CANZO",0,4,24,28,"2022","042"
"36651","CAORLE",772,79,0,851,"2022","005"
"36652","CAORSO",11,441,0,452,"2022","010"
"36653","CAPERGNANICA",364,1126,0,1490,"2022","012"
"36654","CAPIAGO INTIMIANO",1,11,5,17,"2022","043"
"36655","CAPIZZONE",25,16,0,41,"2022","050"
"36656","CAPO DI PONTE",26,167,13,206,"2022","035"
"36657","CAPONAGO",133,0,0,133,"2022",NA
"36658","CAPOVALLE",3,21,1,25,"2022","036"
"36659","CAPPELLA CANTONE",0,338,106,444,"2022","013"
"36660","CAPPELLA DE' PICENARDI",3,416,0,419,"2022","014"
"36661","CAPPELLA MAGGIORE",7,7,0,14,"2022","007"
"36662","CAPRALBA",1,1248,0,1249,"2022","015"
"36663","CAPRAUNA",1,0,0,1,"2022","039"
"36664","CAPRIANO DEL COLLE",2,396,0,398,"2022","037"
"36665","CAPRIATA D'ORBA",24,0,0,24,"2022","029"
"36666","CAPRIE",27,0,0,27,"2022","055"
"36667","CAPRIGLIO",3,0,0,3,"2022","019"
"36668","CAPRILE",66,0,0,66,"2022","013"
"36669","CAPRINO BERGAMASCO",15,0,0,15,"2022","052"
"36670","CAPRINO VERONESE",81,593,62,736,"2022","018"
"36671","CAPRIOLO",297,0,40,337,"2022","038"
"36672","CARAGLIO",3420,564,560,4544,"2022","040"
"36673","CARAMAGNA PIEMONTE",2018,734,47,2799,"2022","041"
"36674","CARAVAGGIO",217,2802,0,3019,"2022","053"
"36675","CARAVATE",0,98,0,98,"2022","031"
"36676","CARBONARA AL TICINO",0,427,0,427,"2022","030"
"36677","CARBONARA SCRIVIA",26,0,0,26,"2022","030"
"36678","CARBONATE",87,46,9,142,"2022","045"
"36679","CARBONERA",137,175,7,319,"2022","008"
"36680","CARCERI",1307,0,0,1307,"2022","022"
"36681","CARCOFORO",0,0,7,7,"2022","029"
"36682","CARDE'",2623,1965,48,4636,"2022","042"
"36683","CAREMA",64,0,6,70,"2022","057"
"36684","CARENNO",18,0,11,29,"2022","014"
"36685","CARENTINO",23,559,0,582,"2022","031"
"36686","CARESANA",6,0,0,6,"2022","030"
"36687","CARIGNANO",2625,1503,363,4491,"2022","058"
"36688","CARISIO",32,0,0,32,"2022","032"
"36689","CARLAZZO",26,44,5,75,"2022","047"
"36690","CARMAGNOLA",6649,3071,0,9720,"2022","059"
"36691","CARMIGNANO DI BRENTA",104,1416,0,1520,"2022","023"
"36692","CARNAGO",18,58,0,76,"2022","033"
"36693","CAROBBIO DEGLI ANGELI",81,32,0,113,"2022","055"
"36694","CARONNO PERTUSELLA",4,0,0,4,"2022","034"
"36695","CARONNO VARESINO",31,0,0,31,"2022","035"
"36696","CARPANETO PIACENTINO",53,4438,0,4491,"2022","011"
"36697","CARPENEDOLO",1061,4358,260,5679,"2022","039"
"36698","CARPENETO",112,0,0,112,"2022","033"
"36699","CARPI",8,1959,0,1967,"2022","005"
"36700","CARPIANO",252,1190,0,1442,"2022","050"
"36701","CARPIGNANO SESIA",112,0,0,112,"2022","036"
"36702","CARPINETI",126,1409,0,1535,"2022","011"
"36703","CARRE'",362,107,0,469,"2022","024"
"36704","CARREGA LIGURE",92,0,0,92,"2022","034"
"36705","CARRU'",758,52,80,890,"2022","043"
"36706","CARTIGLIANO",21,11,0,32,"2022","025"
"36707","CARTIGNANO",233,62,0,295,"2022","044"
"36708","CARTOSIO",65,0,0,65,"2022","036"
"36709","CARTURA",386,0,0,386,"2022","026"
"36710","CARUGATE",22,131,0,153,"2022","051"
"36711","CARUGO",3,0,0,3,"2022","048"
"36712","CARVICO",1,0,0,1,"2022","057"
"36713","CASAL CERMELLI",3,0,0,3,"2022","037"
"36714","CASALBELTRAME",1,0,167,168,"2022","037"
"36715","CASALBORGONE",49,0,0,49,"2022","060"
"36716","CASALBUTTANO ED UNITI",1,1695,0,1696,"2022","016"
"36717","CASALE CORTE CERRO",13,0,5,18,"2022","019"
"36718","CASALE CREMASCO-VIDOLASCO",1,1910,0,1911,"2022","017"
"36719","CASALE DI SCODOSIA",526,0,0,526,"2022","027"
"36720","CASALE LITTA",37,146,0,183,"2022","036"
"36721","CASALE MONFERRATO",128,187,0,315,"2022","039"
"36722","CASALE SUL SILE",776,42,53,871,"2022","009"
"36723","CASALEGGIO BOIRO",25,0,0,25,"2022","038"
"36724","CASALEONE",5,0,0,5,"2022","019"
"36725","CASALETTO CEREDANO",19,12,0,31,"2022","018"
"36726","CASALETTO DI SOPRA",8,350,0,358,"2022","019"
"36727","CASALETTO LODIGIANO",18,595,0,613,"2022","008"
"36728","CASALETTO VAPRIO",97,812,8,917,"2022","020"
"36729","CASALFIUMANESE",703,79,0,782,"2022","012"
"36730","CASALGRANDE",44,1221,0,1265,"2022","012"
"36731","CASALGRASSO",325,236,116,677,"2022","045"
"36732","CASALINO",6,104,0,110,"2022","040"
"36733","CASALMAGGIORE",3,649,0,652,"2022","021"
"36734","CASALMAIOCCO",19,473,0,492,"2022","009"
"36735","CASALMORANO",93,2408,0,2501,"2022","022"
"36736","CASALMORO",439,194,266,899,"2022","010"
"36737","CASALNOCETO",10,0,0,10,"2022","040"
"36738","CASALOLDO",1028,1239,827,3094,"2022","011"
"36739","CASALPUSTERLENGO",3185,1283,0,4468,"2022","010"
"36740","CASALROMANO",308,276,189,773,"2022","012"
"36741","CASALSERUGO",85,7,0,92,"2022","028"
"36742","CASALVOLONE",3,38,0,41,"2022","041"
"36743","CASALZUIGNO",2,110,0,112,"2022","037"
"36744","CASAPINTA",1,0,0,1,"2022",NA
"36745","CASARGO",4,16,4,24,"2022","015"
"36746","CASARILE",57,0,0,57,"2022","055"
"36747","CASATENOVO",415,0,2,417,"2022","016"
"36748","CASAZZA",8,0,0,8,"2022","058"
"36749","CASCIAGO",10,18,0,28,"2022","038"
"36750","CASEI GEROLA",610,0,0,610,"2022","033"
"36751","CASELETTE",111,315,40,466,"2022","062"
"36752","CASELLE LANDI",215,524,0,739,"2022","011"
"36753","CASELLE LURANI",40,478,0,518,"2022","012"
"36754","CASELLE TORINESE",174,1308,44,1526,"2022","063"
"36755","CASIER",10,76,0,86,"2022","010"
"36756","CASINA",78,819,0,897,"2022","013"
"36757","CASIRATE D'ADDA",91,327,0,418,"2022","059"
"36758","CASLINO D'ERBA",2,0,4,6,"2022","052"
"36759","CASNIGO",28,93,0,121,"2022","060"
"36760","CASOLA VALSENIO",290,20,0,310,"2022","005"
"36761","CASORATE PRIMO",31,162,0,193,"2022","034"
"36762","CASOREZZO",0,272,0,272,"2022","058"
"36763","CASORZO",4,0,0,4,"2022","020"
"36764","CASPOGGIO",3,47,0,50,"2022","013"
"36765","CASSAGO BRIANZA",0,57,9,66,"2022","017"
"36766","CASSANO D'ADDA",55,300,41,396,"2022","059"
"36767","CASSANO MAGNAGO",32,70,0,102,"2022","040"
"36768","CASSANO SPINOLA",196,0,0,196,"2022","042"
"36769","CASSINA DE' PECCHI",0,354,0,354,"2022","060"
"36770","CASSINA VALSASSINA",7,28,0,35,"2022","018"
"36771","CASSINASCO",13,0,13,26,"2022","021"
"36772","CASSINE",296,0,0,296,"2022","043"
"36773","CASSINELLE",2,0,0,2,"2022","044"
"36774","CASSINETTA DI LUGAGNANO",0,193,0,193,"2022","061"
"36775","CASSOLA",402,29,0,431,"2022","026"
"36776","CASSOLNOVO",11,0,0,11,"2022","035"
"36777","CASTAGNARO",242,0,0,242,"2022","020"
"36778","CASTAGNETO PO",34,0,0,34,"2022","064"
"36779","CASTAGNITO",115,0,0,115,"2022","046"
"36780","CASTAGNOLE DELLE LANZE",273,0,0,273,"2022","022"
"36781","CASTAGNOLE MONFERRATO",43,0,0,43,"2022","023"
"36782","CASTAGNOLE PIEMONTE",1264,671,77,2012,"2022","065"
"36783","CASTANA",3,0,0,3,"2022","036"
"36784","CASTANO PRIMO",67,0,9,76,"2022","062"
"36785","CASTEGGIO",951,0,0,951,"2022","037"
"36786","CASTEGNATO",36,1028,0,1064,"2022","040"
"36787","CASTEGNERO",27,33,0,60,"2022","027"
"36788","CASTEL BOGLIONE",3,0,0,3,"2022","024"
"36789","CASTEL BOLOGNESE",32,0,0,32,"2022","006"
"36790","CASTEL D'AIANO",76,647,0,723,"2022","013"
"36791","CASTEL D'ARIO",220,62,1123,1405,"2022","014"
"36792","CASTEL D'AZZANO",1742,120,0,1862,"2022","021"
"36793","CASTEL DEL RIO",79,0,0,79,"2022","014"
"36794","CASTEL DI CASIO",63,25,0,88,"2022","015"
"36795","CASTEL GABBIANO",0,1787,0,1787,"2022","024"
"36796","CASTEL GOFFREDO",1749,387,624,2760,"2022","015"
"36797","CASTEL GUELFO DI BOLOGNA",134,253,0,387,"2022","016"
"36798","CASTEL MELLA",7,375,0,382,"2022","042"
"36799","CASTEL ROZZONE",0,43,0,43,"2022","063"
"36800","CASTEL SAN GIOVANNI",83,840,0,923,"2022","013"
"36801","CASTEL SAN PIETRO TERME",910,334,0,1244,"2022","020"
"36802","CASTELBALDO",1,0,0,1,"2022","029"
"36803","CASTELBELFORTE",1588,0,0,1588,"2022","013"
"36804","CASTELCOVATI",3,455,0,458,"2022","041"
"36805","CASTELCUCCO",45,203,27,275,"2022","011"
"36806","CASTELDELCI",429,0,0,429,"2022","021"
"36807","CASTELDELFINO",64,0,0,64,"2022","047"
"36808","CASTELDIDONE",53,0,0,53,"2022","023"
"36809","CASTELFRANCO EMILIA",2151,3035,0,5186,"2022","006"
"36810","CASTELFRANCO VENETO",5043,178,2,5223,"2022","012"
"36811","CASTELGERUNDO",27,1727,0,1754,"2022",NA
"36812","CASTELGOMBERTO",135,414,7,556,"2022","028"
"36813","CASTELGUGLIELMO",658,0,0,658,"2022","011"
"36814","CASTELL'ALFERO",376,0,0,376,"2022","025"
"36815","CASTELL'ARQUATO",133,684,0,817,"2022","012"
"36816","CASTELLAMONTE",407,228,84,719,"2022","066"
"36817","CASTELLARANO",37,337,0,374,"2022","014"
"36818","CASTELLAZZO BORMIDA",103,81,0,184,"2022","047"
"36819","CASTELLEONE",765,4187,14,4966,"2022","025"
"36820","CASTELLETTO CERVO",36,42,0,78,"2022","015"
"36821","CASTELLETTO D'ORBA",5,0,0,5,"2022","049"
"36822","CASTELLETTO MERLI",18,0,0,18,"2022","050"
"36823","CASTELLETTO MONFERRATO",80,0,0,80,"2022","051"
"36824","CASTELLETTO SOPRA TICINO",65,56,26,147,"2022","043"
"36825","CASTELLETTO STURA",1844,51,78,1973,"2022","049"
"36826","CASTELLETTO UZZONE",14,0,0,14,"2022","050"
"36827","CASTELLI CALEPIO",7,188,0,195,"2022","062"
"36828","CASTELLINALDO D'ALBA",943,0,0,943,"2022",NA
"36829","CASTELLINO TANARO",163,0,0,163,"2022","052"
"36830","CASTELLO CABIAGLIO",3,10,0,13,"2022","043"
"36831","CASTELLO D'AGOGNA",5,0,0,5,"2022",NA
"36832","CASTELLO D'ARGILE",68,0,0,68,"2022","017"
"36833","CASTELLO DELL'ACQUA",13,10,0,23,"2022","014"
"36834","CASTELLO DI ANNONE",137,0,0,137,"2022","028"
"36835","CASTELLO DI BRIANZA",3,0,21,24,"2022","019"
"36836","CASTELLO DI GODEGO",5760,140,0,5900,"2022","013"
"36837","CASTELLUCCHIO",691,1877,1636,4204,"2022","016"
"36838","CASTELMAGNO",79,60,11,150,"2022","053"
"36839","CASTELMARTE",11,0,0,11,"2022","058"
"36840","CASTELMASSA",0,105,0,105,"2022","012"
"36841","CASTELNOVETTO",3,0,0,3,"2022","040"
"36842","CASTELNOVO BARIANO",2175,0,0,2175,"2022","013"
"36843","CASTELNOVO DI SOTTO",7,1105,0,1112,"2022","015"
"36844","CASTELNOVO NE' MONTI",56,1452,0,1508,"2022","016"
"36845","CASTELNUOVO BOCCA D'ADDA",2923,340,10,3273,"2022","013"
"36846","CASTELNUOVO BORMIDA",9,0,0,9,"2022","052"
"36847","CASTELNUOVO BOZZENTE",5,5,0,10,"2022","059"
"36848","CASTELNUOVO CALCEA",6,0,0,6,"2022","030"
"36849","CASTELNUOVO DEL GARDA",3086,237,0,3323,"2022","022"
"36850","CASTELNUOVO DON BOSCO",143,0,0,143,"2022","031"
"36851","CASTELNUOVO NIGRA",35,0,0,35,"2022","067"
"36852","CASTELNUOVO RANGONE",0,950,0,950,"2022","007"
"36853","CASTELNUOVO SCRIVIA",20,0,0,20,"2022","053"
"36854","CASTELSEPRIO",1,0,2,3,"2022","044"
"36855","CASTELSPINA",12,0,0,12,"2022","054"
"36856","CASTELVECCANA",1,0,3,4,"2022","045"
"36857","CASTELVERDE",34,3159,0,3193,"2022","026"
"36858","CASTELVETRO DI MODENA",64,947,0,1011,"2022","008"
"36859","CASTELVETRO PIACENTINO",1113,1097,0,2210,"2022","014"
"36860","CASTELVISCONTI",3,1334,305,1642,"2022","027"
"36861","CASTENASO",87,93,0,180,"2022","021"
"36862","CASTENEDOLO",834,1254,0,2088,"2022","043"
"36863","CASTIGLIONE D'ADDA",2,314,0,316,"2022","014"
"36864","CASTIGLIONE DEI PEPOLI",206,39,0,245,"2022","022"
"36865","CASTIGLIONE DELLE STIVIERE",4781,2809,456,8046,"2022","017"
"36866","CASTIGLIONE FALLETTO",37,0,0,37,"2022","055"
"36867","CASTIGLIONE OLONA",4,0,4,8,"2022","046"
"36868","CASTIGLIONE TINELLA",57,0,0,57,"2022","056"
"36869","CASTIGLIONE TORINESE",11,0,0,11,"2022","068"
"36870","CASTINO",95,0,0,95,"2022","057"
"36871","CASTIONE ANDEVENNO",12,56,0,68,"2022","015"
"36872","CASTIONE DELLA PRESOLANA",7,3,0,10,"2022","064"
"36873","CASTIRAGA VIDARDO",3,351,0,354,"2022","015"
"36874","CASTO",18,24,4,46,"2022","044"
"36875","CASTREZZATO",379,1080,169,1628,"2022","045"
"36876","CASTROCARO TERME E TERRA DEL SOLE",36,3,0,39,"2022","005"
"36877","CASTRONNO",2,0,0,2,"2022","047"
"36878","CAVAGLIA'",1134,129,0,1263,"2022","016"
"36879","CAVAGLIETTO",6,171,0,177,"2022","044"
"36880","CAVAGNOLO",47,0,0,47,"2022","069"
"36881","CAVAION VERONESE",3,0,0,3,"2022","023"
"36882","CAVALLERLEONE",379,1147,73,1599,"2022","058"
"36883","CAVALLERMAGGIORE",2332,2348,52,4732,"2022","059"
"36884","CAVALLINO-TREPORTI",5,0,0,5,"2022","044"
"36885","CAVALLIRIO",6,0,0,6,"2022","047"
"36886","CAVARGNA",4,0,3,7,"2022","062"
"36887","CAVARIA CON PREMEZZO",18,0,0,18,"2022","048"
"36888","CAVARZERE",5225,0,0,5225,"2022","006"
"36889","CAVASO DEL TOMBA",63,51,1,115,"2022","014"
"36890","CAVATORE",6,0,0,6,"2022","055"
"36891","CAVENAGO D'ADDA",10,961,0,971,"2022","017"
"36892","CAVEZZO",0,364,0,364,"2022","009"
"36893","CAVOUR",4455,943,642,6040,"2022","070"
"36894","CAVRIAGO",14,539,0,553,"2022","017"
"36895","CAVRIANA",1706,1795,294,3795,"2022","018"
"36896","CAZZAGO SAN MARTINO",1366,133,56,1555,"2022","046"
"36897","CAZZANO DI TRAMIGNA",2,121,0,123,"2022","024"
"36898","CAZZANO SANT'ANDREA",266,9,0,275,"2022","067"
"36899","CECIMA",12,0,0,12,"2022","042"
"36900","CEDEGOLO",1,12,2,15,"2022","047"
"36901","CEDRASCO",0,59,0,59,"2022","016"
"36902","CEGGIA",8,0,0,8,"2022","007"
"36903","CELLA DATI",4221,109,27,4357,"2022","028"
"36904","CELLA MONTE",80,0,0,80,"2022","056"
"36905","CELLARENGO",255,104,153,512,"2022","033"
"36906","CELLATICA",0,81,2,83,"2022","048"
"36907","CELLE DI MACRA",49,0,18,67,"2022","060"
"36908","CELLE ENOMONDO",232,0,0,232,"2022","034"
"36909","CELLIO CON BREIA",2,0,0,2,"2022",NA
"36910","CENATE SOPRA",13,4,0,17,"2022","068"
"36911","CENATE SOTTO",19,0,0,19,"2022","069"
"36912","CENCENIGHE AGORDINO",0,1,0,1,"2022","010"
"36913","CENE",41,41,0,82,"2022","070"
"36914","CENESELLI",0,189,42,231,"2022","014"
"36915","CENTALLO",4984,760,401,6145,"2022","061"
"36916","CENTO",21,0,0,21,"2022","004"
"36917","CENTRO VALLE INTELVI",32,17,6,55,"2022",NA
"36918","CEPPO MORELLI",29,0,0,29,"2022","021"
"36919","CERANO",16,0,0,16,"2022","049"
"36920","CERANO D'INTELVI",9,0,37,46,"2022","063"
"36921","CERANOVA",0,570,0,570,"2022","043"
"36922","CERCENASCO",111,299,0,410,"2022","071"
"36923","CERCINO",59,3,34,96,"2022","017"
"36924","CEREA",647,168,0,815,"2022","025"
"36925","CERES",14,0,0,14,"2022","072"
"36926","CERESARA",1147,338,106,1591,"2022","019"
"36927","CERESETO",88,0,0,88,"2022","057"
"36928","CERESOLE ALBA",3328,730,0,4058,"2022","062"
"36929","CERESOLE REALE",0,5,0,5,"2022","073"
"36930","CERETE",10,146,0,156,"2022","071"
"36931","CERETTO LOMELLINA",1,0,0,1,"2022","044"
"36932","CERIANO LAGHETTO",0,48,0,48,"2022",NA
"36933","CERIGNALE",18,0,0,18,"2022","015"
"36934","CERMENATE",12,149,10,171,"2022","064"
"36935","CERNUSCO LOMBARDONE",32,0,2,34,"2022","020"
"36936","CERNUSCO SUL NAVIGLIO",17,117,0,134,"2022","070"
"36937","CERRETO D'ASTI",1,0,0,1,"2022","035"
"36938","CERRETO GRUE",24,0,0,24,"2022","058"
"36939","CERRINA MONFERRATO",29,30,17,76,"2022","059"
"36940","CERRIONE",84,105,0,189,"2022","018"
"36941","CERRO AL LAMBRO",6,809,0,815,"2022","071"
"36942","CERRO MAGGIORE",4,75,0,79,"2022","072"
"36943","CERRO TANARO",286,0,0,286,"2022","036"
"36944","CERRO VERONESE",33,188,0,221,"2022","026"
"36945","CERTOSA DI PAVIA",12,0,0,12,"2022","046"
"36946","CERVARESE SANTA CROCE",13,160,0,173,"2022","030"
"36947","CERVASCA",1219,326,2,1547,"2022","064"
"36948","CERVENO",22,0,3,25,"2022","049"
"36949","CERVERE",1929,157,0,2086,"2022","065"
"36950","CERVIGNANO D'ADDA",0,937,0,937,"2022","018"
"36951","CESANA BRIANZA",3,14,2,19,"2022","021"
"36952","CESANA TORINESE",59,10,24,93,"2022","074"
"36953","CESANO BOSCONE",0,57,0,57,"2022","074"
"36954","CESANO MADERNO",1,0,0,1,"2022",NA
"36955","CESARA",1,0,0,1,"2022","022"
"36956","CESATE",2,0,0,2,"2022","076"
"36957","CESENA",68,18,0,86,"2022","007"
"36958","CESIOMAGGIORE",200,96,10,306,"2022","011"
"36959","CESSALTO",38,108,0,146,"2022","015"
"36960","CESSOLE",191,0,0,191,"2022","037"
"36961","CETO",4,38,8,50,"2022","050"
"36962","CEVA",1450,0,0,1450,"2022","066"
"36963","CEVO",0,42,2,44,"2022","051"
"36964","CHERASCO",4777,1034,119,5930,"2022","067"
"36965","CHIALAMBERTO",4,0,9,13,"2022","075"
"36966","CHIAMPO",17,64,3,84,"2022","029"
"36967","CHIANOCCO",15,0,6,21,"2022","076"
"36968","CHIARANO",10,527,0,537,"2022","016"
"36969","CHIARI",790,5619,291,6700,"2022","052"
"36970","CHIAVENNA",5,6,4,15,"2022","018"
"36971","CHIAVERANO",32,0,0,32,"2022","077"
"36972","CHIERI",2525,520,53,3098,"2022","078"
"36973","CHIES D'ALPAGO",13,6,0,19,"2022","012"
"36974","CHIESA IN VALMALENCO",13,41,0,54,"2022","019"
"36975","CHIESANUOVA",2,0,0,2,"2022","079"
"36976","CHIEVE",0,1044,0,1044,"2022","029"
"36977","CHIGNOLO D'ISOLA",56,411,0,467,"2022","072"
"36978","CHIGNOLO PO",6,86,0,92,"2022","048"
"36979","CHIOGGIA",3480,0,0,3480,"2022","008"
"36980","CHIOMONTE",0,24,0,24,"2022","080"
"36981","CHIUDUNO",4,0,0,4,"2022","073"
"36982","CHIUPPANO",6,24,0,30,"2022","030"
"36983","CHIURO",3,6,0,9,"2022","020"
"36984","CHIUSA DI PESIO",1604,439,5,2048,"2022","068"
"36985","CHIUSA DI SAN MICHELE",0,0,68,68,"2022","081"
"36986","CHIUSANO D'ASTI",6,0,0,6,"2022","038"
"36987","CHIVASSO",1324,282,0,1606,"2022","082"
"36988","CICOGNOLO",0,1369,0,1369,"2022","030"
"36989","CICONIO",97,94,7,198,"2022","083"
"36990","CIGLIANO",286,62,26,374,"2022","042"
"36991","CIGLIE'",495,0,0,495,"2022","069"
"36992","CIGOLE",2118,1437,0,3555,"2022","053"
"36993","CILAVEGNA",6,0,0,6,"2022","050"
"36994","CIMADOLMO",360,66,0,426,"2022","017"
"36995","CIMBERGO",3,0,1,4,"2022","054"
"36996","CINAGLIO",729,0,13,742,"2022","039"
"36997","CINGIA DE' BOTTI",32,1210,0,1242,"2022","031"
"36998","CINO",19,7,0,26,"2022","021"
"36999","CINTANO",30,0,0,30,"2022","084"
"37000","CINTO CAOMAGGIORE",465,0,27,492,"2022","009"
"37001","CINTO EUGANEO",11,38,0,49,"2022","031"
"37002","CINZANO",10,0,0,10,"2022","085"
"37003","CIRIE'",246,163,103,512,"2022","086"
"37004","CIRIMIDO",7,18,0,25,"2022","068"
"37005","CISANO BERGAMASCO",27,0,0,27,"2022","074"
"37006","CISERANO",14,56,0,70,"2022","075"
"37007","CISLAGO",5,0,0,5,"2022","050"
"37008","CISLIANO",83,533,0,616,"2022","078"
"37009","CISON DI VALMARINO",107,0,4,111,"2022","018"
"37010","CISTERNA D'ASTI",69,0,0,69,"2022","040"
"37011","CITTADELLA",2057,1001,142,3200,"2022","032"
"37012","CITTIGLIO",6,13,0,19,"2022","051"
"37013","CIVATE",1,0,1,2,"2022","022"
"37014","CIVIASCO",0,4,0,4,"2022","043"
"37015","CIVIDATE AL PIANO",856,676,0,1532,"2022","076"
"37016","CIVIDATE CAMUNO",4,0,0,4,"2022","055"
"37017","CIVITELLA DI ROMAGNA",828,23,20,871,"2022","009"
"37018","CIVO",12,27,0,39,"2022","022"
"37019","CLAINO CON OSTENO",1,0,6,7,"2022","071"
"37020","CLAVESANA",408,0,0,408,"2022","071"
"37021","CLIVIO",18,97,0,115,"2022","052"
"37022","CLUSONE",76,198,0,274,"2022","077"
"37023","COASSOLO TORINESE",30,0,1,31,"2022","088"
"37024","COAZZE",10,0,7,17,"2022","089"
"37025","COAZZOLO",34,0,0,34,"2022","041"
"37026","COCCAGLIO",125,1038,4,1167,"2022","056"
"37027","COCCONATO",40,3,0,43,"2022","042"
"37028","COCQUIO-TREVISAGO",17,0,0,17,"2022","053"
"37029","CODEVIGO",322,124,0,446,"2022","033"
"37030","CODIGORO",3661,154,0,3815,"2022","005"
"37031","CODOGNE'",50,151,4,205,"2022","019"
"37032","CODOGNO",13,1087,0,1100,"2022","019"
"37033","COGGIOLA",7,2,0,9,"2022","019"
"37034","COGLIATE",0,0,60,60,"2022",NA
"37035","COGOLLO DEL CENGIO",383,103,0,486,"2022","032"
"37036","COLCERESA",16,426,19,461,"2022",NA
"37037","COLERE",1,0,0,1,"2022","078"
"37038","COLI",93,0,0,93,"2022","016"
"37039","COLICO",50,103,49,202,"2022","023"
"37040","COLLE BRIANZA",5,0,2,7,"2022","024"
"37041","COLLE SANTA LUCIA",0,16,0,16,"2022","014"
"37042","COLLE UMBERTO",23,115,0,138,"2022","020"
"37043","COLLEBEATO",1,0,0,1,"2022",NA
"37044","COLLECCHIO",0,2582,0,2582,"2022","009"
"37045","COLLEGNO",268,304,5,577,"2022","090"
"37046","COLLERETTO CASTELNUOVO",13,39,0,52,"2022","091"
"37047","COLLERETTO GIACOSA",23,0,0,23,"2022","092"
"37048","COLLI VERDI",119,0,0,119,"2022",NA
"37049","COLLIO",37,44,22,103,"2022","058"
"37050","COLOGNA VENETA",8925,248,0,9173,"2022","027"
"37051","COLOGNE",511,691,0,1202,"2022","059"
"37052","COLOGNO AL SERIO",63,923,0,986,"2022","079"
"37053","COLORINA",60,398,11,469,"2022","023"
"37054","COLORNO",14,1157,0,1171,"2022","010"
"37055","COLTURANO",0,9,0,9,"2022","082"
"37056","COLVERDE",15,93,18,126,"2022",NA
"37057","COLZATE",29,84,0,113,"2022","080"
"37058","COMACCHIO",479,246,0,725,"2022","006"
"37059","COMAZZO",29,837,9,875,"2022","020"
"37060","COMELICO SUPERIORE",21,114,4,139,"2022","015"
"37061","COMERIO",7,0,0,7,"2022","055"
"37062","COMEZZANO-CIZZAGO",129,1814,0,1943,"2022","060"
"37063","COMMESSAGGIO",9,19,14,42,"2022","020"
"37064","COMO",0,48,3,51,"2022","075"
"37065","COMPIANO",17,36,0,53,"2022","011"
"37066","COMUN NUOVO",63,0,0,63,"2022","081"
"37067","CONA",15658,0,25,15683,"2022","010"
"37068","CONCAMARISE",0,267,0,267,"2022","029"
"37069","CONCESIO",4,21,0,25,"2022","061"
"37070","CONCORDIA SAGITTARIA",994,0,0,994,"2022","011"
"37071","CONCORDIA SULLA SECCHIA",46,270,0,316,"2022","010"
"37072","CONCOREZZO",1,29,0,30,"2022",NA
"37073","CONDOVE",96,28,41,165,"2022","093"
"37074","CONEGLIANO",17,23,3,43,"2022","021"
"37075","CONFIENZA",23,17,0,40,"2022","052"
"37076","CONIOLO",105,0,0,105,"2022","060"
"37077","CONSELICE",565,210,0,775,"2022","008"
"37078","CONSELVE",1168,63,0,1231,"2022","034"
"37079","CONZANO",84,0,0,84,"2022","061"
"37080","COPPARO",96,0,0,96,"2022","007"
"37081","CORBETTA",20,55,10,85,"2022","085"
"37082","CORBOLA",20,246,0,266,"2022","017"
"37083","CORDIGNANO",89,121,0,210,"2022","022"
"37084","CORIANO",51,147,0,198,"2022","003"
"37085","CORIO",110,0,37,147,"2022","094"
"37086","CORNA IMAGNA",29,35,0,64,"2022","082"
"37087","CORNALBA",1,9,0,10,"2022","249"
"37088","CORNAREDO",1,241,8,250,"2022","087"
"37089","CORNATE D'ADDA",25,81,0,106,"2022",NA
"37090","CORNEDO VICENTINO",6,133,0,139,"2022","034"
"37091","CORNEGLIANO LAUDENSE",0,168,0,168,"2022","021"
"37092","CORNELIANO D'ALBA",110,0,0,110,"2022","072"
"37093","CORNIGLIO",31,351,0,382,"2022","012"
"37094","CORNO GIOVINE",200,73,0,273,"2022","022"
"37095","CORNOVECCHIO",120,0,0,120,"2022","023"
"37096","CORNUDA",476,477,0,953,"2022","023"
"37097","CORREGGIO",2,2099,0,2101,"2022","020"
"37098","CORREZZANA",19,0,0,19,"2022",NA
"37099","CORREZZOLA",4873,21,0,4894,"2022","035"
"37100","CORRIDO",39,19,4,62,"2022","077"
"37101","CORTANZE",72,0,0,72,"2022","046"
"37102","CORTAZZONE",23,0,0,23,"2022","047"
"37103","CORTE BRUGNATELLA",233,12,0,245,"2022","017"
"37104","CORTE DE' CORTESI CON CIGNONE",1,11,233,245,"2022","032"
"37105","CORTE DE' FRATI",19,841,181,1041,"2022","033"
"37106","CORTE FRANCA",107,35,7,149,"2022","062"
"37107","CORTE PALASIO",6,2136,24,2166,"2022","024"
"37108","CORTEMAGGIORE",156,2082,0,2238,"2022","018"
"37109","CORTEMILIA",158,0,0,158,"2022","073"
"37110","CORTENO GOLGI",10,121,16,147,"2022","063"
"37111","CORTENOVA",5,38,0,43,"2022","025"
"37112","CORTENUOVA",169,1268,0,1437,"2022","083"
"37113","CORTEOLONA E GENZONE",110,22,0,132,"2022",NA
"37114","CORTINA D'AMPEZZO",1,21,0,22,"2022","016"
"37115","CORVINO SAN QUIRICO",3,0,0,3,"2022","057"
"37116","CORZANO",118,269,0,387,"2022","064"
"37117","COSIO VALTELLINO",12,723,1,736,"2022","024"
"37118","COSSANO BELBO",365,0,0,365,"2022","074"
"37119","COSSANO CANAVESE",1,0,0,1,"2022","095"
"37120","COSSATO",273,186,0,459,"2022","020"
"37121","COSSOGNO",4,0,0,4,"2022","023"
"37122","COSTA DE' NOBILI",43,16,12,71,"2022","058"
"37123","COSTA DI MEZZATE",20,0,0,20,"2022","084"
"37124","COSTA DI ROVIGO",0,289,0,289,"2022","018"
"37125","COSTA MASNAGA",6,0,0,6,"2022","026"
"37126","COSTA SERINA",7,4,0,11,"2022","247"
"37127","COSTA VALLE IMAGNA",1,2,0,3,"2022","085"
"37128","COSTA VESCOVATO",20,0,0,20,"2022","062"
"37129","COSTA VOLPINO",20,45,13,78,"2022","086"
"37130","COSTABISSARA",36,26,2,64,"2022","035"
"37131","COSTERMANO",14,35,0,49,"2022","030"
"37132","COSTIGLIOLE D'ASTI",479,0,0,479,"2022","050"
"37133","COSTIGLIOLE SALUZZO",582,0,10,592,"2022","075"
"37134","COTIGNOLA",73,0,0,73,"2022","009"
"37135","COVO",2,1653,0,1655,"2022","087"
"37136","COZZO",2,0,0,2,"2022",NA
"37137","CRANDOLA VALSASSINA",0,3,3,6,"2022","027"
"37138","CRAVAGLIANA",0,31,0,31,"2022","048"
"37139","CRAVANZANA",3,0,0,3,"2022","076"
"37140","CRAVEGGIA",20,0,0,20,"2022","024"
"37141","CREAZZO",9,17,0,26,"2022","036"
"37142","CREDARO",0,179,0,179,"2022","088"
"37143","CREDERA RUBBIANO",12,1426,4,1442,"2022","034"
"37144","CREMA",299,2432,143,2874,"2022","035"
"37145","CREMELLA",3,0,0,3,"2022","028"
"37146","CREMENO",5,21,24,50,"2022","029"
"37147","CREMIA",2,0,3,5,"2022","083"
"37148","CREMOLINO",97,0,0,97,"2022","063"
"37149","CREMONA",236,1218,11,1465,"2022","036"
"37150","CREMOSANO",17,596,0,613,"2022","037"
"37151","CRESCENTINO",159,0,41,200,"2022","049"
"37152","CRESPADORO",20,32,1,53,"2022","037"
"37153","CRESPIATICA",5,287,0,292,"2022","025"
"37154","CRESPINO",2219,0,0,2219,"2022","019"
"37155","CRESSA",27,297,2,326,"2022","055"
"37156","CREVACUORE",2,0,0,2,"2022","021"
"37157","CREVALCORE",153,38,0,191,"2022","024"
"37158","CREVOLADOSSOLA",42,23,57,122,"2022","025"
"37159","CROCETTA DEL MONTELLO",16,33,0,49,"2022","025"
"37160","CRODO",53,125,10,188,"2022","026"
"37161","CROTTA D'ADDA",3,403,0,406,"2022","038"
"37162","CUASSO AL MONTE",12,0,0,12,"2022","058"
"37163","CUCCIAGO",4,0,0,4,"2022","084"
"37164","CUCEGLIO",53,0,0,53,"2022","096"
"37165","CUGGIONO",512,58,0,570,"2022","096"
"37166","CUMIANA",978,764,0,1742,"2022","097"
"37167","CUMIGNANO SUL NAVIGLIO",0,1253,0,1253,"2022","039"
"37168","CUNARDO",3,0,0,3,"2022","060"
"37169","CUNEO",8702,868,702,10272,"2022","078"
"37170","CUNICO",1729,0,0,1729,"2022","051"
"37171","CUORGNE'",123,47,0,170,"2022","098"
"37172","CURA CARPIGNANO",15,139,2,156,"2022","060"
"37173","CUREGGIO",13,0,23,36,"2022","058"
"37174","CURIGLIA CON MONTEVIASCO",0,0,3,3,"2022","061"
"37175","CURINO",5,0,0,5,"2022","023"
"37176","CURNO",9,38,0,47,"2022","089"
"37177","CURTAROLO",89,196,0,285,"2022","036"
"37178","CURTATONE",3200,1633,901,5734,"2022","021"
"37179","CUSAGO",0,745,1,746,"2022","097"
"37180","CUSINO",14,0,0,14,"2022","085"
"37181","CUVEGLIO",7,5,0,12,"2022","062"
"37182","CUVIO",0,95,4,99,"2022","063"
"37183","DAIRAGO",0,50,0,50,"2022","099"
"37184","DALMINE",75,109,0,184,"2022","091"
"37185","DANTA DI CADORE",0,2,0,2,"2022",NA
"37186","DARFO BOARIO TERME",11,267,17,295,"2022","065"
"37187","DAVERIO",13,0,0,13,"2022","064"
"37188","DAZIO",0,8,0,8,"2022","025"
"37189","DELEBIO",22,194,2,218,"2022","026"
"37190","DELLO",726,2182,6,2914,"2022","066"
"37191","DEMONTE",1050,82,0,1132,"2022","079"
"37192","DENICE",4,0,0,4,"2022","065"
"37193","DERNICE",14,0,2,16,"2022","066"
"37194","DEROVERE",0,308,4,312,"2022","040"
"37195","DERVIO",1,0,0,1,"2022","030"
"37196","DESANA",18,0,0,18,"2022","054"
"37197","DESENZANO DEL GARDA",53,1564,486,2103,"2022","067"
"37198","DESIO",16,0,0,16,"2022",NA
"37199","DIANO D'ALBA",65,0,0,65,"2022","080"
"37200","DIVIGNANO",36,0,1,37,"2022","060"
"37201","DIZZASCO",0,0,8,8,"2022","087"
"37202","DOGLIANI",1691,0,0,1691,"2022","081"
"37203","DOLO",627,322,0,949,"2022","012"
"37204","DOMASO",0,2,1,3,"2022","089"
"37205","DOMODOSSOLA",6,32,7,45,"2022","028"
"37206","DONATO",114,0,29,143,"2022","024"
"37207","DONGO",2,2,5,9,"2022","090"
"37208","DORMELLETTO",6,0,0,6,"2022","062"
"37209","DORNO",9,29,0,38,"2022","061"
"37210","DORZANO",1,0,0,1,"2022","025"
"37211","DOSOLO",0,382,123,505,"2022","022"
"37212","DOSSENA",57,126,0,183,"2022","092"
"37213","DOSSO DEL LIRO",1,4,13,18,"2022","092"
"37214","DOVADOLA",193,0,0,193,"2022","011"
"37215","DOVERA",95,1225,0,1320,"2022","041"
"37216","DOZZA",13,3,0,16,"2022","025"
"37217","DRONERO",1729,192,29,1950,"2022","082"
"37218","DRUENTO",559,24,0,583,"2022","099"
"37219","DRUOGNO",14,2,6,22,"2022","029"
"37220","DUBINO",213,485,29,727,"2022","027"
"37221","DUE CARRARE",152,0,0,152,"2022","106"
"37222","DUEVILLE",393,629,0,1022,"2022","038"
"37223","DUMENZA",1,0,9,10,"2022","065"
"37224","DUNO",2,0,0,2,"2022",NA
"37225","DUSINO SAN MICHELE",288,53,0,341,"2022","052"
"37226","EDOLO",8,68,10,86,"2022","068"
"37227","ELVA",23,0,35,58,"2022","083"
"37228","ENDINE GAIANO",77,94,0,171,"2022","093"
"37229","ENEGO",3,166,3,172,"2022","039"
"37230","ENTRACQUE",208,0,0,208,"2022","084"
"37231","ENTRATICO",38,5,0,43,"2022","094"
"37232","ENVIE",1562,330,313,2205,"2022","085"
"37233","ERACLEA",4384,291,0,4675,"2022","013"
"37234","ERBA",49,425,2,476,"2022","095"
"37235","ERBE'",270,46,0,316,"2022","032"
"37236","ERBEZZO",32,610,0,642,"2022","033"
"37237","ERBUSCO",235,27,0,262,"2022","069"
"37238","ESINE",8,160,13,181,"2022","070"
"37239","ESINO LARIO",7,0,19,26,"2022","035"
"37240","ESTE",450,50,0,500,"2022","037"
"37241","EUPILIO",23,0,39,62,"2022","097"
"37242","EXILLES",1,0,0,1,"2022",NA
"37243","FABBRICA CURONE",3,6,0,9,"2022","067"
"37244","FABBRICO",0,281,0,281,"2022","021"
"37245","FAEDO VALTELLINO",0,25,0,25,"2022","028"
"37246","FAENZA",266,77,0,343,"2022","010"
"37247","FAGGETO LARIO",0,0,4,4,"2022","098"
"37248","FAGNANO OLONA",7,0,0,7,"2022","067"
"37249","FALCADE",1,26,0,27,"2022","019"
"37250","FALOPPIO",9,0,0,9,"2022","099"
"37251","FANANO",32,492,0,524,"2022","011"
"37252","FARA GERA D'ADDA",19,676,0,695,"2022","096"
"37253","FARA NOVARESE",2,0,0,2,"2022","065"
"37254","FARA OLIVANA CON SOLA",0,224,0,224,"2022","097"
"37255","FARA VICENTINO",516,381,103,1000,"2022","040"
"37256","FARIGLIANO",548,0,0,548,"2022","086"
"37257","FARINI",113,90,0,203,"2022","019"
"37258","FARRA DI SOLIGO",43,26,5,74,"2022","026"
"37259","FAULE",32,0,181,213,"2022","087"
"37260","FAVRIA",371,586,79,1036,"2022","101"
"37261","FEISOGLIO",74,0,0,74,"2022","088"
"37262","FELETTO",21,3,0,24,"2022","102"
"37263","FELINO",19,1150,0,1169,"2022","013"
"37264","FELIZZANO",26,0,0,26,"2022","068"
"37265","FELTRE",145,1101,7,1253,"2022","021"
"37266","FENEGRO'",17,0,38,55,"2022","100"
"37267","FENESTRELLE",25,0,0,25,"2022","103"
"37268","FERNO",0,0,9,9,"2022","068"
"37269","FERRARA",263,132,0,395,"2022","008"
"37270","FERRARA DI MONTE BALDO",100,22,0,122,"2022","034"
"37271","FERRERA DI VARESE",15,0,0,15,"2022","069"
"37272","FERRERA ERBOGNONE",19,0,0,19,"2022","062"
"37273","FERRERE",958,0,0,958,"2022","053"
"37274","FERRIERE",213,4,0,217,"2022","020"
"37275","FIANO",22,0,0,22,"2022","104"
"37276","FICAROLO",18,0,0,18,"2022","021"
"37277","FIDENZA",39,3925,0,3964,"2022","014"
"37278","FIESCO",5,673,0,678,"2022","043"
"37279","FIESSE",641,393,247,1281,"2022","071"
"37280","FIESSO D'ARTICO",2,11,0,13,"2022","014"
"37281","FIESSO UMBERTIANO",3,0,0,3,"2022","022"
"37282","FIGINO SERENZA",81,70,2,153,"2022","101"
"37283","FILAGO",137,0,0,137,"2022","098"
"37284","FILIGHERA",0,55,0,55,"2022","063"
"37285","FINALE EMILIA",9,67,0,76,"2022","012"
"37286","FINO DEL MONTE",2,35,0,37,"2022","099"
"37287","FINO MORNASCO",9,0,0,9,"2022","102"
"37288","FIORANO AL SERIO",3,13,0,16,"2022","100"
"37289","FIORANO CANAVESE",18,0,0,18,"2022","105"
"37290","FIORANO MODENESE",9,80,0,89,"2022","013"
"37291","FIORENZUOLA D'ARDA",157,1812,0,1969,"2022","021"
"37292","FISCAGLIA",1544,100,0,1644,"2022",NA
"37293","FIUMALBO",150,53,0,203,"2022","014"
"37294","FLERO",468,202,80,750,"2022","072"
"37295","FOBELLO",10,0,2,12,"2022","057"
"37296","FOGLIZZO",156,0,0,156,"2022","106"
"37297","FOLLINA",369,74,0,443,"2022","027"
"37298","FOMBIO",0,518,0,518,"2022","026"
"37299","FONTANELICE",379,119,1,499,"2022","026"
"37300","FONTANELLA",3235,2207,0,5442,"2022","101"
"37301","FONTANELLATO",8,2524,0,2532,"2022","015"
"37302","FONTANELLE",60,432,4,496,"2022","028"
"37303","FONTANETO D'AGOGNA",5,138,0,143,"2022","066"
"37304","FONTANETTO PO",2,0,0,2,"2022","058"
"37305","FONTANILE",2,0,0,2,"2022","054"
"37306","FONTANIVA",222,337,2,561,"2022","038"
"37307","FONTE",966,576,13,1555,"2022","029"
"37308","FONTENO",9,0,0,9,"2022","102"
"37309","FONTEVIVO",0,1851,0,1851,"2022","016"
"37310","FONZASO",24,49,0,73,"2022","022"
"37311","FOPPOLO",0,16,0,16,"2022","103"
"37312","FORCOLA",23,125,0,148,"2022","029"
"37313","FORESTO SPARSO",20,68,0,88,"2022","104"
"37314","FORLI'",468,46,0,514,"2022","012"
"37315","FORLIMPOPOLI",8,0,0,8,"2022","013"
"37316","FORMAZZA",3,19,4,26,"2022","031"
"37317","FORMIGARA",4,1174,139,1317,"2022","044"
"37318","FORMIGINE",16,2249,0,2265,"2022","015"
"37319","FORMIGLIANA",25,0,0,25,"2022","059"
"37320","FORNO CANAVESE",39,0,8,47,"2022","107"
"37321","FORNOVO DI TARO",3,666,0,669,"2022","017"
"37322","FORNOVO SAN GIOVANNI",24,680,0,704,"2022","105"
"37323","FORTUNAGO",63,0,0,63,"2022","064"
"37324","FOSSALTA DI PIAVE",2,0,0,2,"2022","015"
"37325","FOSSALTA DI PORTOGRUARO",1,794,0,795,"2022","016"
"37326","FOSSANO",18528,4439,1188,24155,"2022","089"
"37327","FOSSO'",80,22,0,102,"2022","017"
"37328","FOZA",45,9,37,91,"2022","041"
"37329","FRABOSA SOPRANA",356,0,177,533,"2022","090"
"37330","FRABOSA SOTTANA",64,32,27,123,"2022","091"
"37331","FRACONALTO",38,0,0,38,"2022","069"
"37332","FRASCAROLO",278,26,0,304,"2022","065"
"37333","FRASSINELLE POLESINE",137,0,0,137,"2022","023"
"37334","FRASSINELLO MONFERRATO",62,0,0,62,"2022","072"
"37335","FRASSINETO PO",32,0,0,32,"2022","073"
"37336","FRASSINETTO",60,4,0,64,"2022","108"
"37337","FRASSINO",23,0,1,24,"2022","092"
"37338","FRASSINORO",91,99,0,190,"2022","016"
"37339","FRATTA POLESINE",331,77,0,408,"2022","024"
"37340","FREGONA",23,24,1,48,"2022","030"
"37341","FRESONARA",24,0,0,24,"2022","074"
"37342","FRINCO",321,0,0,321,"2022","055"
"37343","FRONT",48,0,8,56,"2022","109"
"37344","FROSSASCO",1844,14,143,2001,"2022","110"
"37345","FRUGAROLO",121,128,0,249,"2022","075"
"37346","FUBINE MONFERRATO",190,0,0,190,"2022",NA
"37347","FUIPIANO VALLE IMAGNA",9,32,0,41,"2022","106"
"37348","FUMANE",16,45,0,61,"2022","035"
"37349","FUSIGNANO",4,0,0,4,"2022","011"
"37350","FUSINE",0,19,0,19,"2022","030"
"37351","GABBIONETA-BINANUOVA",49,686,0,735,"2022","045"
"37352","GABIANO",26,0,0,26,"2022","077"
"37353","GADESCO-PIEVE DELMONA",126,521,0,647,"2022","046"
"37354","GAGGIANO",0,445,2,447,"2022","103"
"37355","GAGGIO MONTANO",309,341,0,650,"2022","027"
"37356","GAGLIANICO",2,0,0,2,"2022","026"
"37357","GAIARINE",790,0,0,790,"2022","031"
"37358","GAIBA",13,0,0,13,"2022","025"
"37359","GAIOLA",21,0,0,21,"2022","093"
"37360","GALBIATE",45,11,10,66,"2022","036"
"37361","GALEATA",445,0,11,456,"2022","014"
"37362","GALGAGNANO",0,921,0,921,"2022","027"
"37363","GALLARATE",13,0,17,30,"2022","070"
"37364","GALLIATE",9,76,0,85,"2022","068"
"37365","GALLIATE LOMBARDO",20,0,0,20,"2022","071"
"37366","GALLIERA VENETA",2915,148,0,3063,"2022","039"
"37367","GALLIO",9,178,3,190,"2022","042"
"37368","GALZIGNANO TERME",4,0,0,4,"2022","040"
"37369","GAMALERO",15,0,0,15,"2022","078"
"37370","GAMBARA",4518,2828,156,7502,"2022","073"
"37371","GAMBASCA",2,0,0,2,"2022","094"
"37372","GAMBOLO'",74,95,0,169,"2022","068"
"37373","GAMBUGLIANO",0,39,20,59,"2022","044"
"37374","GANDELLINO",11,11,0,22,"2022","107"
"37375","GANDINO",44,138,0,182,"2022","108"
"37376","GANDOSSO",6,0,0,6,"2022","109"
"37377","GARBAGNA",83,0,0,83,"2022","079"
"37378","GARBAGNA NOVARESE",2,0,0,2,"2022","069"
"37379","GARBAGNATE MONASTERO",4,0,0,4,"2022","037"
"37380","GARDA",2,0,0,2,"2022","036"
"37381","GARDONE RIVIERA",2,0,3,5,"2022","074"
"37382","GARDONE VAL TROMPIA",23,0,0,23,"2022","075"
"37383","GARESSIO",276,0,14,290,"2022","095"
"37384","GARGNANO",22,3,6,31,"2022","076"
"37385","GARLASCO",10,0,0,10,"2022","069"
"37386","GARZENO",13,6,11,30,"2022","106"
"37387","GARZIGLIANA",229,0,0,229,"2022","111"
"37388","GASSINO TORINESE",26,0,0,26,"2022","112"
"37389","GATTATICO",7,3113,2,3122,"2022","022"
"37390","GATTEO",2,0,0,2,"2022","016"
"37391","GATTICO-VERUNO",11,352,63,426,"2022",NA
"37392","GATTINARA",60,0,0,60,"2022","061"
"37393","GAVARDO",57,497,108,662,"2022","077"
"37394","GAVELLO",120,0,0,120,"2022",NA
"37395","GAVERINA TERME",7,43,0,50,"2022","110"
"37396","GAVI",9,0,0,9,"2022","081"
"37397","GAVIRATE",28,0,0,28,"2022","072"
"37398","GAZOLDO DEGLI IPPOLITI",590,88,3,681,"2022","024"
"37399","GAZZADA SCHIANNO",10,0,6,16,"2022","073"
"37400","GAZZANIGA",15,16,0,31,"2022","111"
"37401","GAZZO",64,2797,0,2861,"2022","041"
"37402","GAZZO VERONESE",646,307,0,953,"2022","037"
"37403","GAZZOLA",297,1747,0,2044,"2022","022"
"37404","GAZZUOLO",24,37,0,61,"2022","025"
"37405","GEMMANO",34,66,0,100,"2022","004"
"37406","GENIVOLTA",71,1642,23,1736,"2022","047"
"37407","GENOLA",1919,2334,235,4488,"2022","096"
"37408","GERA LARIO",19,287,14,320,"2022","107"
"37409","GERENZANO",111,107,0,218,"2022","075"
"37410","GERMAGNANO",11,0,0,11,"2022","113"
"37411","GERMAGNO",1,0,0,1,"2022","032"
"37412","GERMIGNAGA",8,84,0,92,"2022","076"
"37413","GERRE DE' CAPRIOLI",0,620,0,620,"2022","048"
"37414","GESSATE",6,423,0,429,"2022","106"
"37415","GHEDI",3413,7155,27,10595,"2022","078"
"37416","GHEMME",31,5,13,49,"2022","073"
"37417","GHIFFA",1,0,2,3,"2022","033"
"37418","GHISALBA",2,827,0,829,"2022","113"
"37419","GHISLARENGO",27,0,0,27,"2022","062"
"37420","GIAGLIONE",24,0,0,24,"2022","114"
"37421","GIANICO",53,131,255,439,"2022","079"
"37422","GIAVENO",169,376,162,707,"2022","115"
"37423","GIAVERA DEL MONTELLO",927,141,0,1068,"2022","032"
"37424","GIGNESE",9,0,0,9,"2022","034"
"37425","GIUSSAGO",8,70,0,78,"2022","072"
"37426","GIUSSANO",2,0,0,2,"2022",NA
"37427","GIVOLETTO",24,0,0,24,"2022","116"
"37428","GODEGA DI SANT'URBANO",35,59,36,130,"2022","033"
"37429","GODIASCO",7,0,5,12,"2022","073"
"37430","GOITO",3783,5374,832,9989,"2022","026"
"37431","GOLASECCA",13,0,0,13,"2022","077"
"37432","GOLFERENZO",0,0,19,19,"2022","074"
"37433","GOMBITO",6,1160,0,1166,"2022","049"
"37434","GONZAGA",17503,4479,4857,26839,"2022","027"
"37435","GORDONA",74,111,32,217,"2022","032"
"37436","GORGO AL MONTICANO",61,286,0,347,"2022","034"
"37437","GORGONZOLA",21,225,13,259,"2022","108"
"37438","GORLA MAGGIORE",3,153,0,156,"2022","078"
"37439","GORLA MINORE",72,0,0,72,"2022","079"
"37440","GORLAGO",77,300,0,377,"2022","114"
"37441","GORNATE-OLONA",12,0,1,13,"2022","080"
"37442","GORNO",15,97,0,112,"2022","116"
"37443","GORZEGNO",61,0,0,61,"2022","097"
"37444","GOSALDO",5,0,0,5,"2022",NA
"37445","GOSSOLENGO",4,728,0,732,"2022","023"
"37446","GOTTASECCA",41,0,0,41,"2022","098"
"37447","GOTTOLENGO",14515,1402,80,15997,"2022","080"
"37448","GOVONE",324,0,0,324,"2022","099"
"37449","GRAFFIGNANA",33,284,55,372,"2022","028"
"37450","GRAGLIA",58,13,75,146,"2022","028"
"37451","GRAGNANO TREBBIENSE",55,4059,0,4114,"2022","024"
"37452","GRANA",40,0,0,40,"2022","056"
"37453","GRANAROLO DELL'EMILIA",501,210,0,711,"2022","030"
"37454","GRANDOLA ED UNITI",0,6,44,50,"2022","111"
"37455","GRANOZZO CON MONTICELLO",0,47,0,47,"2022","077"
"37456","GRANTOLA",49,0,0,49,"2022","081"
"37457","GRANTORTO",61,876,0,937,"2022","042"
"37458","GRANZE",905,0,0,905,"2022","043"
"37459","GRASSOBBIO",6,125,0,131,"2022","117"
"37460","GRAVEDONA ED UNITI",10,14,30,54,"2022","249"
"37461","GRAVELLONA LOMELLINA",0,0,7,7,"2022","075"
"37462","GRAVELLONA TOCE",13,0,0,13,"2022","035"
"37463","GRAVERE",1,0,0,1,"2022","117"
"37464","GRAZZANO BADOGLIO",347,0,0,347,"2022","057"
"37465","GREMIASCO",43,0,0,43,"2022","083"
"37466","GREZZAGO",3,0,0,3,"2022","110"
"37467","GREZZANA",119,434,18,571,"2022","038"
"37468","GRIANTE",5,0,6,11,"2022","113"
"37469","GRIGNASCO",31,0,0,31,"2022","079"
"37470","GRINZANE CAVOUR",12,0,0,12,"2022","100"
"37471","GRISIGNANO DI ZOCCO",23,446,0,469,"2022","046"
"37472","GRIZZANA MORANDI",102,0,0,102,"2022","031"
"37473","GROMO",39,92,0,131,"2022","118"
"37474","GRONDONA",10,0,0,10,"2022","085"
"37475","GRONE",17,33,0,50,"2022","119"
"37476","GRONTARDO",155,1969,0,2124,"2022","050"
"37477","GROPELLO CAIROLI",29,0,0,29,"2022","076"
"37478","GROPPARELLO",157,14,0,171,"2022","025"
"37479","GROSCAVALLO",11,0,0,11,"2022","118"
"37480","GROSIO",12,212,2,226,"2022","033"
"37481","GROSOTTO",2,86,6,94,"2022","034"
"37482","GROSSO",49,0,30,79,"2022","119"
"37483","GRUARO",9,208,0,217,"2022","018"
"37484","GRUGLIASCO",83,0,65,148,"2022","120"
"37485","GRUMELLO CREMONESE ED UNITI",7,2119,0,2126,"2022","051"
"37486","GRUMELLO DEL MONTE",19,103,0,122,"2022","120"
"37487","GRUMOLO DELLE ABBADESSE",20,196,0,216,"2022","047"
"37488","GUALTIERI",1319,521,0,1840,"2022","023"
"37489","GUANZATE",6,0,19,25,"2022","114"
"37490","GUARDA VENETA",631,0,0,631,"2022","028"
"37491","GUARDABOSONE",54,9,0,63,"2022","066"
"37492","GUARDAMIGLIO",16,569,6,591,"2022","029"
"37493","GUARENE",309,0,0,309,"2022","101"
"37494","GUASTALLA",4,1218,4,1226,"2022","024"
"37495","GUDO VISCONTI",5,0,4,9,"2022","112"
"37496","GUIDIZZOLO",1455,867,320,2642,"2022","028"
"37497","GUIGLIA",47,417,0,464,"2022","017"
"37498","GUSSAGO",26,1097,126,1249,"2022","081"
"37499","GUSSOLA",0,54,12,66,"2022","052"
"37500","IDRO",0,0,5,5,"2022","082"
"37501","IGLIANO",56,0,23,79,"2022","102"
"37502","ILLASI",0,37,0,37,"2022","039"
"37503","IMBERSAGO",1,0,1,2,"2022","039"
"37504","IMOLA",115,0,0,115,"2022","032"
"37505","INARZO",13,0,0,13,"2022","082"
"37506","INCISA SCAPACCINO",26,0,0,26,"2022","058"
"37507","INCUDINE",4,0,2,6,"2022","083"
"37508","INDUNO OLONA",19,102,0,121,"2022","083"
"37509","INTRAGNA",1,0,0,1,"2022","037"
"37510","INTROBIO",11,18,80,109,"2022","040"
"37511","INVERIGO",136,0,51,187,"2022","118"
"37512","INVERNO E MONTELEONE",54,209,22,285,"2022","077"
"37513","INVERSO PINASCA",21,0,0,21,"2022","122"
"37514","INVERUNO",20,49,0,69,"2022","113"
"37515","INVORIO",70,71,0,141,"2022","082"
"37516","INZAGO",365,444,115,924,"2022","114"
"37517","IRMA",11,0,0,11,"2022","084"
"37518","ISASCA",13,0,0,13,"2022","103"
"37519","ISEO",27,31,0,58,"2022","085"
"37520","ISOLA D'ASTI",461,0,0,461,"2022","059"
"37521","ISOLA DELLA SCALA",6376,435,0,6811,"2022","040"
"37522","ISOLA DI FONDRA",3,24,0,27,"2022","121"
"37523","ISOLA DOVARESE",0,647,0,647,"2022","053"
"37524","ISOLA RIZZA",2167,399,0,2566,"2022","041"
"37525","ISOLA VICENTINA",1740,732,23,2495,"2022","048"
"37526","ISOLABELLA",23,470,0,493,"2022","123"
"37527","ISORELLA",12168,344,3,12515,"2022","086"
"37528","ISPRA",50,181,0,231,"2022","084"
"37529","ISSIGLIO",92,24,15,131,"2022","124"
"37530","ISSO",12,1141,0,1153,"2022","122"
"37531","ISTRANA",1720,365,8,2093,"2022","035"
"37532","IVREA",371,209,17,597,"2022","125"
"37533","IZANO",1,1021,0,1022,"2022","054"
"37534","JESOLO",2,81,0,83,"2022",NA
"37535","JOLANDA DI SAVOIA",4264,0,0,4264,"2022","010"
"37536","LA CASSA",0,259,0,259,"2022","126"
"37537","LA LOGGIA",244,0,0,244,"2022","127"
"37538","LA MORRA",53,0,0,53,"2022","105"
"37539","LA VALLE AGORDINA",7,21,7,35,"2022","027"
"37540","LA VALLETTA BRIANZA",14,12,1,27,"2022",NA
"37541","LACCHIARELLA",3,31,0,34,"2022","115"
"37542","LAGNASCO",17,0,77,94,"2022","104"
"37543","LAGOSANTO",58,0,0,58,"2022","011"
"37544","LAINATE",13,0,2,15,"2022","116"
"37545","LAINO",1,1,0,2,"2022","120"
"37546","LAMA MOCOGNO",90,417,0,507,"2022","018"
"37547","LAMBRUGO",1,124,0,125,"2022","121"
"37548","LAMON",6,32,0,38,"2022","026"
"37549","LAMPORO",23,0,0,23,"2022","067"
"37550","LANDRIANO",1,225,0,226,"2022","078"
"37551","LANGHIRANO",0,984,0,984,"2022","018"
"37552","LANGOSCO",2,0,0,2,"2022","079"
"37553","LANZADA",13,74,4,91,"2022","036"
"37554","LANZO TORINESE",110,0,6,116,"2022","128"
"37555","LARDIRAGO",0,0,40,40,"2022",NA
"37556","LASNIGO",1,28,0,29,"2022","123"
"37557","LASTEBASSE",3,0,0,3,"2022",NA
"37558","LAURIANO",17,0,0,17,"2022","129"
"37559","LAVENA PONTE TRESA",4,0,0,4,"2022","086"
"37560","LAVENO-MOMBELLO",2,0,0,2,"2022","087"
"37561","LAVENONE",13,0,0,13,"2022","087"
"37562","LAZISE",27,4,0,31,"2022","043"
"37563","LAZZATE",1,0,24,25,"2022",NA
"37564","LECCO",11,16,9,36,"2022","042"
"37565","LEFFE",13,87,0,100,"2022","124"
"37566","LEGGIUNO",3,0,0,3,"2022","088"
"37567","LEGNAGO",68,36,94,198,"2022","044"
"37568","LEGNANO",0,94,0,94,"2022","118"
"37569","LEGNARO",181,50,0,231,"2022","044"
"37570","LEINI",730,571,74,1375,"2022",NA
"37571","LEMIE",9,0,0,9,"2022","131"
"37572","LENDINARA",574,112,0,686,"2022","029"
"37573","LENNA",5,14,0,19,"2022","125"
"37574","LENO",5096,7453,685,13234,"2022","088"
"37575","LENTA",14,0,0,14,"2022","068"
"37576","LENTATE SUL SEVESO",0,200,14,214,"2022",NA
"37577","LEQUIO BERRIA",15,0,0,15,"2022","106"
"37578","LEQUIO TANARO",2187,0,0,2187,"2022","107"
"37579","LERMA",4,0,0,4,"2022","088"
"37580","LESA",3,0,0,3,"2022","084"
"37581","LESEGNO",1546,0,0,1546,"2022","108"
"37582","LESIGNANO DE' BAGNI",48,1529,0,1577,"2022","019"
"37583","LESMO",0,172,17,189,"2022",NA
"37584","LESSOLO",184,0,5,189,"2022","132"
"37585","LESSONA",3,0,0,3,"2022","029"
"37586","LEVICE",43,0,0,43,"2022","109"
"37587","LEZZENO",0,0,2,2,"2022","126"
"37588","LIERNA",5,3,2,10,"2022","043"
"37589","LIGNANA",1,0,0,1,"2022","070"
"37590","LIMANA",189,70,0,259,"2022","029"
"37591","LIMBIATE",1,0,0,1,"2022",NA
"37592","LIMENA",57,647,66,770,"2022","045"
"37593","LIMIDO COMASCO",2,27,0,29,"2022","128"
"37594","LIMONE PIEMONTE",30,0,0,30,"2022","110"
"37595","LINAROLO",6,333,0,339,"2022","081"
"37596","LIPOMO",1,0,0,1,"2022",NA
"37597","LIRIO",46,0,0,46,"2022","082"
"37598","LISCATE",7,0,0,7,"2022","122"
"37599","LISIO",56,0,0,56,"2022","111"
"37600","LISSONE",40,0,180,220,"2022",NA
"37601","LIVIGNO",68,282,0,350,"2022","037"
"37602","LIVINALLONGO DEL COL DI LANA",8,56,0,64,"2022","030"
"37603","LIVO",2,16,0,18,"2022","130"
"37604","LIVORNO FERRARIS",2,54,0,56,"2022","071"
"37605","LIVRAGA",27,940,63,1030,"2022","030"
"37606","LIZZANO IN BELVEDERE",15,87,14,116,"2022","033"
"37607","LOAZZOLO",5,0,7,12,"2022","060"
"37608","LOCANA",123,48,0,171,"2022","134"
"37609","LOCATE DI TRIULZI",0,1123,0,1123,"2022","125"
"37610","LOCATE VARESINO",10,0,0,10,"2022","131"
"37611","LOCATELLO",28,22,0,50,"2022","127"
"37612","LODI",558,1274,2,1834,"2022","031"
"37613","LODI VECCHIO",0,1504,0,1504,"2022","032"
"37614","LODRINO",7,10,0,17,"2022","090"
"37615","LOGRATO",1289,794,17,2100,"2022","091"
"37616","LOIANO",87,187,0,274,"2022","034"
"37617","LOMBARDORE",16,7,0,23,"2022","135"
"37618","LOMBRIASCO",92,132,0,224,"2022","136"
"37619","LOMELLO",84,201,0,285,"2022","083"
"37620","LONATE CEPPINO",1,286,0,287,"2022","089"
"37621","LONATE POZZOLO",3,0,9,12,"2022","090"
"37622","LONATO DEL GARDA",2403,5262,522,8187,"2022",NA
"37623","LONGARE",39,186,0,225,"2022","051"
"37624","LONGARONE",9,0,0,9,"2022","031"
"37625","LONGHENA",0,452,0,452,"2022","093"
"37626","LONGIANO",45,0,0,45,"2022","018"
"37627","LONIGO",5142,463,0,5605,"2022","052"
"37628","LORANZE'",48,0,0,48,"2022","137"
"37629","LOREGGIA",174,410,0,584,"2022","046"
"37630","LOREGLIA",6,0,0,6,"2022","038"
"37631","LORENZAGO DI CADORE",1,2,0,3,"2022","032"
"37632","LOREO",981,43,0,1024,"2022","030"
"37633","LORIA",6186,0,12,6198,"2022","036"
"37634","LOSINE",0,6,0,6,"2022","094"
"37635","LOVERE",3,40,0,43,"2022","128"
"37636","LOVERO",2,3,0,5,"2022","038"
"37637","LOZIO",0,4,0,4,"2022","095"
"37638","LOZZA",0,112,0,112,"2022","091"
"37639","LOZZO ATESTINO",1210,0,0,1210,"2022","047"
"37640","LU E CUCCARO MONFERRATO",53,0,0,53,"2022",NA
"37641","LUGAGNANO VAL D'ARDA",76,140,0,216,"2022","026"
"37642","LUGO",480,108,0,588,"2022","012"
"37643","LUGO DI VICENZA",11,105,0,116,"2022","053"
"37644","LUINO",4,10,0,14,"2022","092"
"37645","LUISAGO",4,0,7,11,"2022","135"
"37646","LUMEZZANE",14,0,0,14,"2022","096"
"37647","LURAGO D'ERBA",2,0,8,10,"2022","136"
"37648","LURAGO MARINONE",0,170,0,170,"2022","137"
"37649","LURANO",23,13,0,36,"2022","129"
"37650","LURATE CACCIVIO",22,129,0,151,"2022","138"
"37651","LUSERNA SAN GIOVANNI",285,62,79,426,"2022","139"
"37652","LUSERNETTA",88,0,0,88,"2022","140"
"37653","LUSIA",11,0,0,11,"2022","031"
"37654","LUSIANA CONCO",25,306,2,333,"2022",NA
"37655","LUSIGLIE'",98,0,0,98,"2022","141"
"37656","LUZZANA",16,0,0,16,"2022","130"
"37657","LUZZARA",1619,1320,0,2939,"2022","026"
"37658","MACCAGNO CON PINO E VEDDASCA",3,9,0,12,"2022",NA
"37659","MACCASTORNA",0,1,521,522,"2022","033"
"37660","MACELLO",1598,370,160,2128,"2022","142"
"37661","MACLODIO",16,153,0,169,"2022","097"
"37662","MACRA",3,0,0,3,"2022",NA
"37663","MACUGNAGA",1,6,0,7,"2022","039"
"37664","MADESIMO",0,6,0,6,"2022","035"
"37665","MADIGNANO",75,830,0,905,"2022","055"
"37666","MADONE",3,0,0,3,"2022","131"
"37667","MADONNA DEL SASSO",16,0,0,16,"2022","040"
"37668","MAGASA",7,2,0,9,"2022","098"
"37669","MAGENTA",37,831,26,894,"2022","130"
"37670","MAGGIORA",104,54,0,158,"2022","088"
"37671","MAGHERNO",0,125,0,125,"2022","085"
"37672","MAGLIANO ALFIERI",459,0,0,459,"2022","113"
"37673","MAGLIANO ALPI",473,96,0,569,"2022","114"
"37674","MAGNACAVALLO",1,299,495,795,"2022","029"
"37675","MAGNAGO",51,0,0,51,"2022","131"
"37676","MAGNANO",34,19,0,53,"2022","030"
"37677","MAIOLO",151,0,0,151,"2022","022"
"37678","MAIRAGO",0,475,0,475,"2022","034"
"37679","MAIRANO",322,525,0,847,"2022","099"
"37680","MALAGNINO",146,748,0,894,"2022","056"
"37681","MALCESINE",11,99,21,131,"2022","045"
"37682","MALEGNO",21,24,8,53,"2022","100"
"37683","MALEO",137,1404,0,1541,"2022","035"
"37684","MALESCO",32,0,4,36,"2022","041"
"37685","MALGESSO",51,0,0,51,"2022","095"
"37686","MALNATE",28,41,0,69,"2022","096"
"37687","MALO",2154,238,0,2392,"2022","055"
"37688","MALONNO",10,153,81,244,"2022","101"
"37689","MALVICINO",6,0,0,6,"2022","090"
"37690","MANDELLO DEL LARIO",5,1,2,8,"2022","046"
"37691","MANDELLO VITTA",1,0,0,1,"2022","090"
"37692","MANERBA DEL GARDA",0,0,29,29,"2022","102"
"37693","MANERBIO",667,1174,0,1841,"2022","103"
"37694","MANGO",7,0,0,7,"2022","115"
"37695","MANSUE'",52,176,7,235,"2022","037"
"37696","MANTELLO",1,127,0,128,"2022","039"
"37697","MANTOVA",668,787,127,1582,"2022","030"
"37698","MAPELLO",35,0,0,35,"2022","132"
"37699","MARANELLO",36,607,0,643,"2022","019"
"37700","MARANO DI VALPOLICELLA",14,51,11,76,"2022","046"
"37701","MARANO SUL PANARO",35,703,0,738,"2022","020"
"37702","MARANO TICINO",1,220,0,221,"2022","091"
"37703","MARANO VICENTINO",265,303,27,595,"2022","056"
"37704","MARCALLO CON CASONE",0,369,0,369,"2022","134"
"37705","MARCARIA",2983,3151,381,6515,"2022","031"
"37706","MARCHENO",11,17,0,28,"2022","104"
"37707","MARCIGNAGO",2,0,0,2,"2022","086"
"37708","MARCON",362,11,0,373,"2022","020"
"37709","MARENE",3538,2128,101,5767,"2022","117"
"37710","MARENO DI PIAVE",957,105,4,1066,"2022","038"
"37711","MARENTINO",94,0,0,94,"2022","144"
"37712","MARETTO",172,0,0,172,"2022","062"
"37713","MARGARITA",864,0,0,864,"2022","118"
"37714","MARGNO",0,8,1,9,"2022","047"
"37715","MARIANA MANTOVANA",99,397,63,559,"2022","032"
"37716","MARIANO COMENSE",720,40,7,767,"2022","143"
"37717","MARMENTINO",11,32,6,49,"2022","105"
"37718","MARMIROLO",3501,2811,2958,9270,"2022","033"
"37719","MARMORA",0,0,128,128,"2022","119"
"37720","MARONE",20,0,21,41,"2022","106"
"37721","MAROSTICA",112,524,12,648,"2022","057"
"37722","MARSAGLIA",83,0,0,83,"2022","120"
"37723","MARTELLAGO",16,0,18,34,"2022","021"
"37724","MARTIGNANA DI PO",1,0,0,1,"2022","057"
"37725","MARTINENGO",235,2472,0,2707,"2022","133"
"37726","MARTINIANA PO",74,0,33,107,"2022","121"
"37727","MARUDO",3,243,0,246,"2022","036"
"37728","MARZABOTTO",19,106,0,125,"2022","036"
"37729","MARZANO",132,337,0,469,"2022","087"
"37730","MARZIO",3,0,2,5,"2022","099"
"37731","MASATE",178,15,0,193,"2022","136"
"37732","MASCIAGO PRIMO",59,0,0,59,"2022","100"
"37733","MASER",3954,39,0,3993,"2022","039"
"37734","MASERA",34,32,1,67,"2022","042"
"37735","MASERA' DI PADOVA",275,160,0,435,"2022","048"
"37736","MASERADA SUL PIAVE",2431,117,12,2560,"2022","040"
"37737","MASI",61,0,0,61,"2022","049"
"37738","MASI TORELLO",6,97,0,103,"2022","012"
"37739","MASIO",784,0,0,784,"2022","091"
"37740","MASLIANICO",0,0,1,1,"2022","144"
"37741","MASSA LOMBARDA",33,0,0,33,"2022","013"
"37742","MASSALENGO",0,123,0,123,"2022","037"
"37743","MASSANZAGO",299,150,0,449,"2022","050"
"37744","MASSAZZA",35,0,0,35,"2022","031"
"37745","MASSELLO",10,0,0,10,"2022","145"
"37746","MASSERANO",59,0,0,59,"2022","032"
"37747","MASSINO VISCONTI",14,0,0,14,"2022","093"
"37748","MASSIOLA",3,0,0,3,"2022","043"
"37749","MATHI",162,0,92,254,"2022","146"
"37750","MATTIE",2,0,4,6,"2022","147"
"37751","MAZZANO",56,418,303,777,"2022","107"
"37752","MAZZE'",1040,0,0,1040,"2022","148"
"37753","MAZZO DI VALTELLINA",10,25,14,49,"2022","040"
"37754","MEANA DI SUSA",2,0,0,2,"2022","149"
"37755","MEDA",1,0,0,1,"2022",NA
"37756","MEDE",33,0,0,33,"2022","088"
"37757","MEDESANO",177,1391,0,1568,"2022","020"
"37758","MEDICINA",18,110,0,128,"2022","037"
"37759","MEDIGLIA",5,1396,12,1413,"2022","139"
"37760","MEDOLAGO",6,0,0,6,"2022","250"
"37761","MEDOLE",705,2312,351,3368,"2022","034"
"37762","MEDOLLA",0,534,0,534,"2022","021"
"37763","MEDUNA DI LIVENZA",12,12,0,24,"2022","041"
"37764","MEGLIADINO SAN VITALE",2560,0,0,2560,"2022","052"
"37765","MELAZZO",124,0,0,124,"2022","092"
"37766","MELDOLA",239,0,0,239,"2022","019"
"37767","MELEGNANO",0,158,0,158,"2022","140"
"37768","MELETI",379,143,5,527,"2022","038"
"37769","MELLE",80,0,24,104,"2022","122"
"37770","MELLO",30,24,6,60,"2022","041"
"37771","MELZO",108,161,3,272,"2022","142"
"37772","MENAGGIO",3,0,0,3,"2022","145"
"37773","MENCONICO",14,0,0,14,"2022","089"
"37774","MEOLO",539,95,0,634,"2022","022"
"37775","MERANA",34,0,0,34,"2022","093"
"37776","MERATE",29,269,1,299,"2022","048"
"37777","MERCATO SARACENO",363,19,0,382,"2022","020"
"37778","MERCENASCO",344,0,0,344,"2022","150"
"37779","MERGOZZO",23,0,0,23,"2022","044"
"37780","MERLARA",723,0,0,723,"2022","053"
"37781","MERLINO",0,1320,0,1320,"2022","039"
"37782","MERONE",30,18,0,48,"2022","147"
"37783","MESE",23,39,25,87,"2022","043"
"37784","MESENZANA",1,27,0,28,"2022","102"
"37785","MESERO",13,22,0,35,"2022","144"
"37786","MESOLA",701,227,0,928,"2022","014"
"37787","MESTRINO",100,66,0,166,"2022","054"
"37788","MEZZANA BIGLI",60,0,0,60,"2022","090"
"37789","MEZZANE DI SOTTO",2,16,0,18,"2022","047"
"37790","MEZZENILE",54,0,6,60,"2022","152"
"37791","MEZZOLDO",1,16,0,17,"2022","134"
"37792","MEZZOMERICO",16,0,0,16,"2022","097"
"37793","MIAGLIANO",7,0,0,7,"2022","034"
"37794","MIANE",5,7,0,12,"2022","042"
"37795","MIASINO",0,0,40,40,"2022","098"
"37796","MIAZZINA",1,0,0,1,"2022","045"
"37797","MILANO",171,122,135,428,"2022","146"
"37798","MILZANO",2,984,0,986,"2022","108"
"37799","MINERBE",1359,193,147,1699,"2022","048"
"37800","MINERBIO",92,0,0,92,"2022","038"
"37801","MIRA",2158,210,7,2375,"2022","023"
"37802","MIRABELLO MONFERRATO",71,0,0,71,"2022","094"
"37803","MIRADOLO TERME",4,0,41,45,"2022","093"
"37804","MIRANDOLA",262,1522,0,1784,"2022","022"
"37805","MIRANO",664,666,0,1330,"2022","024"
"37806","MISANO ADRIATICO",11,0,0,11,"2022","005"
"37807","MISANO DI GERA D'ADDA",14,220,0,234,"2022","135"
"37808","MISSAGLIA",11,502,4,517,"2022","049"
"37809","MODENA",61,2101,0,2162,"2022","023"
"37810","MODIGLIANA",138,0,0,138,"2022","022"
"37811","MOGLIA",3984,1247,686,5917,"2022","035"
"37812","MOGLIANO VENETO",1179,391,182,1752,"2022","043"
"37813","MOIO DE' CALVI",1,7,0,8,"2022","136"
"37814","MOIOLA",9,0,23,32,"2022","123"
"37815","MOLINELLA",2030,362,0,2392,"2022","039"
"37816","MOLLIA",0,7,0,7,"2022","078"
"37817","MOLTENO",5,36,3,44,"2022","051"
"37818","MOMBALDONE",31,0,3,34,"2022","064"
"37819","MOMBARCARO",95,0,0,95,"2022","124"
"37820","MOMBARUZZO",3,0,0,3,"2022","065"
"37821","MOMBASIGLIO",63,0,0,63,"2022","125"
"37822","MOMBELLO DI TORINO",61,0,0,61,"2022","153"
"37823","MOMBELLO MONFERRATO",7,0,0,7,"2022","097"
"37824","MOMBERCELLI",50,0,0,50,"2022","066"
"37825","MOMO",169,544,4,717,"2022","100"
"37826","MOMPERONE",4,0,0,4,"2022","098"
"37827","MONALE",16,0,0,16,"2022","067"
"37828","MONASTERO BORMIDA",335,0,0,335,"2022","068"
"37829","MONASTERO DI LANZO",8,0,0,8,"2022","155"
"37830","MONASTERO DI VASCO",399,0,57,456,"2022","126"
"37831","MONASTEROLO CASOTTO",41,0,0,41,"2022","127"
"37832","MONASTEROLO DEL CASTELLO",8,22,0,30,"2022","137"
"37833","MONASTEROLO DI SAVIGLIANO",411,254,106,771,"2022","128"
"37834","MONASTIER DI TREVISO",1746,41,109,1896,"2022","044"
"37835","MONCALIERI",135,400,0,535,"2022","156"
"37836","MONCALVO",109,0,0,109,"2022","069"
"37837","MONCENISIO",1,0,0,1,"2022","157"
"37838","MONCHIERO",213,0,0,213,"2022","129"
"37839","MONCHIO DELLE CORTI",42,161,0,203,"2022","022"
"37840","MONCRIVELLO",95,223,0,318,"2022","079"
"37841","MONCUCCO TORINESE",36,0,0,36,"2022","070"
"37842","MONDAINO",6,0,0,6,"2022","006"
"37843","MONDOVI'",5554,14,343,5911,"2022","130"
"37844","MONESIGLIO",79,0,0,79,"2022","131"
"37845","MONFORTE D'ALBA",282,0,0,282,"2022","132"
"37846","MONFUMO",25,178,6,209,"2022","045"
"37847","MONGARDINO",21,0,0,21,"2022","071"
"37848","MONGHIDORO",40,96,0,136,"2022","040"
"37849","MONGIARDINO LIGURE",25,0,12,37,"2022","100"
"37850","MONGRANDO",112,124,0,236,"2022","035"
"37851","MONGUZZO",26,0,0,26,"2022","153"
"37852","MONNO",2,53,12,67,"2022","110"
"37853","MONSELICE",181,48,0,229,"2022","055"
"37854","MONTA'",304,0,0,304,"2022","133"
"37855","MONTABONE",16,0,0,16,"2022","072"
"37856","MONTAFIA",24,0,0,24,"2022","073"
"37857","MONTAGNA IN VALTELLINA",11,70,0,81,"2022","044"
"37858","MONTAGNANA",1532,0,9,1541,"2022","056"
"37859","MONTALDO DI MONDOVI'",105,0,16,121,"2022","134"
"37860","MONTALDO SCARAMPI",32,0,0,32,"2022","074"
"37861","MONTALDO TORINESE",585,0,0,585,"2022","158"
"37862","MONTALTO DORA",35,0,0,35,"2022","160"
"37863","MONTALTO PAVESE",86,0,0,86,"2022","094"
"37864","MONTANARO",210,120,0,330,"2022","161"
"37865","MONTANASO LOMBARDO",57,1188,0,1245,"2022","040"
"37866","MONTANERA",1963,894,121,2978,"2022","136"
"37867","MONTANO LUCINO",3,0,6,9,"2022","154"
"37868","MONTE CREMASCO",248,123,0,371,"2022","058"
"37869","MONTE DI MALO",14,102,0,116,"2022","063"
"37870","MONTE ISOLA",16,0,0,16,"2022","111"
"37871","MONTE MARENZO",6,0,0,6,"2022","052"
"37872","MONTE SAN PIETRO",121,211,0,332,"2022","042"
"37873","MONTEBELLO DELLA BATTAGLIA",0,19,0,19,"2022","095"
"37874","MONTEBELLO VICENTINO",355,0,6,361,"2022","060"
"37875","MONTEBELLUNA",3190,427,1,3618,"2022","046"
"37876","MONTECALVO VERSIGGIA",2,0,0,2,"2022",NA
"37877","MONTECASTELLO",1,0,0,1,"2022","105"
"37878","MONTECCHIA DI CROSARA",614,3,0,617,"2022","049"
"37879","MONTECCHIO EMILIA",2,1773,0,1775,"2022","027"
"37880","MONTECCHIO MAGGIORE",189,48,0,237,"2022","061"
"37881","MONTECCHIO PRECALCINO",363,158,0,521,"2022","062"
"37882","MONTECHIARO D'ACQUI",49,0,0,49,"2022","106"
"37883","MONTECHIARO D'ASTI",330,0,0,330,"2022","075"
"37884","MONTECHIARUGOLO",27,3683,0,3710,"2022","023"
"37885","MONTECOPIOLO",515,50,16,581,"2022",NA
"37886","MONTECRESTESE",81,42,0,123,"2022","046"
"37887","MONTECRETO",8,606,0,614,"2022","024"
"37888","MONTEFIORE CONCA",36,1,0,37,"2022","008"
"37889","MONTEFIORINO",98,319,0,417,"2022","025"
"37890","MONTEFORTE D'ALPONE",789,4,0,793,"2022","050"
"37891","MONTEGALDA",30,267,0,297,"2022","064"
"37892","MONTEGALDELLA",13,361,1,375,"2022","065"
"37893","MONTEGIOCO",20,0,0,20,"2022","107"
"37894","MONTEGRIDOLFO",4,0,0,4,"2022","009"
"37895","MONTEGRINO VALTRAVAGLIA",7,0,0,7,"2022","103"
"37896","MONTEGROSSO D'ASTI",20,0,0,20,"2022","076"
"37897","MONTEGROTTO TERME",6,24,0,30,"2022","057"
"37898","MONTELUPO ALBESE",87,0,0,87,"2022","137"
"37899","MONTEMAGNO",77,0,0,77,"2022","077"
"37900","MONTEMALE DI CUNEO",193,0,0,193,"2022","138"
"37901","MONTERENZIO",544,174,0,718,"2022","041"
"37902","MONTEROSSO GRANA",5,136,0,141,"2022","139"
"37903","MONTESCUDO-MONTE COLOMBO",190,0,0,190,"2022",NA
"37904","MONTESE",128,1321,0,1449,"2022","026"
"37905","MONTESEGALE",13,0,0,13,"2022","098"
"37906","MONTEU DA PO",103,0,0,103,"2022","162"
"37907","MONTEU ROERO",454,0,0,454,"2022","140"
"37908","MONTEVECCHIA",2,0,0,2,"2022","053"
"37909","MONTEVIALE",48,0,0,48,"2022","066"
"37910","MONTEZEMOLO",63,0,0,63,"2022","141"
"37911","MONTICELLI BRUSATI",7,229,3,239,"2022","112"
"37912","MONTICELLI D'ONGINA",287,843,0,1130,"2022","027"
"37913","MONTICELLI PAVESE",1577,548,0,2125,"2022","099"
"37914","MONTICELLO BRIANZA",25,0,110,135,"2022","054"
"37915","MONTICELLO CONTE OTTO",171,766,33,970,"2022","067"
"37916","MONTICELLO D'ALBA",68,0,0,68,"2022","142"
"37917","MONTICHIARI",8524,7629,36,16189,"2022","113"
"37918","MONTIGLIO MONFERRATO",137,0,0,137,"2022","121"
"37919","MONTIRONE",3653,467,0,4120,"2022","114"
"37920","MONTODINE",81,1231,0,1312,"2022","059"
"37921","MONTORFANO",1,0,0,1,"2022","157"
"37922","MONTORSO VICENTINO",678,97,6,781,"2022","068"
"37923","MONTU' BECCARIA",1,0,0,1,"2022","100"
"37924","MONVALLE",14,0,0,14,"2022","104"
"37925","MONZA",30,40,0,70,"2022",NA
"37926","MONZAMBANO",1558,648,194,2400,"2022","036"
"37927","MONZUNO",51,43,0,94,"2022","044"
"37928","MORANO SUL PO",1,0,0,1,"2022","109"
"37929","MORANSENGO",180,0,0,180,"2022","079"
"37930","MORAZZONE",7,84,36,127,"2022","105"
"37931","MORBEGNO",13,64,3,80,"2022","045"
"37932","MORBELLO",2,0,0,2,"2022","110"
"37933","MORENGO",10,56,0,66,"2022","140"
"37934","MORETTA",1717,433,187,2337,"2022","143"
"37935","MORFASSO",188,1,0,189,"2022","028"
"37936","MORGANO",1816,3,0,1819,"2022","047"
"37937","MORIAGO DELLA BATTAGLIA",1627,60,0,1687,"2022","048"
"37938","MORIMONDO",40,1705,0,1745,"2022","150"
"37939","MORIONDO TORINESE",285,0,0,285,"2022","163"
"37940","MORNAGO",23,0,0,23,"2022","106"
"37941","MORNESE",30,0,0,30,"2022","111"
"37942","MORNICO AL SERIO",436,597,0,1033,"2022","141"
"37943","MORNICO LOSANA",14,0,0,14,"2022","101"
"37944","MOROZZO",2352,570,415,3337,"2022","144"
"37945","MORSASCO",123,0,0,123,"2022","112"
"37946","MORTARA",26,0,0,26,"2022","102"
"37947","MORTERONE",3,0,14,17,"2022","055"
"37948","MOSCAZZANO",0,1455,0,1455,"2022","060"
"37949","MOTTA BALUFFI",0,99,0,99,"2022","061"
"37950","MOTTA DI LIVENZA",18,20,0,38,"2022","049"
"37951","MOTTALCIATA",80,41,0,121,"2022","037"
"37952","MOTTEGGIANA",22,991,923,1936,"2022","037"
"37953","MOZZANICA",104,733,0,837,"2022","142"
"37954","MOZZATE",10,80,0,90,"2022","159"
"37955","MOZZECANE",3223,1492,0,4715,"2022","051"
"37956","MULAZZANO",6,812,0,818,"2022","041"
"37957","MURA",17,1,23,41,"2022","115"
"37958","MURAZZANO",293,0,24,317,"2022","145"
"37959","MURELLO",470,1179,192,1841,"2022","146"
"37960","MURISENGO",315,0,0,315,"2022","113"
"37961","MUSCOLINE",425,540,14,979,"2022","116"
"37962","MUSILE DI PIAVE",16,10,0,26,"2022","025"
"37963","MUSSO",2,0,6,8,"2022","160"
"37964","MUSSOLENTE",200,219,0,419,"2022","070"
"37965","MUZZANO",26,0,2,28,"2022","038"
"37966","NANTO",231,210,0,441,"2022","071"
"37967","NARZOLE",1828,140,0,1968,"2022","147"
"37968","NAVE",42,213,24,279,"2022","117"
"37969","NEBBIUNO",37,0,27,64,"2022","103"
"37970","NEGRAR DI VALPOLICELLA",7,75,0,82,"2022",NA
"37971","NEIVE",18,0,0,18,"2022","148"
"37972","NEMBRO",50,7,0,57,"2022","144"
"37973","NERVESA DELLA BATTAGLIA",498,175,19,692,"2022","050"
"37974","NERVIANO",7,154,14,175,"2022","154"
"37975","NESSO",0,7,0,7,"2022","161"
"37976","NETRO",101,29,4,134,"2022","039"
"37977","NEVIANO DEGLI ARDUINI",57,1897,0,1954,"2022","024"
"37978","NIARDO",9,129,19,157,"2022","118"
"37979","NIBIONNO",4,0,0,4,"2022","056"
"37980","NICHELINO",25,0,21,46,"2022","164"
"37981","NIELLA BELBO",105,0,0,105,"2022","150"
"37982","NIELLA TANARO",465,0,0,465,"2022","151"
"37983","NIZZA MONFERRATO",42,5,0,47,"2022","080"
"37984","NOALE",394,52,4,450,"2022","026"
"37985","NOASCA",3,0,35,38,"2022","165"
"37986","NOCETO",55,3770,0,3825,"2022","025"
"37987","NOGARA",2464,477,0,2941,"2022","053"
"37988","NOGAROLE ROCCA",257,378,0,635,"2022","054"
"37989","NOGAROLE VICENTINO",13,14,0,27,"2022","072"
"37990","NOLE",232,43,108,383,"2022","166"
"37991","NONANTOLA",12,131,0,143,"2022","027"
"37992","NONE",606,1340,259,2205,"2022","168"
"37993","NONIO",16,0,0,16,"2022",NA
"37994","NOSATE",13,0,0,13,"2022","155"
"37995","NOVA MILANESE",0,88,0,88,"2022",NA
"37996","NOVAFELTRIA",1041,245,0,1286,"2022","023"
"37997","NOVALESA",50,19,5,74,"2022","169"
"37998","NOVARA",40,291,0,331,"2022","106"
"37999","NOVATE MEZZOLA",3,0,28,31,"2022","046"
"38000","NOVE",24,228,0,252,"2022","073"
"38001","NOVEDRATE",682,0,0,682,"2022","163"
"38002","NOVELLARA",3123,2220,0,5343,"2022","028"
"38003","NOVELLO",916,0,0,916,"2022","152"
"38004","NOVENTA DI PIAVE",3,5,0,8,"2022","027"
"38005","NOVENTA PADOVANA",13,0,0,13,"2022","058"
"38006","NOVENTA VICENTINA",3692,0,0,3692,"2022","074"
"38007","NOVI DI MODENA",662,829,0,1491,"2022","028"
"38008","NOVI LIGURE",486,0,0,486,"2022","114"
"38009","NOVIGLIO",16,475,0,491,"2022","158"
"38010","NUVOLENTO",5,1170,0,1175,"2022","119"
"38011","NUVOLERA",1415,491,0,1906,"2022","120"
"38012","OCCHIEPPO INFERIORE",9,129,0,138,"2022","040"
"38013","OCCHIEPPO SUPERIORE",23,43,26,92,"2022","041"
"38014","OCCHIOBELLO",6,123,0,129,"2022","033"
"38015","OCCIMIANO",34,0,0,34,"2022","115"
"38016","ODALENGO GRANDE",72,0,0,72,"2022","116"
"38017","ODERZO",27,236,0,263,"2022","051"
"38018","ODOLO",6,0,2,8,"2022","121"
"38019","OFFANENGO",274,821,3,1098,"2022","062"
"38020","OFFLAGA",14,4214,0,4228,"2022","122"
"38021","OGGEBBIO",6,0,0,6,"2022","049"
"38022","OGGIONA CON SANTO STEFANO",0,25,0,25,"2022","107"
"38023","OGGIONO",49,0,19,68,"2022","057"
"38024","OGLIANICO",115,300,0,415,"2022","170"
"38025","OLEGGIO",227,1088,0,1315,"2022","108"
"38026","OLGIATE COMASCO",32,42,26,100,"2022","165"
"38027","OLGIATE MOLGORA",13,66,0,79,"2022","058"
"38028","OLGIATE OLONA",1,0,0,1,"2022","108"
"38029","OLGINATE",8,0,0,8,"2022","059"
"38030","OLIVA GESSI",0,3,0,3,"2022",NA
"38031","OLIVETO LARIO",10,0,1,11,"2022","060"
"38032","OLMENETA",10,548,0,558,"2022","063"
"38033","OLMO AL BREMBO",0,7,0,7,"2022","145"
"38034","OLMO GENTILE",34,0,11,45,"2022","081"
"38035","OLTRE IL COLLE",13,80,0,93,"2022","146"
"38036","OLTRESSENDA ALTA",2,47,0,49,"2022","147"
"38037","OLTRONA DI SAN MAMETTE",13,0,0,13,"2022","169"
"38038","OME",8,4,0,12,"2022","123"
"38039","OMEGNA",60,0,0,60,"2022","050"
"38040","ONCINO",0,0,129,129,"2022","154"
"38041","ONETA",9,33,0,42,"2022","148"
"38042","ONO SAN PIETRO",1,5,1,7,"2022","124"
"38043","ONORE",8,21,0,29,"2022","149"
"38044","OPERA",0,115,0,115,"2022","159"
"38045","OPPEANO",5762,655,0,6417,"2022","055"
"38046","ORBASSANO",519,0,7,526,"2022","171"
"38047","ORGIANO",354,18,0,372,"2022","075"
"38048","ORIGGIO",85,0,0,85,"2022","109"
"38049","ORIO LITTA",2,109,5,116,"2022","042"
"38050","ORMEA",100,0,35,135,"2022","155"
"38051","ORMELLE",26,16,0,42,"2022","052"
"38052","ORNAGO",1,55,0,56,"2022",NA
"38053","ORNAVASSO",24,0,0,24,"2022","051"
"38054","ORNICA",0,4,0,4,"2022","151"
"38055","ORSAGO",3,37,0,40,"2022","053"
"38056","ORSARA BORMIDA",10,0,0,10,"2022","119"
"38057","ORSENIGO",4,47,8,59,"2022","170"
"38058","ORTA SAN GIULIO",2,0,0,2,"2022","112"
"38059","ORZINUOVI",288,4957,24,5269,"2022","125"
"38060","ORZIVECCHI",3,860,0,863,"2022","126"
"38061","OSASCO",300,0,93,393,"2022","173"
"38062","OSASIO",272,106,127,505,"2022","174"
"38063","OSIO SOPRA",5,578,0,583,"2022","152"
"38064","OSIO SOTTO",2,0,0,2,"2022","153"
"38065","OSNAGO",204,88,0,292,"2022","061"
"38066","OSPEDALETTO EUGANEO",314,0,0,314,"2022","059"
"38067","OSPEDALETTO LODIGIANO",0,950,0,950,"2022","043"
"38068","OSPITALETTO",172,156,0,328,"2022","127"
"38069","OSSAGO LODIGIANO",38,1600,0,1638,"2022","044"
"38070","OSSIMO",1,7,5,13,"2022","128"
"38071","OSSONA",24,0,0,24,"2022","164"
"38072","OSTELLATO",5083,0,0,5083,"2022","017"
"38073","OSTIANO",18,1288,0,1306,"2022","064"
"38074","OSTIGLIA",16,47,12,75,"2022","038"
"38075","OTTIGLIO",104,0,0,104,"2022","120"
"38076","OTTOBIANO",0,27,0,27,"2022","106"
"38077","OTTONE",251,2,0,253,"2022","030"
"38078","OULX",61,0,0,61,"2022","175"
"38079","OVADA",14,0,0,14,"2022","121"
"38080","OVIGLIO",35,17,0,52,"2022","122"
"38081","OZEGNA",234,0,0,234,"2022","176"
"38082","OZZANO DELL'EMILIA",226,229,0,455,"2022","046"
"38083","OZZANO MONFERRATO",51,0,0,51,"2022","123"
"38084","OZZERO",0,46,50,96,"2022","165"
"38085","PADENGHE SUL GARDA",43,0,11,54,"2022","129"
"38086","PADERNO D'ADDA",0,18,0,18,"2022","062"
"38087","PADERNO DUGNANO",4,0,0,4,"2022","166"
"38088","PADERNO FRANCIACORTA",13,143,140,296,"2022","130"
"38089","PADERNO PONCHIELLI",137,2199,135,2471,"2022","065"
"38090","PADOVA",553,272,52,877,"2022","060"
"38091","PAESANA",765,10,0,775,"2022","157"
"38092","PAESE",2113,522,206,2841,"2022","055"
"38093","PAGNO",49,0,0,49,"2022","158"
"38094","PAGNONA",0,8,2,10,"2022","063"
"38095","PAISCO LOVENO",0,9,3,12,"2022","131"
"38096","PAITONE",16,17,1,34,"2022","132"
"38097","PALADINA",2,0,0,2,"2022","155"
"38098","PALAGANO",72,547,0,619,"2022","029"
"38099","PALANZANO",12,486,9,507,"2022","026"
"38100","PALAZZAGO",101,55,0,156,"2022","156"
"38101","PALAZZO CANAVESE",13,0,0,13,"2022","177"
"38102","PALAZZO PIGNANO",4,777,0,781,"2022","066"
"38103","PALAZZOLO SULL'OGLIO",1232,1336,81,2649,"2022","133"
"38104","PALAZZOLO VERCELLESE",13,0,0,13,"2022","090"
"38105","PALESTRO",2,0,27,29,"2022","107"
"38106","PALLANZENO",53,0,0,53,"2022","052"
"38107","PALOSCO",245,452,0,697,"2022","157"
"38108","PALU'",192,0,0,192,"2022","056"
"38109","PAMPARATO",54,0,0,54,"2022","159"
"38110","PANCALIERI",179,50,0,229,"2022","178"
"38111","PANDINO",11,3740,0,3751,"2022","067"
"38112","PANTIGLIATE",2,0,0,2,"2022","167"
"38113","PAPOZZE",2,64,0,66,"2022","034"
"38114","PARABIAGO",59,40,16,115,"2022","168"
"38115","PARATICO",3,45,0,48,"2022","134"
"38116","PARELLA",1,0,0,1,"2022",NA
"38117","PARETO",44,2,0,46,"2022","125"
"38118","PARMA",299,10097,0,10396,"2022","027"
"38119","PARODI LIGURE",54,0,46,100,"2022","126"
"38120","PAROLDO",22,0,6,28,"2022","160"
"38121","PARONA",3,0,0,3,"2022","109"
"38122","PARRE",16,70,0,86,"2022","158"
"38123","PARUZZARO",44,33,0,77,"2022","114"
"38124","PARZANICA",5,12,0,17,"2022","159"
"38125","PASPARDO",1,4,1,6,"2022","135"
"38126","PASSERANO MARMORITO",127,0,0,127,"2022","082"
"38127","PASSIRANO",31,161,0,192,"2022","136"
"38128","PASTRENGO",0,103,0,103,"2022","057"
"38129","PASTURO",42,119,31,192,"2022","065"
"38130","PAULLO",0,512,0,512,"2022","169"
"38131","PAVAROLO",38,0,0,38,"2022","180"
"38132","PAVIA",86,268,5,359,"2022","110"
"38133","PAVONE CANAVESE",141,0,0,141,"2022","181"
"38134","PAVONE DEL MELLA",1724,242,2,1968,"2022","137"
"38135","PAVULLO NEL FRIGNANO",213,3881,0,4094,"2022","030"
"38136","PECETTO DI VALENZA",8,0,0,8,"2022","128"
"38137","PECETTO TORINESE",71,0,0,71,"2022","183"
"38138","PEDAVENA",6,107,3,116,"2022","036"
"38139","PEDEMONTE",0,0,7,7,"2022","076"
"38140","PEDEROBBA",48,146,0,194,"2022","056"
"38141","PEDRENGO",29,241,0,270,"2022","160"
"38142","PEGLIO",2,8,4,14,"2022","178"
"38143","PEGOGNAGA",1053,2689,1915,5657,"2022","039"
"38144","PEIA",5,24,0,29,"2022","161"
"38145","PELLEGRINO PARMENSE",147,721,0,868,"2022","028"
"38146","PENANGO",58,0,0,58,"2022","083"
"38147","PENNABILLI",525,0,0,525,"2022","024"
"38148","PERLEDO",2,0,0,2,"2022","067"
"38149","PERLETTO",172,0,0,172,"2022","161"
"38150","PERLO",26,0,0,26,"2022","162"
"38151","PERNUMIA",121,146,0,267,"2022","061"
"38152","PEROSA ARGENTINA",59,11,2,72,"2022","184"
"38153","PEROSA CANAVESE",128,198,0,326,"2022","185"
"38154","PERRERO",33,0,0,33,"2022","186"
"38155","PERSICO DOSIMO",0,1701,105,1806,"2022","068"
"38156","PERTENGO",1,0,0,1,"2022","091"
"38157","PERTICA ALTA",10,15,6,31,"2022","139"
"38158","PERTICA BASSA",23,39,27,89,"2022","140"
"38159","PERTUSIO",67,0,0,67,"2022","187"
"38160","PESCANTINA",159,43,0,202,"2022","058"
"38161","PESCAROLO ED UNITI",35,833,0,868,"2022","069"
"38162","PESCHIERA BORROMEO",40,348,0,388,"2022","171"
"38163","PESSANO CON BORNAGO",51,158,0,209,"2022","172"
"38164","PESSINA CREMONESE",440,2913,131,3484,"2022","070"
"38165","PETTENASCO",6,0,0,6,"2022","116"
"38166","PETTINENGO",4,25,0,29,"2022","042"
"38167","PETTORAZZA GRIMANI",15,186,0,201,"2022","035"
"38168","PEVERAGNO",991,439,37,1467,"2022","163"
"38169","PEZZAZE",39,10,0,49,"2022","141"
"38170","PEZZOLO VALLE UZZONE",46,0,0,46,"2022","164"
"38171","PIACENZA",563,1688,0,2251,"2022","032"
"38172","PIACENZA D'ADIGE",594,0,0,594,"2022","062"
"38173","PIADENA DRIZZONA",71,818,74,963,"2022",NA
"38174","PIAN CAMUNO",0,278,1,279,"2022","142"
"38175","PIANCOGNO",0,91,2,93,"2022","206"
"38176","PIANELLO DEL LARIO",8,0,8,16,"2022","183"
"38177","PIANELLO VAL TIDONE",636,64,0,700,"2022","033"
"38178","PIANENGO",1,292,0,293,"2022","072"
"38179","PIANEZZA",214,367,156,737,"2022","189"
"38180","PIANEZZE",187,103,0,290,"2022","077"
"38181","PIANFEI",843,63,24,930,"2022","165"
"38182","PIANICO",14,76,0,90,"2022","162"
"38183","PIANIGA",36,5,0,41,"2022","028"
"38184","PIANORO",229,152,0,381,"2022","047"
"38185","PIANTEDO",6,245,1,252,"2022","048"
"38186","PIARIO",31,0,0,31,"2022","163"
"38187","PIASCO",251,279,62,592,"2022","166"
"38188","PIATEDA",35,70,0,105,"2022","049"
"38189","PIATTO",14,0,0,14,"2022","043"
"38190","PIAZZA BREMBANA",3,0,0,3,"2022","164"
"38191","PIAZZATORRE",4,2,0,6,"2022","165"
"38192","PIAZZOLA SUL BRENTA",2603,1041,0,3644,"2022","063"
"38193","PIEA",66,0,0,66,"2022","084"
"38194","PIEDIMULERA",0,24,0,24,"2022","053"
"38195","PIERANICA",83,42,0,125,"2022","073"
"38196","PIETRA DE' GIORGI",2,0,0,2,"2022","111"
"38197","PIEVE D'OLMI",0,2049,0,2049,"2022","074"
"38198","PIEVE DEL CAIRO",0,80,0,80,"2022","113"
"38199","PIEVE DEL GRAPPA",1189,776,18,1983,"2022",NA
"38200","PIEVE DI CADORE",0,18,0,18,"2022","039"
"38201","PIEVE DI SOLIGO",28,137,6,171,"2022","057"
"38202","PIEVE EMANUELE",0,329,180,509,"2022","173"
"38203","PIEVE FISSIRAGA",139,1223,0,1362,"2022","045"
"38204","PIEVE PORTO MORONE",117,0,0,117,"2022","114"
"38205","PIEVE SAN GIACOMO",0,1951,6,1957,"2022","075"
"38206","PIEVE VERGONTE",45,6,70,121,"2022","054"
"38207","PIEVEPELAGO",45,79,0,124,"2022","031"
"38208","PINAROLO PO",2115,0,0,2115,"2022","115"
"38209","PINASCA",93,0,46,139,"2022","190"
"38210","PINCARA",371,0,0,371,"2022","036"
"38211","PINEROLO",1776,144,157,2077,"2022","191"
"38212","PINO TORINESE",402,0,47,449,"2022","192"
"38213","PIOBESI TORINESE",537,1062,294,1893,"2022","193"
"38214","PIODE",0,6,0,6,"2022","097"
"38215","PIOLTELLO",1,0,0,1,"2022","175"
"38216","PIOMBINO DESE",4384,164,3,4551,"2022","064"
"38217","PIOSSASCO",550,1015,64,1629,"2022","194"
"38218","PIOVA' MASSAIA",252,0,0,252,"2022","086"
"38219","PIOVE DI SACCO",3697,145,0,3842,"2022","065"
"38220","PIOVENE ROCCHETTE",1432,104,0,1536,"2022","078"
"38221","PIOZZANO",330,0,0,330,"2022","034"
"38222","PIOZZO",341,0,0,341,"2022","169"
"38223","PISCINA",1560,0,0,1560,"2022","195"
"38224","PISOGNE",8,191,25,224,"2022","143"
"38225","PIUBEGA",5058,1162,142,6362,"2022","041"
"38226","PIURO",9,180,0,189,"2022","050"
"38227","PIVERONE",87,60,0,147,"2022","196"
"38228","PIZZIGHETTONE",80,2985,0,3065,"2022","076"
"38229","POCAPAGLIA",127,26,0,153,"2022","170"
"38230","PODENZANO",84,706,0,790,"2022","035"
"38231","POGGIO RENATICO",18,524,0,542,"2022","018"
"38232","POGGIO RUSCO",346,1062,10,1418,"2022","042"
"38233","POGGIO TORRIANA",403,0,0,403,"2022",NA
"38234","POGGIRIDENTI",6,0,0,6,"2022","051"
"38235","POGNANO",100,289,0,389,"2022","167"
"38236","POIRINO",3549,449,0,3998,"2022","197"
"38237","POJANA MAGGIORE",1271,31,0,1302,"2022","079"
"38238","POLAVENO",16,26,0,42,"2022","144"
"38239","POLESINE ZIBELLO",54,1559,0,1613,"2022",NA
"38240","POLINAGO",42,713,0,755,"2022","032"
"38241","POLLONE",195,48,0,243,"2022","046"
"38242","POLONGHERA",189,118,67,374,"2022","171"
"38243","POLPENAZZE DEL GARDA",9,95,0,104,"2022","145"
"38244","POLVERARA",6,19,0,25,"2022","066"
"38245","POMARETTO",41,0,14,55,"2022","198"
"38246","POMARO MONFERRATO",4,0,222,226,"2022","131"
"38247","POMBIA",4,17,0,21,"2022","121"
"38248","POMPIANO",10,1512,0,1522,"2022","146"
"38249","POMPONESCO",31,411,22,464,"2022","043"
"38250","PONCARALE",432,638,156,1226,"2022","147"
"38251","PONDERANO",56,32,40,128,"2022","047"
"38252","PONNA",2,1,4,7,"2022","187"
"38253","PONSO",5,0,0,5,"2022","067"
"38254","PONT-CANAVESE",41,44,0,85,"2022","199"
"38255","PONTE DELL'OLIO",249,114,0,363,"2022","036"
"38256","PONTE DI LEGNO",6,3,1,10,"2022","148"
"38257","PONTE DI PIAVE",53,32,1,86,"2022","058"
"38258","PONTE IN VALTELLINA",10,0,0,10,"2022","052"
"38259","PONTE LAMBRO",6,5,0,11,"2022","188"
"38260","PONTE NELLE ALPI",25,70,1,96,"2022","040"
"38261","PONTE NIZZA",124,39,0,163,"2022","117"
"38262","PONTE NOSSA",0,33,0,33,"2022","168"
"38263","PONTE SAN NICOLO'",13,49,0,62,"2022","069"
"38264","PONTE SAN PIETRO",7,0,0,7,"2022","170"
"38265","PONTECCHIO POLESINE",1763,0,0,1763,"2022","038"
"38266","PONTECHIANALE",202,0,0,202,"2022","172"
"38267","PONTECURONE",3,0,0,3,"2022","132"
"38268","PONTELONGO",399,0,2,401,"2022","068"
"38269","PONTENURE",52,156,0,208,"2022","037"
"38270","PONTERANICA",2,0,0,2,"2022","169"
"38271","PONTESTURA",14,0,0,14,"2022","133"
"38272","PONTEVICO",237,3633,360,4230,"2022","149"
"38273","PONTI",63,0,16,79,"2022","134"
"38274","PONTI SUL MINCIO",141,384,31,556,"2022","044"
"38275","PONTIDA",17,0,0,17,"2022","171"
"38276","PONTIROLO NUOVO",198,566,0,764,"2022","172"
"38277","PONTOGLIO",810,1483,0,2293,"2022","150"
"38278","PONZANO MONFERRATO",41,0,0,41,"2022","135"
"38279","PONZANO VENETO",325,178,0,503,"2022","059"
"38280","PONZONE",6,0,28,34,"2022","136"
"38281","PORLEZZA",2,29,17,48,"2022","189"
"38282","PORTACOMARO",59,0,0,59,"2022","087"
"38283","PORTE",5,0,0,5,"2022","200"
"38284","PORTICO E SAN BENEDETTO",137,0,0,137,"2022","031"
"38285","PORTO MANTOVANO",2016,900,1676,4592,"2022","045"
"38286","PORTO TOLLE",17,0,0,17,"2022","039"
"38287","PORTO VALTRAVAGLIA",9,0,15,24,"2022","114"
"38288","PORTO VIRO",4212,0,0,4212,"2022","052"
"38289","PORTOBUFFOLE'",1,0,2,3,"2022","060"
"38290","PORTOGRUARO",1024,63,0,1087,"2022","029"
"38291","PORTOMAGGIORE",1253,405,0,1658,"2022","019"
"38292","PORTULA",3,0,0,3,"2022","048"
"38293","POSINA",1,5,0,6,"2022","080"
"38294","POSSAGNO",10,10,0,20,"2022","061"
"38295","POSTALESIO",2,0,0,2,"2022","053"
"38296","POSTUA",2,0,0,2,"2022","102"
"38297","POVE DEL GRAPPA",19,0,0,19,"2022","081"
"38298","POVEGLIANO",170,164,3,337,"2022","062"
"38299","POVEGLIANO VERONESE",2367,493,0,2860,"2022","060"
"38300","POVIGLIO",7,1445,0,1452,"2022","029"
"38301","POZZAGLIO ED UNITI",35,2070,206,2311,"2022","077"
"38302","POZZO D'ADDA",213,0,0,213,"2022","177"
"38303","POZZOL GROPPO",38,0,0,38,"2022","137"
"38304","POZZOLENGO",600,430,17,1047,"2022","151"
"38305","POZZOLEONE",108,2253,20,2381,"2022","082"
"38306","POZZOLO FORMIGARO",256,0,0,256,"2022","138"
"38307","POZZONOVO",1848,0,0,1848,"2022","070"
"38308","POZZUOLO MARTESANA",2,229,14,245,"2022","178"
"38309","PRADALUNGA",17,0,0,17,"2022","173"
"38310","PRADLEVES",0,14,0,14,"2022","173"
"38311","PRAGELATO",9,0,1,10,"2022","201"
"38312","PRALBOINO",1011,770,6,1787,"2022","152"
"38313","PRALI",48,0,0,48,"2022","202"
"38314","PRALORMO",1100,423,0,1523,"2022","203"
"38315","PRALUNGO",77,0,24,101,"2022","049"
"38316","PRAMAGGIORE",9,3,0,12,"2022","030"
"38317","PRAMOLLO",5,0,0,5,"2022","204"
"38318","PRAROSTINO",36,8,0,44,"2022","205"
"38319","PRASCO",24,0,0,24,"2022","139"
"38320","PRATA CAMPORTACCIO",20,128,48,196,"2022","054"
"38321","PRATIGLIONE",2,0,0,2,"2022","207"
"38322","PRATO SESIA",1,11,0,12,"2022","122"
"38323","PRAY",71,0,0,71,"2022","050"
"38324","PRAZZO",211,31,47,289,"2022","174"
"38325","PREDAPPIO",457,2,0,459,"2022","032"
"38326","PREDORE",34,0,0,34,"2022","174"
"38327","PREDOSA",290,115,0,405,"2022","140"
"38328","PREGANZIOL",20,210,0,230,"2022","063"
"38329","PREGNANA MILANESE",3,107,0,110,"2022","179"
"38330","PREMANA",5,2,2,9,"2022","069"
"38331","PREMIA",33,192,1,226,"2022","056"
"38332","PREMILCUORE",598,0,11,609,"2022","033"
"38333","PREMOLO",9,10,0,19,"2022","175"
"38334","PREMOSELLO-CHIOVENDA",19,0,0,19,"2022","057"
"38335","PRESEGLIE",70,0,3,73,"2022","153"
"38336","PRESSANA",4330,0,26,4356,"2022","061"
"38337","PREVALLE",11,589,6,606,"2022","155"
"38338","PRIERO",28,0,0,28,"2022","175"
"38339","PRIGNANO SULLA SECCHIA",182,1398,0,1580,"2022","033"
"38340","PRIMALUNA",21,40,3,64,"2022","070"
"38341","PRIOCCA",707,0,0,707,"2022","176"
"38342","PRIOLA",84,0,0,84,"2022","177"
"38343","PROSERPIO",1,4,0,5,"2022","192"
"38344","PROVAGLIO D'ISEO",119,189,0,308,"2022","156"
"38345","PROVAGLIO VAL SABBIA",12,0,13,25,"2022","157"
"38346","PRUNETTO",74,0,0,74,"2022","178"
"38347","PUEGNAGO SUL GARDA",9,79,0,88,"2022","158"
"38348","PUMENENGO",2130,909,0,3039,"2022","177"
"38349","QUAREGNA CERRETO",121,0,0,121,"2022",NA
"38350","QUARGNENTO",602,0,0,602,"2022","141"
"38351","QUARNA SOPRA",4,0,0,4,"2022","058"
"38352","QUARNA SOTTO",13,0,0,13,"2022","059"
"38353","QUARONA",4,12,0,16,"2022","107"
"38354","QUARTO D'ALTINO",3,0,0,3,"2022","031"
"38355","QUASSOLO",32,11,9,52,"2022","209"
"38356","QUATTORDIO",271,0,0,271,"2022","142"
"38357","QUATTRO CASTELLA",5,1393,0,1398,"2022","030"
"38358","QUERO VAS",5,83,4,92,"2022",NA
"38359","QUINCINETTO",36,35,0,71,"2022","210"
"38360","QUINGENTOLE",695,56,64,815,"2022","046"
"38361","QUINTANO",11,382,0,393,"2022","078"
"38362","QUINTO DI TREVISO",120,170,10,300,"2022","064"
"38363","QUINTO VERCELLESE",3,0,0,3,"2022","108"
"38364","QUINTO VICENTINO",20,537,0,557,"2022","083"
"38365","QUINZANO D'OGLIO",154,3051,0,3205,"2022","159"
"38366","QUISTELLO",95,1588,418,2101,"2022","047"
"38367","RACCONIGI",1885,1971,189,4045,"2022","179"
"38368","RANCIO VALCUVIA",4,0,0,4,"2022","115"
"38369","RANCO",0,0,23,23,"2022","116"
"38370","RANICA",23,8,0,31,"2022","178"
"38371","RANZANICO",4,23,0,27,"2022","179"
"38372","RASURA",0,8,0,8,"2022","055"
"38373","RAVENNA",1067,1411,0,2478,"2022","014"
"38374","RE",26,0,0,26,"2022","060"
"38375","REANO",15,0,3,18,"2022","211"
"38376","RECOARO TERME",56,97,0,153,"2022","084"
"38377","REDAVALLE",72,0,0,72,"2022","120"
"38378","REDONDESCO",248,810,854,1912,"2022","048"
"38379","REFRANCORE",18,0,0,18,"2022","089"
"38380","REFRONTOLO",10,25,2,37,"2022","065"
"38381","REGGIO NELL'EMILIA",140,10638,0,10778,"2022","033"
"38382","REGGIOLO",628,2538,0,3166,"2022","032"
"38383","REMEDELLO",7479,2572,242,10293,"2022","160"
"38384","RENATE",1,0,2,3,"2022",NA
"38385","RESANA",2734,38,10,2782,"2022","066"
"38386","REVELLO",7021,1884,206,9111,"2022","180"
"38387","REVIGLIASCO D'ASTI",238,0,0,238,"2022","090"
"38388","REVINE LAGO",16,0,0,16,"2022","067"
"38389","REZZATO",258,622,0,880,"2022","161"
"38390","RHO",19,504,0,523,"2022","182"
"38391","RIBORDONE",9,0,0,9,"2022","212"
"38392","RICENGO",20,3333,0,3353,"2022","079"
"38393","RIESE PIO X",7370,407,7,7784,"2022","068"
"38394","RIFREDDO",695,6,43,744,"2022","181"
"38395","RIMELLA",7,6,0,13,"2022","113"
"38396","RIMINI",86,100,0,186,"2022","014"
"38397","RIO SALICETO",931,429,0,1360,"2022","034"
"38398","RIOLO TERME",373,0,0,373,"2022","015"
"38399","RIOLUNATO",59,16,0,75,"2022","035"
"38400","RIPALTA ARPINA",0,474,0,474,"2022","080"
"38401","RIPALTA CREMASCA",2,412,0,414,"2022","081"
"38402","RIPALTA GUERINA",3,559,0,562,"2022","082"
"38403","RIVA DEL PO",1760,98,0,1858,"2022",NA
"38404","RIVA DI SOLTO",2,0,0,2,"2022","180"
"38405","RIVA PRESSO CHIERI",3026,147,161,3334,"2022","215"
"38406","RIVALBA",67,0,0,67,"2022","213"
"38407","RIVALTA DI TORINO",103,0,0,103,"2022","214"
"38408","RIVAMONTE AGORDINO",0,10,0,10,"2022","043"
"38409","RIVANAZZANO",54,0,0,54,"2022","122"
"38410","RIVARA",154,129,3,286,"2022","216"
"38411","RIVAROLO CANAVESE",1038,240,672,1950,"2022","217"
"38412","RIVAROLO DEL RE ED UNITI",3551,329,0,3880,"2022","083"
"38413","RIVAROLO MANTOVANO",44,1280,183,1507,"2022","050"
"38414","RIVAROSSA",3,167,0,170,"2022","218"
"38415","RIVERGARO",129,1108,0,1237,"2022","038"
"38416","RIVOLI",1259,0,27,1286,"2022","219"
"38417","RIVOLI VERONESE",185,3,0,188,"2022","062"
"38418","RIVOLTA D'ADDA",1971,2446,146,4563,"2022","084"
"38419","ROANA",18,372,4,394,"2022","085"
"38420","ROASCIO",3,0,0,3,"2022","184"
"38421","ROASIO",5,0,0,5,"2022","116"
"38422","ROATTO",142,0,0,142,"2022","091"
"38423","ROBASSOMERO",48,109,17,174,"2022","220"
"38424","ROBBIO",2,166,0,168,"2022","123"
"38425","ROBECCHETTO CON INDUNO",216,238,0,454,"2022","183"
"38426","ROBECCO D'OGLIO",0,3090,0,3090,"2022","085"
"38427","ROBECCO PAVESE",6,0,0,6,"2022","124"
"38428","ROBECCO SUL NAVIGLIO",115,706,65,886,"2022","184"
"38429","ROBELLA",397,0,0,397,"2022","092"
"38430","ROBILANTE",260,0,0,260,"2022","185"
"38431","ROBURENT",21,0,0,21,"2022","186"
"38432","ROCCA CANAVESE",109,0,0,109,"2022","221"
"38433","ROCCA CIGLIE'",11,0,0,11,"2022","188"
"38434","ROCCA D'ARAZZO",181,0,0,181,"2022","093"
"38435","ROCCA DE' BALDI",2924,935,798,4657,"2022","189"
"38436","ROCCA GRIMALDA",4,0,0,4,"2022","147"
"38437","ROCCA PIETORE",0,13,0,13,"2022","044"
"38438","ROCCA SAN CASCIANO",173,1,0,174,"2022","036"
"38439","ROCCA SUSELLA",2,0,0,2,"2022",NA
"38440","ROCCABIANCA",0,1228,0,1228,"2022","030"
"38441","ROCCABRUNA",94,43,61,198,"2022","187"
"38442","ROCCAFORTE LIGURE",58,0,0,58,"2022","146"
"38443","ROCCAFORTE MONDOVI'",1156,0,13,1169,"2022","190"
"38444","ROCCAFRANCA",848,1715,11,2574,"2022","162"
"38445","ROCCASPARVERA",481,0,0,481,"2022","191"
"38446","ROCCAVERANO",66,0,0,66,"2022","094"
"38447","ROCCAVIONE",31,0,0,31,"2022","192"
"38448","ROCCHETTA LIGURE",35,0,0,35,"2022","148"
"38449","ROCCHETTA PALAFEA",6,0,0,6,"2022","095"
"38450","ROCCHETTA TANARO",456,0,0,456,"2022","096"
"38451","RODANO",15,47,0,62,"2022","185"
"38452","RODDI",71,0,0,71,"2022","194"
"38453","RODDINO",63,0,0,63,"2022","195"
"38454","RODELLO",100,0,0,100,"2022","196"
"38455","RODENGO-SAIANO",16,236,148,400,"2022","163"
"38456","RODERO",4,5,0,9,"2022",NA
"38457","RODIGO",895,1392,1177,3464,"2022","051"
"38458","ROE' VOLCIANO",5,0,0,5,"2022","164"
"38459","ROGENO",18,316,16,350,"2022","072"
"38460","ROGNANO",8,0,0,8,"2022","127"
"38461","ROGNO",13,73,0,86,"2022","182"
"38462","ROGOLO",0,17,0,17,"2022","056"
"38463","ROLETTO",98,92,0,190,"2022","222"
"38464","ROLO",67,256,0,323,"2022","035"
"38465","ROMAGNANO SESIA",2,0,0,2,"2022","130"
"38466","ROMAGNESE",114,0,0,114,"2022","128"
"38467","ROMANENGO",0,2190,0,2190,"2022","086"
"38468","ROMANO CANAVESE",30,0,0,30,"2022","223"
"38469","ROMANO D'EZZELINO",178,568,0,746,"2022","086"
"38470","ROMANO DI LOMBARDIA",65,3461,0,3526,"2022","183"
"38471","ROMENTINO",16,0,0,16,"2022","131"
"38472","RONAGO",7,27,0,34,"2022","199"
"38473","RONCA'",1,0,0,1,"2022","063"
"38474","RONCADE",2068,65,0,2133,"2022","069"
"38475","RONCADELLE",218,843,0,1061,"2022","165"
"38476","RONCELLO",1,0,0,1,"2022",NA
"38477","RONCO ALL'ADIGE",5391,0,0,5391,"2022","064"
"38478","RONCO BIELLESE",25,33,0,58,"2022","053"
"38479","RONCO BRIANTINO",0,145,0,145,"2022",NA
"38480","RONCOBELLO",2,0,0,2,"2022",NA
"38481","RONCOFERRARO",3193,769,315,4277,"2022","052"
"38482","RONCOFREDDO",24,28,0,52,"2022","037"
"38483","RONCOLA",17,46,0,63,"2022","185"
"38484","RONSECCO",4,0,0,4,"2022",NA
"38485","ROPPOLO",7,0,0,7,"2022","054"
"38486","RORA'",27,0,0,27,"2022","226"
"38487","ROSA'",51,807,3,861,"2022","087"
"38488","ROSATE",3600,480,0,4080,"2022","188"
"38489","ROSIGNANO MONFERRATO",61,0,0,61,"2022","149"
"38490","ROSOLINA",5,0,0,5,"2022","040"
"38491","ROSSA",5,19,0,24,"2022","121"
"38492","ROSSANA",107,64,0,171,"2022","197"
"38493","ROSSANO VENETO",330,225,14,569,"2022","088"
"38494","ROSTA",29,0,60,89,"2022","228"
"38495","ROTA D'IMAGNA",3,64,0,67,"2022","186"
"38496","ROTTOFRENO",913,519,0,1432,"2022","039"
"38497","ROTZO",119,0,6,125,"2022","089"
"38498","ROURE",4,0,0,4,"2022","227"
"38499","ROVASENDA",4,0,0,4,"2022","122"
"38500","ROVATO",1781,2292,34,4107,"2022","166"
"38501","ROVELLASCA",1,66,0,67,"2022","201"
"38502","ROVERBELLA",12689,949,110,13748,"2022","053"
"38503","ROVERCHIARA",4657,0,53,4710,"2022","065"
"38504","ROVERE' VERONESE",227,1130,0,1357,"2022","067"
"38505","ROVEREDO DI GUA'",1544,32,30,1606,"2022","066"
"38506","ROVESCALA",16,0,0,16,"2022","131"
"38507","ROVETTA",36,104,0,140,"2022","187"
"38508","ROVIGO",1571,1,0,1572,"2022","041"
"38509","ROVOLON",146,19,26,191,"2022","071"
"38510","RUBANO",69,16,0,85,"2022","072"
"38511","RUBIANA",5,0,1,6,"2022","229"
"38512","RUBIERA",10,453,0,463,"2022","036"
"38513","RUDIANO",273,1209,0,1482,"2022","167"
"38514","RUEGLIO",81,0,4,85,"2022","230"
"38515","RUFFIA",603,182,61,846,"2022","198"
"38516","RUSSI",8,0,0,8,"2022","016"
"38517","SABBIO CHIESE",12,73,16,101,"2022","168"
"38518","SABBIONETA",3,22,0,25,"2022","054"
"38519","SACCOLONGO",49,512,4,565,"2022","073"
"38520","SAGLIANO MICCA",106,0,0,106,"2022","056"
"38521","SALA BAGANZA",5,106,20,131,"2022","031"
"38522","SALA BIELLESE",10,0,0,10,"2022","057"
"38523","SALA BOLOGNESE",343,0,0,343,"2022","050"
"38524","SALA COMACINA",1,0,0,1,"2022","203"
"38525","SALA MONFERRATO",85,0,0,85,"2022","150"
"38526","SALARA",3,0,0,3,"2022","042"
"38527","SALASSA",20,0,0,20,"2022","231"
"38528","SALBERTRAND",2,0,68,70,"2022","232"
"38529","SALCEDO",1005,68,0,1073,"2022","090"
"38530","SALE",110,0,0,110,"2022","151"
"38531","SALE DELLE LANGHE",166,0,0,166,"2022","199"
"38532","SALE MARASINO",24,1,22,47,"2022","169"
"38533","SALE SAN GIOVANNI",62,0,0,62,"2022","200"
"38534","SALERANO CANAVESE",2,0,0,2,"2022",NA
"38535","SALERANO SUL LAMBRO",2,228,0,230,"2022","046"
"38536","SALGAREDA",1598,151,0,1749,"2022","070"
"38537","SALICETO",57,0,0,57,"2022","201"
"38538","SALIZZOLE",2491,386,55,2932,"2022","068"
"38539","SALMOUR",244,0,0,244,"2022","202"
"38540","SALO'",0,35,0,35,"2022","170"
"38541","SALSOMAGGIORE TERME",29,965,0,994,"2022","032"
"38542","SALTRIO",2,29,0,31,"2022","117"
"38543","SALUDECIO",76,0,0,76,"2022","015"
"38544","SALUGGIA",504,172,0,676,"2022","128"
"38545","SALUSSOLA",618,9,0,627,"2022","058"
"38546","SALUZZO",3373,3465,480,7318,"2022","203"
"38547","SALVIROLA",700,30,0,730,"2022","087"
"38548","SALZANO",346,24,0,370,"2022","032"
"38549","SAMARATE",16,0,0,16,"2022","118"
"38550","SAMBUCO",52,0,0,52,"2022","204"
"38551","SAMOLACO",136,871,38,1045,"2022","057"
"38552","SAMPEYRE",267,105,0,372,"2022","205"
"38553","SAN BARTOLOMEO VAL CAVARGNA",1,0,0,1,"2022","204"
"38554","SAN BASSANO",2,1875,0,1877,"2022","088"
"38555","SAN BELLINO",1252,0,0,1252,"2022","043"
"38556","SAN BENEDETTO BELBO",33,0,0,33,"2022","206"
"38557","SAN BENEDETTO PO",1013,2429,392,3834,"2022","055"
"38558","SAN BENEDETTO VAL DI SAMBRO",445,94,0,539,"2022","051"
"38559","SAN BENIGNO CANAVESE",191,0,1,192,"2022","236"
"38560","SAN BERNARDINO VERBANO",4,0,0,4,"2022","061"
"38561","SAN BIAGIO DI CALLALTA",768,0,0,768,"2022","071"
"38562","SAN BONIFACIO",2077,0,0,2077,"2022","069"
"38563","SAN CARLO CANAVESE",186,144,139,469,"2022","237"
"38564","SAN CESARIO SUL PANARO",24,948,0,972,"2022","036"
"38565","SAN CIPRIANO PO",0,278,0,278,"2022","133"
"38566","SAN CLEMENTE",7,0,0,7,"2022","016"
"38567","SAN COLOMBANO AL LAMBRO",22,343,0,365,"2022","191"
"38568","SAN COLOMBANO BELMONTE",4,12,0,16,"2022","238"
"38569","SAN DAMIANO D'ASTI",3770,0,0,3770,"2022","097"
"38570","SAN DAMIANO MACRA",43,0,0,43,"2022","207"
"38571","SAN DANIELE PO",14,1577,0,1591,"2022","089"
"38572","SAN DIDERO",0,2,0,2,"2022","239"
"38573","SAN DONA' DI PIAVE",250,301,0,551,"2022","033"
"38574","SAN DONATO MILANESE",0,0,4,4,"2022","192"
"38575","SAN FELICE DEL BENACO",11,0,0,11,"2022","171"
"38576","SAN FELICE SUL PANARO",0,868,0,868,"2022","037"
"38577","SAN FERMO DELLA BATTAGLIA",42,0,5,47,"2022","206"
"38578","SAN FIOR",26,16,4,46,"2022","072"
"38579","SAN FIORANO",0,191,0,191,"2022","047"
"38580","SAN FRANCESCO AL CAMPO",605,348,0,953,"2022","240"
"38581","SAN GENESIO ED UNITI",2,645,0,647,"2022","135"
"38582","SAN GERMANO CHISONE",97,11,0,108,"2022","242"
"38583","SAN GERMANO VERCELLESE",5,0,0,5,"2022","131"
"38584","SAN GERVASIO BRESCIANO",1,278,0,279,"2022","172"
"38585","SAN GIACOMO DELLE SEGNATE",309,281,105,695,"2022","056"
"38586","SAN GIACOMO VERCELLESE",1850,0,0,1850,"2022","035"
"38587","SAN GILLIO",99,80,0,179,"2022","243"
"38588","SAN GIORGIO BIGARELLO",1449,362,268,2079,"2022",NA
"38589","SAN GIORGIO CANAVESE",377,20,0,397,"2022","244"
"38590","SAN GIORGIO DELLE PERTICHE",229,81,0,310,"2022","075"
"38591","SAN GIORGIO DI PIANO",36,0,0,36,"2022","052"
"38592","SAN GIORGIO IN BOSCO",200,630,5,835,"2022","076"
"38593","SAN GIORGIO MONFERRATO",17,0,0,17,"2022","153"
"38594","SAN GIORGIO PIACENTINO",768,767,0,1535,"2022","040"
"38595","SAN GIORGIO SCARAMPI",73,0,0,73,"2022","098"
"38596","SAN GIORIO DI SUSA",0,35,5,40,"2022","245"
"38597","SAN GIOVANNI BIANCO",37,18,0,55,"2022","188"
"38598","SAN GIOVANNI DEL DOSSO",0,246,104,350,"2022","058"
"38599","SAN GIOVANNI ILARIONE",835,0,0,835,"2022","070"
"38600","SAN GIOVANNI IN CROCE",0,467,1,468,"2022","090"
"38601","SAN GIOVANNI IN MARIGNANO",8,0,0,8,"2022","017"
"38602","SAN GIOVANNI IN PERSICETO",20,769,0,789,"2022","053"
"38603","SAN GIOVANNI LUPATOTO",707,68,0,775,"2022","071"
"38604","SAN GIULIANO MILANESE",26,546,110,682,"2022","195"
"38605","SAN GIUSTO CANAVESE",101,32,19,152,"2022","246"
"38606","SAN GREGORIO NELLE ALPI",1,69,1,71,"2022","045"
"38607","SAN LAZZARO DI SAVENA",8,0,0,8,"2022","054"
"38608","SAN LEO",451,126,0,577,"2022","025"
"38609","SAN MARTINO ALFIERI",6,0,0,6,"2022","099"
"38610","SAN MARTINO BUON ALBERGO",185,952,0,1137,"2022","073"
"38611","SAN MARTINO CANAVESE",57,0,0,57,"2022","247"
"38612","SAN MARTINO DALL'ARGINE",0,1239,375,1614,"2022","059"
"38613","SAN MARTINO DEL LAGO",8,0,0,8,"2022","091"
"38614","SAN MARTINO DI LUPARI",3305,349,0,3654,"2022","077"
"38615","SAN MARTINO IN RIO",0,1089,0,1089,"2022","037"
"38616","SAN MARTINO IN STRADA",0,899,2,901,"2022","048"
"38617","SAN MARTINO SICCOMARIO",17,0,0,17,"2022","137"
"38618","SAN MARZANO OLIVETO",33,0,0,33,"2022","100"
"38619","SAN MAURIZIO CANAVESE",80,281,195,556,"2022","248"
"38620","SAN MAURIZIO D'OPAGLIO",7,0,0,7,"2022","133"
"38621","SAN MAURO DI SALINE",83,334,4,421,"2022","074"
"38622","SAN MAURO TORINESE",3,0,0,3,"2022","249"
"38623","SAN MICHELE AL TAGLIAMENTO",2398,32,0,2430,"2022","034"
"38624","SAN MICHELE MONDOVI'",171,0,0,171,"2022","210"
"38625","SAN NAZZARO SESIA",115,0,0,115,"2022","134"
"38626","SAN NAZZARO VAL CAVARGNA",5,0,5,10,"2022","207"
"38627","SAN NICOLO' DI COMELICO",0,18,0,18,"2022","046"
"38628","SAN PAOLO",393,2979,19,3391,"2022","138"
"38629","SAN PAOLO D'ARGON",28,0,0,28,"2022","189"
"38630","SAN PAOLO SOLBRITO",18,0,0,18,"2022","101"
"38631","SAN PELLEGRINO TERME",53,17,0,70,"2022","190"
"38632","SAN PIETRO DI CADORE",0,67,2,69,"2022","047"
"38633","SAN PIETRO DI FELETTO",27,12,10,49,"2022","073"
"38634","SAN PIETRO IN CASALE",2,438,0,440,"2022","055"
"38635","SAN PIETRO IN CERRO",90,964,0,1054,"2022","041"
"38636","SAN PIETRO IN GU",593,2953,0,3546,"2022","078"
"38637","SAN PIETRO MOSEZZO",1,0,0,1,"2022","135"
"38638","SAN PIETRO MUSSOLINO",15,0,0,15,"2022","094"
"38639","SAN PIETRO VAL LEMINA",7,0,0,7,"2022","250"
"38640","SAN PIETRO VIMINARIO",9,31,0,40,"2022","079"
"38641","SAN POLO D'ENZA",5,618,0,623,"2022","038"
"38642","SAN POLO DI PIAVE",965,53,0,1018,"2022","074"
"38643","SAN PONSO",2,42,0,44,"2022","251"
"38644","SAN POSSIDONIO",0,477,0,477,"2022","038"
"38645","SAN PROSPERO",0,382,0,382,"2022","039"
"38646","SAN RAFFAELE CIMENA",38,0,0,38,"2022","252"
"38647","SAN ROCCO AL PORTO",143,630,11,784,"2022","049"
"38648","SAN SALVATORE MONFERRATO",197,0,0,197,"2022","154"
"38649","SAN SEBASTIANO CURONE",11,0,0,11,"2022","155"
"38650","SAN SEBASTIANO DA PO",245,0,0,245,"2022","253"
"38651","SAN SECONDO DI PINEROLO",505,39,7,551,"2022","254"
"38652","SAN SECONDO PARMENSE",2,1468,0,1470,"2022","033"
"38653","SAN SIRO",1,0,7,8,"2022","248"
"38654","SAN VENDEMIANO",59,107,0,166,"2022","076"
"38655","SAN VITO DI CADORE",2,0,0,2,"2022","051"
"38656","SAN VITO DI LEGUZZANO",423,140,0,563,"2022","096"
"38657","SAN VITTORE OLONA",36,24,0,60,"2022","201"
"38658","SAN ZENO DI MONTAGNA",170,134,29,333,"2022","079"
"38659","SAN ZENO NAVIGLIO",0,583,0,583,"2022","173"
"38660","SAN ZENONE AL LAMBRO",0,989,0,989,"2022","202"
"38661","SAN ZENONE DEGLI EZZELINI",2035,429,1,2465,"2022","077"
"38662","SANDIGLIANO",78,93,14,185,"2022","059"
"38663","SANDRIGO",1139,1742,91,2972,"2022","091"
"38664","SANFRE'",643,0,0,643,"2022","208"
"38665","SANFRONT",2103,210,33,2346,"2022","209"
"38666","SANGANO",47,0,18,65,"2022","241"
"38667","SANGIANO",4,45,0,49,"2022","141"
"38668","SANGUINETTO",5,209,0,214,"2022","072"
"38669","SANNAZZARO DE' BURGONDI",2,34,0,36,"2022","138"
"38670","SANT'AGATA BOLOGNESE",5,634,0,639,"2022","056"
"38671","SANT'AGATA FELTRIA",511,25,0,536,"2022","026"
"38672","SANT'AGATA FOSSILI",37,0,0,37,"2022","156"
"38673","SANT'AGATA SUL SANTERNO",42,0,0,42,"2022","017"
"38674","SANT'ALBANO STURA",4390,964,181,5535,"2022","211"
"38675","SANT'ALESSIO CON VIALONE",0,5,0,5,"2022","141"
"38676","SANT'AMBROGIO DI TORINO",60,19,0,79,"2022","255"
"38677","SANT'AMBROGIO DI VALPOLICELLA",0,51,0,51,"2022","077"
"38678","SANT'ANGELO DI PIOVE DI SACCO",319,63,0,382,"2022","082"
"38679","SANT'ANGELO LODIGIANO",21,411,0,432,"2022","050"
"38680","SANT'ANGELO LOMELLINA",0,540,0,540,"2022","144"
"38681","SANT'ANNA D'ALFAEDO",159,1326,134,1619,"2022","078"
"38682","SANT'ANTONINO DI SUSA",7,64,21,92,"2022","256"
"38683","SANT'ELENA",56,0,0,56,"2022","083"
"38684","SANT'ILARIO D'ENZA",3,717,0,720,"2022","039"
"38685","SANT'OMOBONO TERME",99,69,0,168,"2022","192"
"38686","SANT'URBANO",449,0,0,449,"2022","084"
"38687","SANTA BRIGIDA",7,14,0,21,"2022","191"
"38688","SANTA CRISTINA E BISSONE",12,360,0,372,"2022","139"
"38689","SANTA GIULETTA",9,0,0,9,"2022","140"
"38690","SANTA GIUSTINA",129,115,782,1026,"2022","048"
"38691","SANTA GIUSTINA IN COLLE",1518,379,1,1898,"2022","080"
"38692","SANTA LUCIA DI PIAVE",28,45,5,78,"2022","075"
"38693","SANTA MARGHERITA DI STAFFORA",23,0,24,47,"2022","142"
"38694","SANTA MARIA DELLA VERSA",2,0,0,2,"2022","143"
"38695","SANTA MARIA DI SALA",83,113,11,207,"2022","035"
"38696","SANTA MARIA HOE'",5,0,0,5,"2022","074"
"38697","SANTA MARIA MAGGIORE",21,12,37,70,"2022","062"
"38698","SANTA SOFIA",617,0,6,623,"2022","043"
"38699","SANTA VITTORIA D'ALBA",47,0,0,47,"2022","212"
"38700","SANTARCANGELO DI ROMAGNA",24,0,0,24,"2022","018"
"38701","SANTENA",326,0,0,326,"2022","257"
"38702","SANTHIA'",330,34,0,364,"2022","133"
"38703","SANTO STEFANO BELBO",9,0,0,9,"2022","213"
"38704","SANTO STEFANO DI CADORE",0,23,7,30,"2022","050"
"38705","SANTO STEFANO LODIGIANO",133,319,10,462,"2022","051"
"38706","SANTO STEFANO ROERO",73,0,0,73,"2022","214"
"38707","SANTO STEFANO TICINO",0,27,0,27,"2022","200"
"38708","SANTO STINO DI LIVENZA",3733,100,2,3835,"2022","036"
"38709","SANTORSO",25,137,0,162,"2022","095"
"38710","SAONARA",280,0,1,281,"2022","085"
"38711","SARCEDO",1088,327,0,1415,"2022","097"
"38712","SAREGO",490,21,0,511,"2022","098"
"38713","SAREZZO",9,37,0,46,"2022","174"
"38714","SARMATO",0,305,0,305,"2022","042"
"38715","SARMEDE",57,16,0,73,"2022","078"
"38716","SARNICO",5,0,0,5,"2022","193"
"38717","SARONNO",12,0,0,12,"2022","119"
"38718","SARSINA",334,7,0,341,"2022","044"
"38719","SASSO MARCONI",158,72,0,230,"2022","057"
"38720","SASSOFELTRIO",55,32,0,87,"2022",NA
"38721","SASSUOLO",79,467,0,546,"2022","040"
"38722","SAUZE D'OULX",8,0,0,8,"2022","259"
"38723","SAUZE DI CESANA",50,0,0,50,"2022","258"
"38724","SAVIGLIANO",11182,4914,234,16330,"2022","215"
"38725","SAVIGNANO SUL PANARO",58,53,0,111,"2022","041"
"38726","SAVIGNANO SUL RUBICONE",56,0,0,56,"2022","045"
"38727","SAVIORE DELL'ADAMELLO",5,18,5,28,"2022","175"
"38728","SCAGNELLO",153,0,66,219,"2022","216"
"38729","SCALDASOLE",0,5,0,5,"2022","147"
"38730","SCALENGHE",1856,2337,219,4412,"2022","260"
"38731","SCANDIANO",29,1350,0,1379,"2022","040"
"38732","SCANDOLARA RAVARA",0,908,0,908,"2022","092"
"38733","SCANDOLARA RIPA D'OGLIO",22,844,236,1102,"2022","093"
"38734","SCANZOROSCIATE",31,0,0,31,"2022","194"
"38735","SCARMAGNO",3,19,0,22,"2022","261"
"38736","SCARNAFIGI",1323,1628,50,3001,"2022","217"
"38737","SCHIAVON",2051,1705,0,3756,"2022","099"
"38738","SCHIGNANO",12,22,4,38,"2022","211"
"38739","SCHILPARIO",11,43,0,54,"2022","195"
"38740","SCHIO",441,237,0,678,"2022","100"
"38741","SCIOLZE",132,0,0,132,"2022","262"
"38742","SCOPELLO",23,6,0,29,"2022","135"
"38743","SCORZE'",3639,40,0,3679,"2022","037"
"38744","SECUGNAGO",0,1457,0,1457,"2022","052"
"38745","SEDICO",1689,114,0,1803,"2022","053"
"38746","SEDRIANO",7,808,0,815,"2022","204"
"38747","SEDRINA",23,18,0,41,"2022","196"
"38748","SEGRATE",16,0,0,16,"2022","205"
"38749","SEGUSINO",18,61,2,81,"2022","079"
"38750","SELLERO",8,27,4,39,"2022","176"
"38751","SELVA DI CADORE",0,3,0,3,"2022","054"
"38752","SELVA DI PROGNO",57,410,67,534,"2022","080"
"38753","SELVAZZANO DENTRO",14,0,16,30,"2022","086"
"38754","SELVINO",1,0,0,1,"2022","197"
"38755","SENAGO",2,0,0,2,"2022",NA
"38756","SENIGA",1765,1982,0,3747,"2022","177"
"38757","SENNA COMASCO",2,0,40,42,"2022","212"
"38758","SENNA LODIGIANA",0,917,0,917,"2022","053"
"38759","SEREGNO",5,0,0,5,"2022",NA
"38760","SEREN DEL GRAPPA",79,39,199,317,"2022","055"
"38761","SERGNANO",15,1626,12,1653,"2022","094"
"38762","SERIATE",90,71,0,161,"2022","198"
"38763","SERINA",17,100,0,117,"2022","199"
"38764","SERLE",21,46,18,85,"2022","178"
"38765","SERMIDE E FELONICA",0,340,0,340,"2022",NA
"38766","SERNAGLIA DELLA BATTAGLIA",871,0,2,873,"2022","080"
"38767","SERNIO",3,0,0,3,"2022","059"
"38768","SEROLE",60,0,4,64,"2022","104"
"38769","SERRALUNGA D'ALBA",16,0,0,16,"2022","218"
"38770","SERRALUNGA DI CREA",12,0,0,12,"2022","159"
"38771","SERRAMAZZONI",30,1585,0,1615,"2022","042"
"38772","SERRAVALLE A PO",58,0,146,204,"2022","062"
"38773","SERRAVALLE LANGHE",101,0,0,101,"2022","219"
"38774","SERRAVALLE SCRIVIA",7,0,0,7,"2022","160"
"38775","SERRAVALLE SESIA",14,0,0,14,"2022","137"
"38776","SESTO CALENDE",19,0,0,19,"2022","120"
"38777","SESTO ED UNITI",7,2082,0,2089,"2022","095"
"38778","SESTOLA",108,335,0,443,"2022","043"
"38779","SETTALA",15,344,22,381,"2022","210"
"38780","SETTIME",126,0,0,126,"2022","106"
"38781","SETTIMO MILANESE",2,280,6,288,"2022","211"
"38782","SETTIMO ROTTARO",48,0,0,48,"2022","264"
"38783","SETTIMO TORINESE",403,375,57,835,"2022","265"
"38784","SETTIMO VITTONE",135,105,31,271,"2022","266"
"38785","SEVESO",1,0,0,1,"2022",NA
"38786","SEZZADIO",38,0,0,38,"2022","161"
"38787","SILEA",5,113,0,118,"2022","081"
"38788","SILLAVENGO",31,0,128,159,"2022","138"
"38789","SILVANO D'ORBA",8,0,0,8,"2022","162"
"38790","SILVANO PIETRA",1,0,0,1,"2022",NA
"38791","SINIO",8,4,0,12,"2022","220"
"38792","SIRONE",7,122,3,132,"2022","075"
"38793","SIRTORI",3,0,0,3,"2022","076"
"38794","SISSA TRECASALI",12,749,0,761,"2022",NA
"38795","SIZIANO",63,97,0,160,"2022","150"
"38796","SIZZANO",105,14,74,193,"2022","139"
"38797","SOAVE",40,0,0,40,"2022","081"
"38798","SOGLIANO AL RUBICONE",370,19,0,389,"2022","046"
"38799","SOIANO DEL LAGO",2,0,3,5,"2022","180"
"38800","SOLAGNA",0,17,0,17,"2022","101"
"38801","SOLARO",0,18,0,18,"2022","213"
"38802","SOLAROLO RAINERIO",0,260,0,260,"2022","096"
"38803","SOLBIATE CON CAGNO",3,170,0,173,"2022",NA
"38804","SOLERO",184,0,0,184,"2022","163"
"38805","SOLESINO",5,0,0,5,"2022","087"
"38806","SOLFERINO",640,271,156,1067,"2022","063"
"38807","SOLIERA",27,1006,0,1033,"2022","044"
"38808","SOLIGNANO",38,247,0,285,"2022","035"
"38809","SOLONGHELLO",96,0,0,96,"2022","164"
"38810","SOLTO COLLINA",24,0,0,24,"2022","200"
"38811","SOMAGLIA",3,1265,0,1268,"2022","054"
"38812","SOMANO",48,0,0,48,"2022","221"
"38813","SOMMA LOMBARDO",26,26,0,52,"2022","123"
"38814","SOMMACAMPAGNA",1608,395,57,2060,"2022","082"
"38815","SOMMARIVA DEL BOSCO",1502,559,145,2206,"2022","222"
"38816","SOMMARIVA PERNO",15,0,0,15,"2022","223"
"38817","SOMMO",9,0,0,9,"2022","151"
"38818","SONA",2354,476,3,2833,"2022","083"
"38819","SONCINO",676,5392,176,6244,"2022","097"
"38820","SONDALO",17,87,9,113,"2022","060"
"38821","SONDRIO",34,44,0,78,"2022","061"
"38822","SONGAVAZZO",1,0,0,1,"2022","201"
"38823","SONICO",4,115,14,133,"2022","181"
"38824","SORAGNA",44,1661,0,1705,"2022","036"
"38825","SORBOLO MEZZANI",1,1902,0,1903,"2022",NA
"38826","SORDEVOLO",78,12,0,90,"2022","063"
"38827","SORDIO",0,224,0,224,"2022","055"
"38828","SORESINA",70,1265,166,1501,"2022","098"
"38829","SORGA'",1837,19,0,1856,"2022","084"
"38830","SORICO",10,13,94,117,"2022","216"
"38831","SORISO",9,0,0,9,"2022","140"
"38832","SORISOLE",58,92,0,150,"2022","202"
"38833","SORMANO",37,0,0,37,"2022","217"
"38834","SOSPIRO",54,445,0,499,"2022","099"
"38835","SOSPIROLO",8,105,0,113,"2022","056"
"38836","SOSSANO",55,361,0,416,"2022","102"
"38837","SOSTEGNO",0,10,0,10,"2022","064"
"38838","SOTTO IL MONTE GIOVANNI XXIII",130,0,0,130,"2022","203"
"38839","SOVERE",37,34,0,71,"2022","204"
"38840","SOVERZENE",3,0,0,3,"2022","057"
"38841","SOVIZZO",459,72,1,532,"2022","103"
"38842","SOVRAMONTE",61,62,2,125,"2022","058"
"38843","SOZZAGO",1,0,0,1,"2022","141"
"38844","SPARONE",38,47,0,85,"2022","267"
"38845","SPESSA",11,0,0,11,"2022","152"
"38846","SPIGNO MONFERRATO",147,3,47,197,"2022","165"
"38847","SPILAMBERTO",1892,1200,0,3092,"2022","045"
"38848","SPINEA",27,106,2,135,"2022","038"
"38849","SPINEDA",15,783,0,798,"2022","101"
"38850","SPINETO SCRIVIA",77,0,0,77,"2022","166"
"38851","SPINO D'ADDA",523,2003,47,2573,"2022","102"
"38852","SPINONE AL LAGO",4,0,0,4,"2022","205"
"38853","SPIRANO",4,1031,0,1035,"2022","206"
"38854","SPRESIANO",24,209,0,233,"2022","082"
"38855","STAGNO LOMBARDO",3,6787,0,6790,"2022","103"
"38856","STANGHELLA",540,0,0,540,"2022","088"
"38857","STAZZANO",8,0,0,8,"2022","167"
"38858","STAZZONA",3,7,5,15,"2022","218"
"38859","STEZZANO",195,450,0,645,"2022","207"
"38860","STIENTA",65,0,0,65,"2022","045"
"38861","STRA",10,0,0,10,"2022","039"
"38862","STRADELLA",4,34,0,38,"2022","153"
"38863","STRAMBINELLO",44,0,0,44,"2022",NA
"38864","STRAMBINO",176,0,0,176,"2022","269"
"38865","STRESA",62,0,0,62,"2022","064"
"38866","STREVI",23,0,0,23,"2022","168"
"38867","STROPPO",4,0,0,4,"2022","224"
"38868","STROZZA",4,0,0,4,"2022","208"
"38869","SUARDI",4,0,0,4,"2022","154"
"38870","SUEGLIO",0,0,2,2,"2022","077"
"38871","SUELLO",2,0,3,5,"2022","078"
"38872","SUISIO",1,109,0,110,"2022","209"
"38873","SULBIATE",37,0,0,37,"2022",NA
"38874","SULZANO",37,200,3,240,"2022","182"
"38875","SUMIRAGO",55,45,0,100,"2022","124"
"38876","SUNO",40,367,0,407,"2022","143"
"38877","SUSA",218,0,0,218,"2022","270"
"38878","SUSEGANA",812,42,2,856,"2022","083"
"38879","SUSTINENTE",732,661,213,1606,"2022","064"
"38880","SUZZARA",2010,1274,1807,5091,"2022","065"
"38881","TACENO",5,0,16,21,"2022","079"
"38882","TAGLIO DI PO",7787,0,0,7787,"2022","046"
"38883","TAGLIOLO MONFERRATO",53,0,0,53,"2022","169"
"38884","TAIBON AGORDINO",0,22,0,22,"2022","059"
"38885","TAINO",33,142,0,175,"2022","125"
"38886","TALAMONA",16,182,14,212,"2022","063"
"38887","TALEGGIO",55,26,0,81,"2022","210"
"38888","TAMBRE",7,129,4,140,"2022","060"
"38889","TARANTASCA",2433,798,0,3231,"2022","225"
"38890","TARTANO",20,18,0,38,"2022","064"
"38891","TARZO",24,0,2,26,"2022","084"
"38892","TAVAGNASCO",111,0,0,111,"2022","271"
"38893","TAVAZZANO CON VILLAVESCO",0,1075,0,1075,"2022","056"
"38894","TAVERNOLA BERGAMASCA",6,0,0,6,"2022","211"
"38895","TAVERNOLE SUL MELLA",7,41,5,53,"2022","183"
"38896","TAVIGLIANO",4,0,0,4,"2022","066"
"38897","TEGLIO",77,229,29,335,"2022","065"
"38898","TELGATE",2306,158,0,2464,"2022","212"
"38899","TEMU'",27,8,1,36,"2022","184"
"38900","TEOLO",25,39,0,64,"2022","089"
"38901","TERDOBBIATE",9,147,0,156,"2022","144"
"38902","TERENZO",74,779,0,853,"2022","038"
"38903","TERNO D'ISOLA",8,0,0,8,"2022","213"
"38904","TERRANOVA DEI PASSERINI",0,256,75,331,"2022","057"
"38905","TERRASSA PADOVANA",1732,0,0,1732,"2022","090"
"38906","TERRAZZO",17,0,0,17,"2022","085"
"38907","TERRE DEL RENO",1,0,0,1,"2022",NA
"38908","TERRUGGIA",29,0,0,29,"2022","171"
"38909","TERZO",6,0,0,6,"2022","172"
"38910","TEZZE SUL BRENTA",82,174,0,256,"2022","104"
"38911","THIENE",495,294,12,801,"2022","105"
"38912","TICENGO",1,432,98,531,"2022","104"
"38913","TIGLIOLE",796,0,0,796,"2022","108"
"38914","TIGNALE",4,7,7,18,"2022","185"
"38915","TIRANO",1,13,3,17,"2022","066"
"38916","TIZZANO VAL PARMA",6,752,0,758,"2022","039"
"38917","TOANO",53,1942,0,1995,"2022","041"
"38918","TOCENO",31,5,21,57,"2022","065"
"38919","TOLLEGNO",36,0,1,37,"2022","068"
"38920","TOMBOLO",946,21,0,967,"2022","091"
"38921","TONCO",754,0,0,754,"2022","109"
"38922","TONENGO",79,0,0,79,"2022","110"
"38923","TONEZZA DEL CIMONE",1,0,0,1,"2022","106"
"38924","TORBOLE CASAGLIA",13,860,0,873,"2022","186"
"38925","TORINO",178,0,7,185,"2022","272"
"38926","TORLINO VIMERCATI",0,286,0,286,"2022","105"
"38927","TORNACO",0,142,0,142,"2022",NA
"38928","TORNATA",0,176,0,176,"2022","106"
"38929","TORNO",2,0,0,2,"2022","223"
"38930","TORNOLO",130,3,0,133,"2022","040"
"38931","TORRAZZA COSTE",8,0,0,8,"2022","155"
"38932","TORRAZZA PIEMONTE",168,0,0,168,"2022","273"
"38933","TORRAZZO",4,0,0,4,"2022","069"
"38934","TORRE BERETTI E CASTELLARO",14,389,0,403,"2022","156"
"38935","TORRE BOLDONE",2,0,0,2,"2022","214"
"38936","TORRE BORMIDA",13,0,0,13,"2022","226"
"38937","TORRE D'ISOLA",0,942,0,942,"2022","159"
"38938","TORRE DE' BUSI",9,0,0,9,"2022","080"
"38939","TORRE DE' NEGRI",7,0,87,94,"2022","158"
"38940","TORRE DE' PICENARDI",86,2882,0,2968,"2022","107"
"38941","TORRE DE' ROVERI",8,0,0,8,"2022","216"
"38942","TORRE DI MOSTO",3,614,0,617,"2022","041"
"38943","TORRE DI SANTA MARIA",12,9,7,28,"2022","067"
"38944","TORRE PALLAVICINA",237,326,0,563,"2022","217"
"38945","TORRE PELLICE",70,0,27,97,"2022","275"
"38946","TORRE SAN GIORGIO",80,10,8,98,"2022","228"
"38947","TORREBELVICINO",1000,10,0,1010,"2022","107"
"38948","TORREGLIA",6,0,0,6,"2022","092"
"38949","TORRESINA",2,0,0,2,"2022","229"
"38950","TORREVECCHIA PIA",52,9,12,73,"2022","160"
"38951","TORRI DEL BENACO",5,0,0,5,"2022",NA
"38952","TORRI DI QUARTESOLO",42,148,0,190,"2022","108"
"38953","TORRICELLA VERZATE",1,0,0,1,"2022",NA
"38954","TORRILE",0,2578,0,2578,"2022","041"
"38955","TORTONA",3165,52,0,3217,"2022","174"
"38956","TOSCOLANO-MADERNO",3,0,2,5,"2022","187"
"38957","TOVO DI SANT'AGATA",6,51,1,58,"2022","068"
"38958","TRADATE",10,0,0,10,"2022","127"
"38959","TRANA",55,8,12,75,"2022","276"
"38960","TRAONA",86,214,0,300,"2022","069"
"38961","TRAREGO VIGGIONA",4,0,0,4,"2022","066"
"38962","TRASQUERA",25,0,6,31,"2022","067"
"38963","TRAVAGLIATO",300,369,0,669,"2022","188"
"38964","TRAVEDONA-MONATE",5,0,8,13,"2022","128"
"38965","TRAVERSELLA",34,27,9,70,"2022","278"
"38966","TRAVERSETOLO",109,990,0,1099,"2022","042"
"38967","TRAVES",13,0,0,13,"2022","279"
"38968","TRAVO",88,26,0,114,"2022","043"
"38969","TREBASELEGHE",6946,61,3,7010,"2022","093"
"38970","TRECATE",0,100,0,100,"2022","149"
"38971","TRECENTA",611,88,71,770,"2022","047"
"38972","TREDOZIO",227,0,0,227,"2022","049"
"38973","TREGNAGO",597,115,0,712,"2022","087"
"38974","TREMEZZINA",19,17,37,73,"2022",NA
"38975","TREMOSINE",20,424,4,448,"2022","189"
"38976","TRENZANO",837,1440,148,2425,"2022","190"
"38977","TRESCORE BALNEARIO",45,60,0,105,"2022","218"
"38978","TRESCORE CREMASCO",10,601,0,611,"2022","109"
"38979","TRESIGNANA",1,0,0,1,"2022",NA
"38980","TRESIVIO",15,17,0,32,"2022","070"
"38981","TREVENZUOLO",476,1135,0,1611,"2022","088"
"38982","TREVIGLIO",1008,1605,0,2613,"2022","219"
"38983","TREVIGNANO",1909,137,0,2046,"2022","085"
"38984","TREVILLE",12,0,0,12,"2022","175"
"38985","TREVIOLO",92,73,0,165,"2022","220"
"38986","TREVISO",393,111,13,517,"2022","086"
"38987","TREVISO BRESCIANO",6,39,3,48,"2022","191"
"38988","TREZZO SULL'ADDA",5,344,0,349,"2022","221"
"38989","TREZZO TINELLA",10,0,0,10,"2022","231"
"38990","TREZZONE",1,0,4,5,"2022","226"
"38991","TRIBANO",1,0,0,1,"2022","094"
"38992","TRIBIANO",0,58,0,58,"2022","222"
"38993","TRIGOLO",0,1084,0,1084,"2022","110"
"38994","TRINITA'",3159,542,183,3884,"2022","232"
"38995","TRINO",7,144,0,151,"2022","148"
"38996","TRISOBBIO",81,0,0,81,"2022","176"
"38997","TRISSINO",80,236,33,349,"2022","110"
"38998","TRIUGGIO",5,281,23,309,"2022",NA
"38999","TROFARELLO",542,50,0,592,"2022","280"
"39000","TROMELLO",13,488,185,686,"2022","164"
"39001","TRONTANO",9,16,0,25,"2022","068"
"39002","TRONZANO VERCELLESE",206,0,0,206,"2022","150"
"39003","TROVO",5,37,0,42,"2022","165"
"39004","TRUCCAZZANO",43,1773,9,1825,"2022","224"
"39005","TURANO LODIGIANO",81,2156,0,2237,"2022","058"
"39006","TURBIGO",0,50,0,50,"2022","226"
"39007","UBIALE CLANEZZO",2,0,0,2,"2022","221"
"39008","UBOLDO",13,0,0,13,"2022","130"
"39009","UGGIATE-TREVANO",17,62,8,87,"2022","228"
"39010","URAGO D'OGLIO",323,1262,0,1585,"2022","192"
"39011","URBANA",695,0,0,695,"2022","095"
"39012","URGNANO",212,137,0,349,"2022","222"
"39013","USMATE VELATE",4,26,2,32,"2022",NA
"39014","USSEAUX",10,30,65,105,"2022","281"
"39015","USSEGLIO",2,0,0,2,"2022","282"
"39016","VAIANO CREMASCO",234,572,0,806,"2022","111"
"39017","VAIE",18,59,0,77,"2022","283"
"39018","VAILATE",8,331,0,339,"2022","112"
"39019","VAL BREMBILLA",60,41,0,101,"2022",NA
"39020","VAL DELLA TORRE",204,0,25,229,"2022","284"
"39021","VAL DI CHY",36,4,0,40,"2022",NA
"39022","VAL DI NIZZA",2,0,0,2,"2022","166"
"39023","VAL DI ZOLDO",14,0,0,14,"2022",NA
"39024","VAL LIONA",356,159,0,515,"2022",NA
"39025","VAL MASINO",0,7,0,7,"2022","074"
"39026","VAL REZZO",17,0,20,37,"2022","233"
"39027","VALBONDIONE",3,14,0,17,"2022","223"
"39028","VALBREMBO",16,30,0,46,"2022","224"
"39029","VALBRENTA",29,13,0,42,"2022",NA
"39030","VALBRONA",4,0,1,5,"2022","229"
"39031","VALCHIUSA",121,104,37,262,"2022",NA
"39032","VALDAGNO",38,130,5,173,"2022","111"
"39033","VALDASTICO",1009,7,0,1016,"2022","112"
"39034","VALDENGO",34,9,0,43,"2022","071"
"39035","VALDIDENTRO",38,116,27,181,"2022","071"
"39036","VALDIERI",17,0,0,17,"2022","233"
"39037","VALDILANA",79,49,34,162,"2022",NA
"39038","VALDISOTTO",35,155,7,197,"2022","072"
"39039","VALDOBBIADENE",55,321,9,385,"2022","087"
"39040","VALEGGIO",55,0,0,55,"2022","167"
"39041","VALEGGIO SUL MINCIO",2250,2216,56,4522,"2022","089"
"39042","VALENZA",89,0,0,89,"2022","177"
"39043","VALERA FRATTA",21,294,141,456,"2022","059"
"39044","VALFENERA",949,113,263,1325,"2022","112"
"39045","VALFURVA",23,117,0,140,"2022","073"
"39046","VALGANNA",20,0,0,20,"2022","131"
"39047","VALGIOIE",2,0,0,2,"2022",NA
"39048","VALGOGLIO",17,45,0,62,"2022","225"
"39049","VALGRANA",395,0,0,395,"2022","234"
"39050","VALGREGHENTINO",5,0,0,5,"2022","082"
"39051","VALLADA AGORDINA",0,7,0,7,"2022","062"
"39052","VALLE LOMELLINA",24,771,0,795,"2022","168"
"39053","VALLE SAN NICOLAO",5,0,0,5,"2022","074"
"39054","VALLEVE",0,6,0,6,"2022","226"
"39055","VALLI DEL PASUBIO",3,4,0,7,"2022","113"
"39056","VALLIO TERME",9,0,2,11,"2022","193"
"39057","VALLO TORINESE",18,0,0,18,"2022","286"
"39058","VALMADRERA",16,0,8,24,"2022","083"
"39059","VALMOREA",2,34,0,36,"2022","232"
"39060","VALMOZZOLA",89,7,0,96,"2022","044"
"39061","VALPERGA",201,109,24,334,"2022","287"
"39062","VALSAMOGGIA",273,853,0,1126,"2022",NA
"39063","VALSOLDA",5,3,2,10,"2022","234"
"39064","VALSTRONA",20,0,0,20,"2022","069"
"39065","VALTORTA",0,23,0,23,"2022","229"
"39066","VALVARRONE",1,0,0,1,"2022",NA
"39067","VALVESTINO",0,17,0,17,"2022","194"
"39068","VANZAGO",28,0,0,28,"2022","229"
"39069","VAPRIO D'ADDA",2,441,4,447,"2022","230"
"39070","VARALLO",16,37,0,53,"2022","156"
"39071","VARANO DE' MELEGARI",55,370,0,425,"2022","045"
"39072","VAREDO",1,0,0,1,"2022",NA
"39073","VARESE",66,18,0,84,"2022","133"
"39074","VARISELLA",190,0,0,190,"2022","289"
"39075","VARSI",8,439,0,447,"2022","046"
"39076","VARZI",77,4,0,81,"2022","171"
"39077","VARZO",12,15,12,39,"2022","071"
"39078","VAUDA CANAVESE",47,0,0,47,"2022","290"
"39079","VAZZOLA",1377,58,3,1438,"2022","088"
"39080","VEDANO OLONA",5,203,0,208,"2022","134"
"39081","VEDELAGO",20587,682,160,21429,"2022","089"
"39082","VEDESETA",3,121,0,124,"2022","230"
"39083","VEGGIANO",373,64,10,447,"2022","096"
"39084","VELESO",0,0,10,10,"2022","236"
"39085","VELLEZZO BELLINI",10,332,2,344,"2022","173"
"39086","VELO D'ASTICO",1029,15,0,1044,"2022","115"
"39087","VELO VERONESE",413,1548,43,2004,"2022","090"
"39088","VENARIA REALE",58,18,209,285,"2022","292"
"39089","VENASCA",64,0,0,64,"2022","237"
"39090","VENAUS",2,0,47,49,"2022","291"
"39091","VENEGONO INFERIORE",0,83,0,83,"2022","136"
"39092","VENEGONO SUPERIORE",2,0,0,2,"2022","137"
"39093","VENEZIA",1620,185,0,1805,"2022","042"
"39094","VENIANO",61,78,0,139,"2022","238"
"39095","VENTASSO",101,379,0,480,"2022",NA
"39096","VERBANIA",60,0,5,65,"2022","072"
"39097","VERCANA",3,4,0,7,"2022","239"
"39098","VERCEIA",8,0,4,12,"2022","075"
"39099","VERCELLI",70,230,0,300,"2022","158"
"39100","VERDELLINO",0,56,0,56,"2022","232"
"39101","VERDELLO",241,70,0,311,"2022","233"
"39102","VERDERIO",39,0,59,98,"2022",NA
"39103","VERDUNO",18,0,0,18,"2022","238"
"39104","VERGATO",59,0,0,59,"2022","059"
"39105","VERGHERETO",1370,0,0,1370,"2022","050"
"39106","VERGIATE",14,0,0,14,"2022","138"
"39107","VERMEZZO CON ZELO",9,502,0,511,"2022",NA
"39108","VERNANTE",199,46,0,245,"2022","239"
"39109","VERNASCA",82,66,0,148,"2022","044"
"39110","VERNATE",19,84,0,103,"2022","236"
"39111","VEROLANUOVA",724,2014,58,2796,"2022","195"
"39112","VEROLAVECCHIA",3,3510,0,3513,"2022","196"
"39113","VEROLENGO",546,41,0,587,"2022","293"
"39114","VERONA",3674,807,0,4481,"2022","091"
"39115","VERONELLA",4829,241,0,5070,"2022","092"
"39116","VERRETTO",3,0,0,3,"2022","174"
"39117","VERRONE",42,10,0,52,"2022","076"
"39118","VERRUA SAVOIA",523,0,0,523,"2022","294"
"39119","VERTEMATE CON MINOPRIO",3,0,0,3,"2022","242"
"39120","VERTOVA",12,36,0,48,"2022","234"
"39121","VERUCCHIO",195,0,0,195,"2022","020"
"39122","VERVIO",28,47,0,75,"2022","076"
"39123","VERZUOLO",2,0,0,2,"2022","240"
"39124","VESCOVANA",6,0,0,6,"2022","097"
"39125","VESCOVATO",2692,1407,0,4099,"2022","113"
"39126","VESIME",530,0,0,530,"2022","113"
"39127","VESPOLATE",0,126,0,126,"2022","158"
"39128","VESTENANOVA",449,202,0,651,"2022","093"
"39129","VESTIGNE'",8,96,0,104,"2022","295"
"39130","VESTONE",8,0,0,8,"2022","197"
"39131","VETTO",7,341,0,348,"2022","042"
"39132","VEZZA D'ALBA",2,0,0,2,"2022","241"
"39133","VEZZA D'OGLIO",0,193,8,201,"2022","198"
"39134","VEZZANO SUL CROSTOLO",15,107,0,122,"2022","043"
"39135","VIADANA",268,1433,4,1705,"2022","066"
"39136","VIADANICA",18,28,0,46,"2022","235"
"39137","VIALE",295,0,0,295,"2022","114"
"39138","VIALFRE'",14,0,13,27,"2022","296"
"39139","VIANO",8,766,0,774,"2022","044"
"39140","VIARIGI",25,0,0,25,"2022","115"
"39141","VICENZA",168,901,13,1082,"2022","116"
"39142","VICOFORTE",577,0,0,577,"2022","242"
"39143","VIDIGULFO",16,292,0,308,"2022","176"
"39144","VIDOR",5,423,9,437,"2022","090"
"39145","VIGANO SAN MARTINO",4,0,0,4,"2022","236"
"39146","VIGASIO",593,777,7,1377,"2022","094"
"39147","VIGEVANO",42,0,14,56,"2022","177"
"39148","VIGGIU'",20,0,0,20,"2022","139"
"39149","VIGHIZZOLO D'ESTE",124,22,0,146,"2022","098"
"39150","VIGLIANO BIELLESE",1,0,0,1,"2022","077"
"39151","VIGLIANO D'ASTI",54,0,0,54,"2022","116"
"39152","VIGNALE MONFERRATO",217,0,0,217,"2022","179"
"39153","VIGNATE",0,293,65,358,"2022","237"
"39154","VIGNOLA",0,88,0,88,"2022","046"
"39155","VIGNOLE BORBERA",30,0,0,30,"2022","180"
"39156","VIGNOLO",1442,0,0,1442,"2022","243"
"39157","VIGNONE",1,0,0,1,"2022","074"
"39158","VIGO DI CADORE",6,10,0,16,"2022","065"
"39159","VIGODARZERE",299,55,0,354,"2022","099"
"39160","VIGOLO",5,218,2,225,"2022","237"
"39161","VIGOLZONE",113,668,0,781,"2022","045"
"39162","VIGONE",3174,1176,161,4511,"2022","299"
"39163","VIGONOVO",15,0,0,15,"2022","043"
"39164","VIGONZA",1020,182,0,1202,"2022","100"
"39165","VILLA BARTOLOMEA",259,0,0,259,"2022","095"
"39166","VILLA CARCINA",1,0,0,1,"2022","199"
"39167","VILLA CORTESE",4,0,0,4,"2022","248"
"39168","VILLA D'ADDA",10,0,0,10,"2022","238"
"39169","VILLA D'ALME'",123,8,0,131,"2022","239"
"39170","VILLA D'OGNA",0,40,0,40,"2022","241"
"39171","VILLA DEL CONTE",794,644,0,1438,"2022","101"
"39172","VILLA DI CHIAVENNA",0,24,2,26,"2022","077"
"39173","VILLA DI SERIO",8,0,0,8,"2022","240"
"39174","VILLA DI TIRANO",19,214,4,237,"2022","078"
"39175","VILLA ESTENSE",33,0,0,33,"2022","102"
"39176","VILLA GUARDIA",115,0,32,147,"2022","245"
"39177","VILLA MINOZZO",35,706,0,741,"2022","045"
"39178","VILLA SAN SECONDO",5,0,0,5,"2022","119"
"39179","VILLACHIARA",457,3480,16,3953,"2022","200"
"39180","VILLADEATI",16,0,0,16,"2022","182"
"39181","VILLADOSE",0,1,69,70,"2022","048"
"39182","VILLADOSSOLA",9,0,0,9,"2022","075"
"39183","VILLAFALLETTO",2262,782,265,3309,"2022","244"
"39184","VILLAFRANCA D'ASTI",230,0,0,230,"2022","117"
"39185","VILLAFRANCA DI VERONA",8119,3611,126,11856,"2022","096"
"39186","VILLAFRANCA PADOVANA",676,2015,83,2774,"2022","103"
"39187","VILLAFRANCA PIEMONTE",2602,2243,164,5009,"2022","300"
"39188","VILLAGA",156,195,0,351,"2022","117"
"39189","VILLAMARZANA",952,95,0,1047,"2022","049"
"39190","VILLANOVA BIELLESE",409,0,0,409,"2022","079"
"39191","VILLANOVA CANAVESE",27,2,9,38,"2022","301"
"39192","VILLANOVA D'ASTI",4100,75,0,4175,"2022","118"
"39193","VILLANOVA DEL GHEBBO",31,0,0,31,"2022","050"
"39194","VILLANOVA DEL SILLARO",1,898,4,903,"2022","060"
"39195","VILLANOVA DI CAMPOSAMPIERO",24,10,0,34,"2022","104"
"39196","VILLANOVA MARCHESANA",0,87,0,87,"2022","051"
"39197","VILLANOVA MONDOVI'",1371,505,151,2027,"2022","245"
"39198","VILLANOVA MONFERRATO",1,0,0,1,"2022","185"
"39199","VILLANOVA SOLARO",301,645,6,952,"2022","246"
"39200","VILLANOVA SULL'ARDA",1,1780,0,1781,"2022","046"
"39201","VILLANTERIO",3,0,199,202,"2022","180"
"39202","VILLANUOVA SUL CLISI",3,0,0,3,"2022","201"
"39203","VILLAR DORA",86,0,23,109,"2022","303"
"39204","VILLAR FOCCHIARDO",8,30,114,152,"2022","305"
"39205","VILLAR PELLICE",237,31,19,287,"2022","306"
"39206","VILLAR PEROSA",11,15,0,26,"2022","307"
"39207","VILLAR SAN COSTANZO",419,233,3,655,"2022","247"
"39208","VILLARBASSE",231,10,2,243,"2022","302"
"39209","VILLARBOIT",1,0,0,1,"2022","163"
"39210","VILLAREGGIA",27,0,0,27,"2022","304"
"39211","VILLAROMAGNANO",1,0,0,1,"2022","186"
"39212","VILLASTELLONE",522,490,119,1131,"2022","308"
"39213","VILLATA",14,30,0,44,"2022","164"
"39214","VILLAVERLA",81,1414,0,1495,"2022","118"
"39215","VILLETTE",21,0,35,56,"2022","076"
"39216","VILLIMPENTA",60,34,2,96,"2022","068"
"39217","VILLONGO",10,1,0,11,"2022","242"
"39218","VILLORBA",119,0,0,119,"2022","091"
"39219","VILMINORE DI SCALVE",12,151,0,163,"2022","243"
"39220","VIMERCATE",3,27,0,30,"2022",NA
"39221","VINADIO",239,0,0,239,"2022","248"
"39222","VINCHIO",2,0,0,2,"2022","120"
"39223","VINOVO",425,158,25,608,"2022","309"
"39224","VINZAGLIO",4,39,0,43,"2022","164"
"39225","VIOLA",73,0,0,73,"2022","249"
"39226","VIONE",9,30,0,39,"2022","202"
"39227","VIRLE PIEMONTE",403,214,162,779,"2022","310"
"39228","VISANO",2318,450,1,2769,"2022","203"
"39229","VISCHE",26,0,0,26,"2022","311"
"39230","VISONE",46,0,0,46,"2022","187"
"39231","VISTARINO",4,0,0,4,"2022","181"
"39232","VISTRORIO",4,0,10,14,"2022","312"
"39233","VITTORIO VENETO",217,131,3,351,"2022","092"
"39234","VITTUONE",3,208,0,211,"2022","243"
"39235","VIU'",29,0,6,35,"2022","313"
"39236","VIVERONE",29,0,0,29,"2022","080"
"39237","VIZZOLO PREDABISSI",14,0,90,104,"2022","244"
"39238","VO'",57,81,0,138,"2022","105"
"39239","VOBARNO",21,103,22,146,"2022","204"
"39240","VOCCA",1,11,0,12,"2022","166"
"39241","VODO CADORE",0,0,23,23,"2022","066"
"39242","VOGHERA",42,0,0,42,"2022","182"
"39243","VOGOGNA",25,3,0,28,"2022","077"
"39244","VOLONGO",18,0,0,18,"2022","114"
"39245","VOLPAGO DEL MONTELLO",1127,664,24,1815,"2022","093"
"39246","VOLPEDO",1,0,0,1,"2022","188"
"39247","VOLPIANO",287,105,57,449,"2022","314"
"39248","VOLTA MANTOVANA",2982,1344,880,5206,"2022","070"
"39249","VOLTAGGIO",14,0,77,91,"2022","190"
"39250","VOLVERA",1271,278,55,1604,"2022","315"
"39251","VOTTIGNASCO",1703,40,102,1845,"2022","250"
"39252","ZANDOBBIO",7,0,0,7,"2022","244"
"39253","ZANE'",286,96,0,382,"2022","119"
"39254","ZANICA",182,1247,0,1429,"2022","245"
"39255","ZAVATTARELLO",85,0,0,85,"2022","184"
"39256","ZECCONE",7,219,0,226,"2022","185"
"39257","ZELBIO",0,0,11,11,"2022","246"
"39258","ZELO BUON PERSICO",0,1351,0,1351,"2022","061"
"39259","ZEME",68,0,0,68,"2022","186"
"39260","ZENEVREDO",2,0,0,2,"2022","187"
"39261","ZENSON DI PIAVE",4,0,0,4,"2022","094"
"39262","ZERBOLO'",0,213,0,213,"2022","189"
"39263","ZERMEGHEDO",0,47,0,47,"2022","120"
"39264","ZERO BRANCO",231,158,0,389,"2022","095"
"39265","ZEVIO",4005,528,108,4641,"2022","097"
"39266","ZIANO PIACENTINO",183,0,0,183,"2022","048"
"39267","ZIBIDO SAN GIACOMO",33,372,0,405,"2022","247"
"39268","ZIMELLA",8120,423,0,8543,"2022","098"
"39269","ZINASCO",35,0,0,35,"2022","190"
"39270","ZOCCA",84,726,0,810,"2022","047"
"39271","ZOGNO",72,57,0,129,"2022","246"
"39272","ZOLA PREDOSA",11,247,0,258,"2022","060"
"39273","ZONE",2,24,0,26,"2022","205"
"39274","ZOVENCEDO",6,0,0,6,"2022","121"
"39275","ZUBIENA",45,0,20,65,"2022","082"
"39276","ZUGLIANO",660,128,8,796,"2022","122"
"39277","ZUMAGLIA",53,0,0,53,"2022","083"
"39278","ABANO TERME",45,126,0,171,"2023","001"
"39279","ABBADIA CERRETO",30,1236,0,1266,"2023","001"
"39280","ABBADIA LARIANA",4,27,4,35,"2023","001"
"39281","ABBIATEGRASSO",86,1633,0,1719,"2023","002"
"39282","ACCEGLIO",80,0,0,80,"2023","001"
"39283","ACQUAFREDDA",1326,99,0,1425,"2023","001"
"39284","ACQUANEGRA CREMONESE",1,974,0,975,"2023","001"
"39285","ACQUANEGRA SUL CHIESE",795,456,417,1668,"2023","001"
"39286","ACQUI TERME",196,0,0,196,"2023","001"
"39287","ADRARA SAN MARTINO",52,21,0,73,"2023","001"
"39288","ADRARA SAN ROCCO",19,0,0,19,"2023","002"
"39289","ADRIA",2018,136,0,2154,"2023","001"
"39290","ADRO",517,17,0,534,"2023","002"
"39291","AGAZZANO",142,433,0,575,"2023","001"
"39292","AGLIANO TERME",48,0,0,48,"2023","001"
"39293","AGLIE'",386,45,13,444,"2023","001"
"39294","AGNA",231,0,0,231,"2023","002"
"39295","AGNADELLO",1,1962,6,1969,"2023","002"
"39296","AGNOSINE",7,34,1,42,"2023","003"
"39297","AGORDO",2,6,0,8,"2023","001"
"39298","AGRATE CONTURBIA",14,0,0,14,"2023","001"
"39299","AGUGLIARO",303,0,0,303,"2023","001"
"39300","AICURZIO",0,0,20,20,"2023",NA
"39301","AILOCHE",0,6,0,6,"2023","001"
"39302","AIRASCA",707,746,0,1453,"2023","002"
"39303","AIRUNO",11,0,0,11,"2023","002"
"39304","AISONE",26,0,0,26,"2023","002"
"39305","ALA DI STURA",24,0,0,24,"2023","003"
"39306","ALAGNA VALSESIA",42,30,0,72,"2023","002"
"39307","ALANO DI PIAVE",397,59,6,462,"2023","002"
"39308","ALBA",729,0,0,729,"2023","003"
"39309","ALBAIRATE",56,617,0,673,"2023","005"
"39310","ALBANO SANT'ALESSANDRO",2,0,0,2,"2023","003"
"39311","ALBAREDO D'ADIGE",10400,200,0,10600,"2023","002"
"39312","ALBAREDO PER SAN MARCO",5,15,0,20,"2023","001"
"39313","ALBARETO",219,44,0,263,"2023","001"
"39314","ALBARETTO DELLA TORRE",21,0,0,21,"2023","004"
"39315","ALBAVILLA",1,0,0,1,"2023","003"
"39316","ALBERA LIGURE",53,0,0,53,"2023","002"
"39317","ALBESE CON CASSANO",0,0,4,4,"2023","004"
"39318","ALBETTONE",2119,672,51,2842,"2023","002"
"39319","ALBIANO D'IVREA",115,26,0,141,"2023","004"
"39320","ALBIATE",223,0,0,223,"2023",NA
"39321","ALBIGNASEGO",40,186,0,226,"2023","003"
"39322","ALBINEA",33,1013,0,1046,"2023","001"
"39323","ALBINO",113,57,0,170,"2023","004"
"39324","ALBIOLO",4,2,0,6,"2023","005"
"39325","ALBIZZATE",12,0,0,12,"2023","002"
"39326","ALBOSAGGIA",85,61,60,206,"2023","002"
"39327","ALBUGNANO",97,0,0,97,"2023","002"
"39328","ALBUZZANO",83,0,0,83,"2023","004"
"39329","ALESSANDRIA",7535,2001,145,9681,"2023","003"
"39330","ALFIANELLO",0,585,2,587,"2023","004"
"39331","ALFIANO NATTA",16,0,0,16,"2023","004"
"39332","ALFONSINE",55,0,0,55,"2023","001"
"39333","ALGUA",20,7,0,27,"2023","248"
"39334","ALICE BEL COLLE",2,0,0,2,"2023","005"
"39335","ALICE CASTELLO",913,30,2,945,"2023","004"
"39336","ALLEGHE",3,0,0,3,"2023","003"
"39337","ALLUVIONI PIOVERA",353,87,0,440,"2023",NA
"39338","ALME'",10,0,0,10,"2023","005"
"39339","ALMENNO SAN BARTOLOMEO",58,0,0,58,"2023","006"
"39340","ALMENNO SAN SALVATORE",6,0,0,6,"2023","007"
"39341","ALMESE",61,19,0,80,"2023","006"
"39342","ALONTE",720,19,0,739,"2023","003"
"39343","ALPAGO",13,164,0,177,"2023",NA
"39344","ALPIGNANO",247,62,18,327,"2023","008"
"39345","ALSENO",10,972,0,982,"2023","002"
"39346","ALSERIO",9,0,0,9,"2023","006"
"39347","ALTA VAL TIDONE",797,219,0,1016,"2023",NA
"39348","ALTA VALLE INTELVI",71,35,0,106,"2023",NA
"39349","ALTAVILLA MONFERRATO",164,0,0,164,"2023","007"
"39350","ALTAVILLA VICENTINA",146,0,0,146,"2023","004"
"39351","ALTISSIMO",11,34,0,45,"2023","005"
"39352","ALTIVOLE",12092,0,11,12103,"2023","001"
"39353","ALTO RENO TERME",115,0,0,115,"2023",NA
"39354","ALTO SERMENZA",1,12,0,13,"2023",NA
"39355","ALZANO LOMBARDO",24,33,0,57,"2023","008"
"39356","ALZANO SCRIVIA",4,0,0,4,"2023","008"
"39357","ALZATE BRIANZA",9,190,0,199,"2023","007"
"39358","AMBIVERE",1,0,0,1,"2023","009"
"39359","AMENO",28,8,11,47,"2023","002"
"39360","ANDALO VALTELLINO",30,0,0,30,"2023",NA
"39361","ANDEZENO",284,0,0,284,"2023","009"
"39362","ANDORNO MICCA",46,0,57,103,"2023","002"
"39363","ANDRATE",26,0,1,27,"2023","010"
"39364","ANFO",0,15,0,15,"2023","005"
"39365","ANGERA",75,138,22,235,"2023","003"
"39366","ANGOLO TERME",2,43,3,48,"2023","006"
"39367","ANGROGNA",109,0,31,140,"2023","011"
"39368","ANGUILLARA VENETA",10,0,0,10,"2023","004"
"39369","ANNICCO",0,980,0,980,"2023","003"
"39370","ANNONE DI BRIANZA",29,0,0,29,"2023","003"
"39371","ANNONE VENETO",12,0,1,13,"2023","001"
"39372","ANTEGNATE",783,1829,0,2612,"2023","010"
"39373","ANTIGNANO",47,0,0,47,"2023","003"
"39374","ANTRONA SCHIERANCO",2,0,0,2,"2023","001"
"39375","ANZANO DEL PARCO",4,86,3,93,"2023","009"
"39376","ANZOLA D'OSSOLA",2,233,0,235,"2023","002"
"39377","ANZOLA DELL'EMILIA",7,493,0,500,"2023","001"
"39378","APPIANO GENTILE",105,279,32,416,"2023","010"
"39379","APRICA",0,2,0,2,"2023","004"
"39380","ARAMENGO",408,0,0,408,"2023","004"
"39381","ARCADE",922,51,0,973,"2023","002"
"39382","ARCENE",1,468,0,469,"2023","011"
"39383","ARCISATE",113,992,0,1105,"2023","004"
"39384","ARCOLE",969,66,0,1035,"2023","004"
"39385","ARCONATE",21,81,0,102,"2023","007"
"39386","ARCORE",50,0,6,56,"2023",NA
"39387","ARCUGNANO",73,3,1,77,"2023","006"
"39388","ARDENNO",53,31,24,108,"2023","005"
"39389","ARDESIO",131,112,0,243,"2023","012"
"39390","ARENA PO",54,376,13,443,"2023","005"
"39391","ARESE",0,168,0,168,"2023","009"
"39392","ARGEGNO",8,0,0,8,"2023","011"
"39393","ARGELATO",100,74,0,174,"2023","002"
"39394","ARGENTA",1321,6,0,1327,"2023","001"
"39395","ARGUELLO",70,0,0,70,"2023","007"
"39396","ARIANO NEL POLESINE",795,145,0,940,"2023","002"
"39397","ARIGNANO",494,0,0,494,"2023","012"
"39398","ARLUNO",23,332,35,390,"2023","010"
"39399","ARMENO",95,84,0,179,"2023","006"
"39400","AROLA",1,0,5,6,"2023","004"
"39401","ARONA",1,0,0,1,"2023","008"
"39402","AROSIO",3,0,0,3,"2023","012"
"39403","ARQUA' PETRARCA",7,0,0,7,"2023","005"
"39404","ARQUA' POLESINE",809,0,0,809,"2023","003"
"39405","ARQUATA SCRIVIA",7,0,0,7,"2023","009"
"39406","ARRE",4,5,0,9,"2023","006"
"39407","ARSAGO SEPRIO",7,0,0,7,"2023","005"
"39408","ARSIE'",9,367,0,376,"2023","004"
"39409","ARSIERO",0,16,5,21,"2023","007"
"39410","ARTOGNE",10,275,35,320,"2023","007"
"39411","ARZAGO D'ADDA",240,1143,0,1383,"2023","013"
"39412","ARZERGRANDE",253,115,0,368,"2023","007"
"39413","ARZIGNANO",89,296,4,389,"2023","008"
"39414","ASIAGO",57,1152,30,1239,"2023","009"
"39415","ASIGLIANO VENETO",87,0,0,87,"2023","010"
"39416","ASIGLIANO VERCELLESE",11,0,0,11,"2023","007"
"39417","ASOLA",9722,2285,669,12676,"2023","002"
"39418","ASOLO",9932,553,77,10562,"2023","003"
"39419","ASSAGO",4,0,0,4,"2023","011"
"39420","ASSO",8,0,11,19,"2023","013"
"39421","ASTI",2757,0,0,2757,"2023","005"
"39422","AURANO",18,0,0,18,"2023","005"
"39423","AURONZO DI CADORE",30,14,0,44,"2023","005"
"39424","AVIATICO",0,15,0,15,"2023","015"
"39425","AVIGLIANA",160,71,7,238,"2023","013"
"39426","AVOLASCA",530,0,0,530,"2023","010"
"39427","AZEGLIO",93,10,63,166,"2023","014"
"39428","AZZANELLO",0,453,0,453,"2023","004"
"39429","AZZANO MELLA",81,986,0,1067,"2023","008"
"39430","AZZANO SAN PAOLO",19,204,0,223,"2023","016"
"39431","AZZATE",26,0,6,32,"2023","006"
"39432","AZZIO",8,142,0,150,"2023","007"
"39433","BACENO",6,26,0,32,"2023","006"
"39434","BADIA CALAVENA",1303,260,0,1563,"2023","005"
"39435","BADIA PAVESE",0,0,217,217,"2023","006"
"39436","BADIA POLESINE",145,0,0,145,"2023","004"
"39437","BAGNACAVALLO",37,0,0,37,"2023","002"
"39438","BAGNARIA",133,0,0,133,"2023","007"
"39439","BAGNASCO",60,0,0,60,"2023","008"
"39440","BAGNATICA",3,81,0,84,"2023","018"
"39441","BAGNO DI ROMAGNA",1636,15,0,1651,"2023","001"
"39442","BAGNOLI DI SOPRA",965,2,0,967,"2023","008"
"39443","BAGNOLO CREMASCO",3,1969,0,1972,"2023","005"
"39444","BAGNOLO IN PIANO",1,544,0,545,"2023","002"
"39445","BAGNOLO MELLA",666,3269,310,4245,"2023","009"
"39446","BAGNOLO PIEMONTE",684,0,102,786,"2023","009"
"39447","BAGNOLO SAN VITO",204,3107,585,3896,"2023","003"
"39448","BAGOLINO",20,228,7,255,"2023","010"
"39449","BAIRO",84,84,8,176,"2023","015"
"39450","BAISO",10,900,0,910,"2023","003"
"39451","BALANGERO",160,7,116,283,"2023","016"
"39452","BALDICHIERI D'ASTI",47,0,0,47,"2023","007"
"39453","BALDISSERO CANAVESE",0,75,0,75,"2023","017"
"39454","BALDISSERO D'ALBA",645,0,0,645,"2023","010"
"39455","BALDISSERO TORINESE",145,0,0,145,"2023","018"
"39456","BALLABIO",20,63,0,83,"2023","004"
"39457","BALME",7,0,0,7,"2023","019"
"39458","BALOCCO",77,0,55,132,"2023","009"
"39459","BANCHETTE",0,0,4,4,"2023","020"
"39460","BANNIO ANZINO",52,0,0,52,"2023","007"
"39461","BAONE",2,0,0,2,"2023","009"
"39462","BARBANIA",33,117,94,244,"2023","021"
"39463","BARBARANO MOSSANO",668,339,0,1007,"2023",NA
"39464","BARBARESCO",1,0,0,1,"2023","011"
"39465","BARBARIGA",1028,1636,64,2728,"2023","011"
"39466","BARBATA",1,793,0,794,"2023","019"
"39467","BARBIANELLO",166,2,0,168,"2023","008"
"39468","BARBONA",287,0,2,289,"2023","010"
"39469","BARDELLO CON MALGESSO E BREGANO",138,0,0,138,"2023",NA
"39470","BARDI",57,631,0,688,"2023","002"
"39471","BARDOLINO",22,86,0,108,"2023","006"
"39472","BARDONECCHIA",20,0,0,20,"2023","022"
"39473","BAREGGIO",9,127,0,136,"2023","012"
"39474","BARENGO",0,163,0,163,"2023","012"
"39475","BARGE",4605,1611,412,6628,"2023","012"
"39476","BARGHE",9,8,0,17,"2023","012"
"39477","BARIANO",9,335,0,344,"2023","020"
"39478","BARNI",3,5,0,8,"2023","015"
"39479","BAROLO",18,0,0,18,"2023","013"
"39480","BARONE CANAVESE",3,28,0,31,"2023","023"
"39481","BARZAGO",157,0,0,157,"2023","005"
"39482","BARZANO'",2,0,7,9,"2023","006"
"39483","BARZIO",38,54,37,129,"2023","007"
"39484","BASALUZZO",375,0,0,375,"2023","012"
"39485","BASCAPE'",29,987,0,1016,"2023","009"
"39486","BASIGLIO",0,77,0,77,"2023","015"
"39487","BASSANO BRESCIANO",4,114,0,118,"2023","013"
"39488","BASSANO DEL GRAPPA",193,116,2,311,"2023","012"
"39489","BASSIGNANA",2,0,0,2,"2023","013"
"39490","BASTIA MONDOVI'",751,0,5,756,"2023","014"
"39491","BASTIGLIA",107,0,0,107,"2023","001"
"39492","BATTAGLIA TERME",4,0,0,4,"2023","011"
"39493","BEDERO VALCUVIA",17,0,0,17,"2023","010"
"39494","BEDIZZOLE",4112,1330,60,5502,"2023","014"
"39495","BEDONIA",341,59,0,400,"2023","003"
"39496","BEDULITA",7,0,0,7,"2023","022"
"39497","BEE",4,0,0,4,"2023","009"
"39498","BEINETTE",734,321,0,1055,"2023","016"
"39499","BELFIORE",2794,0,0,2794,"2023","007"
"39500","BELGIOIOSO",0,118,0,118,"2023","013"
"39501","BELLAGIO",7,73,35,115,"2023","019"
"39502","BELLANO",13,1,4,18,"2023","008"
"39503","BELLARIA-IGEA MARINA",4,0,0,4,"2023","001"
"39504","BELLINO",75,0,0,75,"2023","017"
"39505","BELLINZAGO LOMBARDO",505,1269,60,1834,"2023","016"
"39506","BELLINZAGO NOVARESE",478,730,0,1208,"2023","016"
"39507","BELLUNO",271,250,145,666,"2023","006"
"39508","BELVEDERE LANGHE",69,0,85,154,"2023","018"
"39509","BEMA",0,3,0,3,"2023","006"
"39510","BENE LARIO",1,0,53,54,"2023","021"
"39511","BENE VAGIENNA",1686,513,0,2199,"2023","019"
"39512","BENEVELLO",63,0,0,63,"2023","020"
"39513","BENNA",8,26,43,77,"2023","003"
"39514","BENTIVOGLIO",10,88,0,98,"2023","005"
"39515","BERBENNO",23,36,0,59,"2023","023"
"39516","BERBENNO DI VALTELLINA",45,147,0,192,"2023","007"
"39517","BERCETO",56,343,0,399,"2023","004"
"39518","BEREGAZZO CON FIGLIARO",4,0,0,4,"2023","022"
"39519","BEREGUARDO",14,457,114,585,"2023","014"
"39520","BERGAMASCO",36,0,0,36,"2023","015"
"39521","BERGAMO",187,79,0,266,"2023","024"
"39522","BERLINGO",2484,244,21,2749,"2023","015"
"39523","BERNAREGGIO",1,10,0,11,"2023",NA
"39524","BERNATE TICINO",46,123,3,172,"2023","019"
"39525","BERNEZZO",322,31,0,353,"2023","022"
"39526","BERTINORO",53,5,0,58,"2023","003"
"39527","BERTONICO",0,2532,0,2532,"2023","002"
"39528","BERZANO DI SAN PIETRO",15,0,0,15,"2023","009"
"39529","BERZO DEMO",6,57,4,67,"2023","016"
"39530","BERZO INFERIORE",19,163,0,182,"2023","017"
"39531","BERZO SAN FERMO",777,83,0,860,"2023","025"
"39532","BESANA IN BRIANZA",904,48,9,961,"2023",NA
"39533","BESANO",20,0,38,58,"2023","011"
"39534","BESATE",126,0,0,126,"2023","022"
"39535","BESENZONE",177,2012,0,2189,"2023","003"
"39536","BESNATE",23,135,0,158,"2023","012"
"39537","BESOZZO",15,54,0,69,"2023","013"
"39538","BETTOLA",537,49,0,586,"2023","004"
"39539","BEURA-CARDEZZA",34,2,10,46,"2023","011"
"39540","BEVILACQUA",72,26,0,98,"2023","008"
"39541","BIANDRONNO",43,0,0,43,"2023","014"
"39542","BIANZANO",7,1,0,8,"2023","026"
"39543","BIANZE'",84,414,0,498,"2023","011"
"39544","BIANZONE",2,9,0,11,"2023","008"
"39545","BIASSONO",16,0,0,16,"2023",NA
"39546","BIBBIANO",43,2512,0,2555,"2023","004"
"39547","BIBIANA",390,0,15,405,"2023","025"
"39548","BIELLA",293,81,127,501,"2023","004"
"39549","BIENNO",13,157,8,178,"2023","018"
"39550","BINAGO",38,174,1,213,"2023","023"
"39551","BIOGLIO",20,0,2,22,"2023","005"
"39552","BIONE",11,6,1,18,"2023","019"
"39553","BISTAGNO",17,0,0,17,"2023","017"
"39554","BISUSCHIO",2,0,0,2,"2023","015"
"39555","BIZZARONE",0,15,6,21,"2023","024"
"39556","BLELLO",0,55,0,55,"2023","027"
"39557","BLESSAGNO",1,0,3,4,"2023","025"
"39558","BOBBIO",331,40,0,371,"2023","005"
"39559","BOBBIO PELLICE",60,30,108,198,"2023","026"
"39560","BOCCIOLETO",1,7,0,8,"2023","014"
"39561","BOFFALORA D'ADDA",0,192,0,192,"2023","003"
"39562","BOFFALORA SOPRA TICINO",73,93,39,205,"2023","026"
"39563","BOGOGNO",1,0,0,1,"2023",NA
"39564","BOLGARE",72,202,0,274,"2023","028"
"39565","BOLLATE",21,230,0,251,"2023","027"
"39566","BOLLENGO",27,5,53,85,"2023","027"
"39567","BOLOGNA",10,0,0,10,"2023","006"
"39568","BOLTIERE",20,10,0,30,"2023","029"
"39569","BOLZANO NOVARESE",0,6,0,6,"2023","022"
"39570","BOLZANO VICENTINO",138,1183,0,1321,"2023","013"
"39571","BOMPORTO",49,111,0,160,"2023","002"
"39572","BONATE SOPRA",254,0,0,254,"2023","030"
"39573","BONATE SOTTO",69,0,0,69,"2023","031"
"39574","BONAVIGO",3599,23,19,3641,"2023","009"
"39575","BONDENO",232,360,0,592,"2023","003"
"39576","BONEMERSE",21,193,0,214,"2023","006"
"39577","BORDOLANO",33,612,0,645,"2023","007"
"39578","BORE",90,0,0,90,"2023","005"
"39579","BORETTO",0,199,0,199,"2023","005"
"39580","BORGARO TORINESE",136,34,0,170,"2023","028"
"39581","BORGHETTO DI BORBERA",131,0,0,131,"2023","018"
"39582","BORGHETTO LODIGIANO",21,1584,49,1654,"2023","004"
"39583","BORGHI",33,0,0,33,"2023","004"
"39584","BORGIALLO",5,34,0,39,"2023","029"
"39585","BORGO D'ALE",297,0,0,297,"2023","015"
"39586","BORGO DI TERZO",2,0,0,2,"2023","032"
"39587","BORGO MANTOVANO",11,1118,5,1134,"2023",NA
"39588","BORGO PRIOLO",9,0,0,9,"2023","016"
"39589","BORGO SAN DALMAZZO",365,0,79,444,"2023","025"
"39590","BORGO SAN GIACOMO",612,3259,150,4021,"2023","020"
"39591","BORGO SAN GIOVANNI",13,1063,0,1076,"2023","005"
"39592","BORGO SAN SIRO",1,1024,0,1025,"2023","018"
"39593","BORGO TICINO",24,0,0,24,"2023","025"
"39594","BORGO TOSSIGNANO",14,0,0,14,"2023","007"
"39595","BORGO VAL DI TARO",142,204,0,346,"2023","006"
"39596","BORGO VALBELLUNA",153,720,29,902,"2023",NA
"39597","BORGO VENETO",1656,34,0,1690,"2023",NA
"39598","BORGO VERCELLI",4,0,0,4,"2023","017"
"39599","BORGO VIRGILIO",112,4508,2247,6867,"2023",NA
"39600","BORGOCARBONARA",0,648,67,715,"2023",NA
"39601","BORGOFRANCO D'IVREA",172,3,12,187,"2023","030"
"39602","BORGOMALE",21,0,0,21,"2023","024"
"39603","BORGOMANERO",85,14,1,100,"2023","024"
"39604","BORGOMASINO",91,0,14,105,"2023","031"
"39605","BORGOMEZZAVALLE",3,0,0,3,"2023",NA
"39606","BORGONE SUSA",23,48,0,71,"2023","032"
"39607","BORGONOVO VAL TIDONE",818,1869,0,2687,"2023","006"
"39608","BORGORATTO ALESSANDRINO",57,0,0,57,"2023","019"
"39609","BORGORATTO MORMOROLO",4,0,0,4,"2023","017"
"39610","BORGORICCO",40,0,3,43,"2023","013"
"39611","BORGOSATOLLO",244,418,48,710,"2023","021"
"39612","BORGOSESIA",20,78,0,98,"2023","016"
"39613","BORMIO",35,352,0,387,"2023","009"
"39614","BORNASCO",311,467,6,784,"2023","019"
"39615","BORNO",7,113,48,168,"2023","022"
"39616","BORRIANA",253,36,0,289,"2023","006"
"39617","BORSO DEL GRAPPA",103,201,31,335,"2023","004"
"39618","BOSCHI SANT'ANNA",63,0,0,63,"2023","010"
"39619","BOSCO CHIESANUOVA",50,1249,23,1322,"2023","011"
"39620","BOSCO MARENGO",127,31,0,158,"2023","021"
"39621","BOSCONERO",48,30,19,97,"2023","033"
"39622","BOSIA",398,0,0,398,"2023","026"
"39623","BOSIO",17,0,3,20,"2023","022"
"39624","BOSISIO PARINI",0,143,0,143,"2023","009"
"39625","BOSSICO",43,52,0,95,"2023","033"
"39626","BOSSOLASCO",34,60,0,94,"2023","027"
"39627","BOTTANUCO",107,914,0,1021,"2023","034"
"39628","BOTTICINO",40,0,0,40,"2023","023"
"39629","BOVEGNO",75,109,6,190,"2023","024"
"39630","BOVES",686,687,113,1486,"2023","028"
"39631","BOVOLENTA",4535,197,0,4732,"2023","014"
"39632","BOVOLONE",3433,376,0,3809,"2023","012"
"39633","BOZZOLO",45,1270,21,1336,"2023","007"
"39634","BRA",3251,1681,92,5024,"2023","029"
"39635","BRACCA",4,0,0,4,"2023","035"
"39636","BRALLO DI PREGOLA",28,0,0,28,"2023","021"
"39637","BRANDICO",0,909,0,909,"2023","026"
"39638","BRANDIZZO",0,0,80,80,"2023","034"
"39639","BRANZI",3,39,0,42,"2023","036"
"39640","BRAONE",0,26,2,28,"2023","027"
"39641","BREBBIA",3,27,0,30,"2023","017"
"39642","BREDA DI PIAVE",69,399,4,472,"2023","005"
"39643","BREGANZE",492,523,13,1028,"2023","014"
"39644","BREGNANO",15,84,0,99,"2023","028"
"39645","BREMBATE",38,182,0,220,"2023","037"
"39646","BREMBATE DI SOPRA",0,268,0,268,"2023","038"
"39647","BREMBIO",69,2625,0,2694,"2023","006"
"39648","BREME",98,0,0,98,"2023","022"
"39649","BRENDOLA",329,99,0,428,"2023","015"
"39650","BRENNA",4,0,0,4,"2023","029"
"39651","BRENO",12,237,6,255,"2023","028"
"39652","BRENTA",4,0,0,4,"2023","019"
"39653","BRENZONE",10,0,3,13,"2023","014"
"39654","BRESCELLO",1,8,0,9,"2023","006"
"39655","BRESCIA",15,527,0,542,"2023","029"
"39656","BRESSANA BOTTARONE",197,0,0,197,"2023","023"
"39657","BRESSANVIDO",18,1631,18,1667,"2023","016"
"39658","BRESSO",13,0,0,13,"2023",NA
"39659","BREZZO DI BEDERO",0,3,0,3,"2023","020"
"39660","BRIAGLIA",40,0,0,40,"2023","030"
"39661","BRICHERASIO",569,67,10,646,"2023","035"
"39662","BRIGA NOVARESE",0,97,0,97,"2023","026"
"39663","BRIGNANO GERA D'ADDA",217,1823,0,2040,"2023","040"
"39664","BRIGNANO-FRASCATA",1,0,0,1,"2023","024"
"39665","BRINZIO",5,0,0,5,"2023","021"
"39666","BRIONA",14,737,0,751,"2023","027"
"39667","BRIONE",10,0,0,10,"2023","030"
"39668","BRIOSCO",13,0,0,13,"2023",NA
"39669","BRISIGHELLA",409,66,0,475,"2023","004"
"39670","BRISSAGO-VALTRAVAGLIA",10,0,0,10,"2023","022"
"39671","BRIVIO",12,0,1,13,"2023","010"
"39672","BROGLIANO",17,36,0,53,"2023","017"
"39673","BRONDELLO",4,0,0,4,"2023","032"
"39674","BRONI",51,0,0,51,"2023","024"
"39675","BROSSASCO",29,0,0,29,"2023","033"
"39676","BROSSO",35,14,8,57,"2023","036"
"39677","BROVELLO-CARPUGNINO",14,0,2,16,"2023","013"
"39678","BROZOLO",26,0,0,26,"2023","037"
"39679","BRUGHERIO",7,163,6,176,"2023",NA
"39680","BRUGINE",3223,73,0,3296,"2023","015"
"39681","BRUINO",67,0,0,67,"2023","038"
"39682","BRUMANO",22,22,0,44,"2023","041"
"39683","BRUNELLO",5,0,0,5,"2023","023"
"39684","BRUNO",17,0,0,17,"2023","010"
"39685","BRUSAPORTO",76,22,0,98,"2023","042"
"39686","BRUSASCO",164,0,0,164,"2023","039"
"39687","BRUSNENGO",21,0,0,21,"2023","007"
"39688","BRUZOLO",28,49,44,121,"2023","040"
"39689","BUBBIANO",0,16,0,16,"2023","035"
"39690","BUBBIO",79,0,0,79,"2023","011"
"39691","BUCCINASCO",31,514,0,545,"2023","036"
"39692","BUDRIO",127,210,0,337,"2023","008"
"39693","BUGLIO IN MONTE",33,151,0,184,"2023","010"
"39694","BULCIAGO",0,114,14,128,"2023","011"
"39695","BULGAROGRASSO",38,222,0,260,"2023","034"
"39696","BURIASCO",1217,724,146,2087,"2023","041"
"39697","BUROLO",16,0,0,16,"2023","042"
"39698","BURONZO",7,13,0,20,"2023","021"
"39699","BUSANO",57,35,0,92,"2023","043"
"39700","BUSCA",4253,1560,421,6234,"2023","034"
"39701","BUSCATE",24,0,0,24,"2023","038"
"39702","BUSNAGO",23,8,0,31,"2023",NA
"39703","BUSSERO",0,386,0,386,"2023","040"
"39704","BUSSETO",36,3705,0,3741,"2023","007"
"39705","BUSSOLENGO",533,57,75,665,"2023","015"
"39706","BUSSOLENO",35,121,45,201,"2023","044"
"39707","BUSTO ARSIZIO",8,211,15,234,"2023","026"
"39708","BUSTO GAROLFO",29,250,0,279,"2023","041"
"39709","BUTTAPIETRA",237,48,0,285,"2023","016"
"39710","BUTTIGLIERA ALTA",61,32,0,93,"2023","045"
"39711","BUTTIGLIERA D'ASTI",2596,74,60,2730,"2023","012"
"39712","CABELLA LIGURE",141,0,0,141,"2023","025"
"39713","CADEGLIANO-VICONAGO",4,0,0,4,"2023","027"
"39714","CADELBOSCO DI SOPRA",37,1479,0,1516,"2023","008"
"39715","CADEO",123,2777,0,2900,"2023","007"
"39716","CADONEGHE",7,0,0,7,"2023","016"
"39717","CADORAGO",4,52,0,56,"2023","036"
"39718","CADREZZATE CON OSMATE",41,0,0,41,"2023",NA
"39719","CAERANO DI SAN MARCO",130,50,0,180,"2023","006"
"39720","CAFASSE",128,29,1,158,"2023","046"
"39721","CAGLIO",45,0,25,70,"2023","037"
"39722","CAINO",5,0,0,5,"2023","031"
"39723","CAIOLO",2,101,0,103,"2023","011"
"39724","CAIRATE",2,0,0,2,"2023","029"
"39725","CALALZO DI CADORE",1,0,0,1,"2023",NA
"39726","CALAMANDRANA",87,0,0,87,"2023","013"
"39727","CALASCA-CASTIGLIONE",15,0,0,15,"2023","014"
"39728","CALCINATE",347,245,0,592,"2023","043"
"39729","CALCINATO",5084,2256,371,7711,"2023","032"
"39730","CALCIO",199,1532,0,1731,"2023","044"
"39731","CALCO",15,212,0,227,"2023","012"
"39732","CALDERARA DI RENO",26,39,0,65,"2023","009"
"39733","CALDOGNO",49,295,88,432,"2023","018"
"39734","CALENDASCO",199,367,0,566,"2023","008"
"39735","CALESTANO",72,321,0,393,"2023","008"
"39736","CALLABIANA",63,0,0,63,"2023","008"
"39737","CALLIANO",265,0,0,265,"2023","014"
"39738","CALOLZIOCORTE",2,0,9,11,"2023","013"
"39739","CALOSSO",3,0,0,3,"2023","015"
"39740","CALTIGNAGA",1082,126,0,1208,"2023","030"
"39741","CALTO",33,0,0,33,"2023","008"
"39742","CALTRANO",1677,0,0,1677,"2023","019"
"39743","CALUSCO D'ADDA",15,0,0,15,"2023","046"
"39744","CALUSO",826,143,0,969,"2023","047"
"39745","CALVAGESE DELLA RIVIERA",4,189,0,193,"2023","033"
"39746","CALVATONE",0,123,0,123,"2023","009"
"39747","CALVENE",9,38,0,47,"2023","020"
"39748","CALVENZANO",17,557,0,574,"2023","047"
"39749","CALVIGNASCO",1,0,0,1,"2023","042"
"39750","CALVISANO",12934,4481,223,17638,"2023","034"
"39751","CAMAGNA MONFERRATO",52,0,0,52,"2023","026"
"39752","CAMANDONA",32,0,0,32,"2023","009"
"39753","CAMBIAGO",41,95,0,136,"2023","044"
"39754","CAMBIANO",207,0,0,207,"2023","048"
"39755","CAMBIASCA",8,0,0,8,"2023","015"
"39756","CAMBURZANO",212,0,34,246,"2023","010"
"39757","CAMERANA",240,0,0,240,"2023","035"
"39758","CAMERANO CASASCO",18,0,0,18,"2023","016"
"39759","CAMERATA CORNELLO",4,80,0,84,"2023","048"
"39760","CAMERI",51,700,0,751,"2023","032"
"39761","CAMISANO",207,2812,0,3019,"2023","010"
"39762","CAMISANO VICENTINO",80,1242,337,1659,"2023","021"
"39763","CAMPAGNA LUPIA",42,94,0,136,"2023","002"
"39764","CAMPAGNOLA CREMASCA",12,714,76,802,"2023","011"
"39765","CAMPAGNOLA EMILIA",1,530,0,531,"2023","009"
"39766","CAMPEGINE",0,1233,0,1233,"2023","010"
"39767","CAMPERTOGNO",0,59,0,59,"2023","025"
"39768","CAMPIGLIA CERVO",8,5,0,13,"2023","011"
"39769","CAMPIGLIA DEI BERICI",523,108,0,631,"2023","022"
"39770","CAMPIGLIONE-FENILE",506,0,19,525,"2023","049"
"39771","CAMPO SAN MARTINO",466,81,0,547,"2023","020"
"39772","CAMPODARSEGO",864,43,2,909,"2023","017"
"39773","CAMPODORO",64,111,0,175,"2023","018"
"39774","CAMPOGALLIANO",1,260,0,261,"2023","003"
"39775","CAMPOLONGO MAGGIORE",28,3,0,31,"2023","003"
"39776","CAMPONOGARA",141,27,0,168,"2023","004"
"39777","CAMPOSAMPIERO",386,77,0,463,"2023","019"
"39778","CAMPOSANTO",3,0,0,3,"2023",NA
"39779","CAMUGNANO",517,64,0,581,"2023","010"
"39780","CANALE",727,0,0,727,"2023","037"
"39781","CANALE D'AGORDO",7,0,0,7,"2023",NA
"39782","CANARO",493,0,0,493,"2023","009"
"39783","CANDELO",347,41,110,498,"2023","012"
"39784","CANDIA CANAVESE",30,0,0,30,"2023","050"
"39785","CANDIANA",11778,198,0,11976,"2023","021"
"39786","CANDIOLO",153,692,53,898,"2023","051"
"39787","CANELLI",10,0,0,10,"2023","017"
"39788","CANISCHIO",40,0,0,40,"2023","052"
"39789","CANNETO SULL'OGLIO",1505,2393,953,4851,"2023","008"
"39790","CANNOBIO",4,4,0,8,"2023","017"
"39791","CANONICA D'ADDA",32,433,0,465,"2023","049"
"39792","CANOSIO",11,0,0,11,"2023","038"
"39793","CANOSSA",97,214,0,311,"2023","018"
"39794","CANTALUPA",35,0,0,35,"2023","053"
"39795","CANTARANA",107,0,0,107,"2023","018"
"39796","CANTELLO",134,115,0,249,"2023","030"
"39797","CANTOIRA",89,3,18,110,"2023","054"
"39798","CANTU'",202,256,6,464,"2023","041"
"39799","CANZO",0,0,26,26,"2023","042"
"39800","CAORLE",490,69,0,559,"2023","005"
"39801","CAORSO",3,531,0,534,"2023","010"
"39802","CAPERGNANICA",398,1063,0,1461,"2023","012"
"39803","CAPIAGO INTIMIANO",0,9,5,14,"2023","043"
"39804","CAPIZZONE",34,16,0,50,"2023","050"
"39805","CAPO DI PONTE",85,174,7,266,"2023","035"
"39806","CAPONAGO",103,0,0,103,"2023",NA
"39807","CAPOVALLE",9,27,1,37,"2023","036"
"39808","CAPPELLA CANTONE",0,320,94,414,"2023","013"
"39809","CAPPELLA DE' PICENARDI",7,405,0,412,"2023","014"
"39810","CAPPELLA MAGGIORE",12,7,0,19,"2023","007"
"39811","CAPRALBA",1,1265,0,1266,"2023","015"
"39812","CAPRIANO DEL COLLE",4,384,0,388,"2023","037"
"39813","CAPRIATA D'ORBA",21,0,0,21,"2023","029"
"39814","CAPRIE",30,0,0,30,"2023","055"
"39815","CAPRIGLIO",5,0,0,5,"2023","019"
"39816","CAPRILE",106,0,0,106,"2023","013"
"39817","CAPRINO BERGAMASCO",16,0,0,16,"2023","052"
"39818","CAPRINO VERONESE",112,520,35,667,"2023","018"
"39819","CAPRIOLO",307,0,41,348,"2023","038"
"39820","CARAGLIO",2795,609,602,4006,"2023","040"
"39821","CARAMAGNA PIEMONTE",1936,665,0,2601,"2023","041"
"39822","CARATE URIO",0,0,3,3,"2023","044"
"39823","CARAVAGGIO",104,2554,0,2658,"2023","053"
"39824","CARAVATE",0,113,0,113,"2023","031"
"39825","CARBONARA AL TICINO",0,418,0,418,"2023","030"
"39826","CARBONARA SCRIVIA",50,0,0,50,"2023","030"
"39827","CARBONATE",77,46,9,132,"2023","045"
"39828","CARBONERA",174,177,0,351,"2023","008"
"39829","CARCERI",1628,0,0,1628,"2023","022"
"39830","CARCOFORO",1,0,4,5,"2023","029"
"39831","CARDE'",2649,1886,23,4558,"2023","042"
"39832","CAREMA",60,0,12,72,"2023","057"
"39833","CARENNO",19,0,10,29,"2023","014"
"39834","CARENTINO",56,636,0,692,"2023","031"
"39835","CARESANA",5,0,0,5,"2023","030"
"39836","CAREZZANO",5,0,0,5,"2023","032"
"39837","CARIGNANO",2585,1513,280,4378,"2023","058"
"39838","CARISIO",15,0,0,15,"2023","032"
"39839","CARLAZZO",27,33,3,63,"2023","047"
"39840","CARMAGNOLA",6076,2963,278,9317,"2023","059"
"39841","CARMIGNANO DI BRENTA",68,1447,0,1515,"2023","023"
"39842","CARNAGO",18,62,0,80,"2023","033"
"39843","CAROBBIO DEGLI ANGELI",100,24,0,124,"2023","055"
"39844","CARONNO PERTUSELLA",5,0,0,5,"2023","034"
"39845","CARONNO VARESINO",30,0,0,30,"2023","035"
"39846","CARPANETO PIACENTINO",52,4421,0,4473,"2023","011"
"39847","CARPENEDOLO",1207,4165,477,5849,"2023","039"
"39848","CARPENETO",118,0,0,118,"2023","033"
"39849","CARPI",7,1934,0,1941,"2023","005"
"39850","CARPIANO",188,1206,0,1394,"2023","050"
"39851","CARPIGNANO SESIA",91,0,0,91,"2023","036"
"39852","CARPINETI",80,1272,0,1352,"2023","011"
"39853","CARRE'",383,117,0,500,"2023","024"
"39854","CARREGA LIGURE",123,0,0,123,"2023","034"
"39855","CARRU'",707,52,81,840,"2023","043"
"39856","CARTIGLIANO",23,9,0,32,"2023","025"
"39857","CARTIGNANO",187,80,0,267,"2023","044"
"39858","CARTOSIO",119,0,0,119,"2023","036"
"39859","CARTURA",385,0,0,385,"2023","026"
"39860","CARUGATE",26,108,0,134,"2023","051"
"39861","CARUGO",4,0,0,4,"2023","048"
"39862","CARVICO",1,0,0,1,"2023","057"
"39863","CASAL CERMELLI",2,0,0,2,"2023","037"
"39864","CASALBELTRAME",0,0,152,152,"2023","037"
"39865","CASALBORGONE",36,0,0,36,"2023","060"
"39866","CASALBUTTANO ED UNITI",0,1840,0,1840,"2023","016"
"39867","CASALE CORTE CERRO",13,0,4,17,"2023","019"
"39868","CASALE CREMASCO-VIDOLASCO",1,1848,0,1849,"2023","017"
"39869","CASALE DI SCODOSIA",503,0,0,503,"2023","027"
"39870","CASALE LITTA",58,110,0,168,"2023","036"
"39871","CASALE MONFERRATO",141,189,18,348,"2023","039"
"39872","CASALE SUL SILE",723,27,60,810,"2023","009"
"39873","CASALEGGIO BOIRO",19,0,0,19,"2023","038"
"39874","CASALEONE",6,0,0,6,"2023","019"
"39875","CASALETTO CEREDANO",20,3,0,23,"2023","018"
"39876","CASALETTO DI SOPRA",12,346,0,358,"2023","019"
"39877","CASALETTO LODIGIANO",22,522,0,544,"2023","008"
"39878","CASALETTO VAPRIO",100,804,32,936,"2023","020"
"39879","CASALFIUMANESE",588,82,0,670,"2023","012"
"39880","CASALGRANDE",50,1123,0,1173,"2023","012"
"39881","CASALGRASSO",291,221,117,629,"2023","045"
"39882","CASALINO",2,110,0,112,"2023","040"
"39883","CASALMAGGIORE",2,661,0,663,"2023","021"
"39884","CASALMAIOCCO",37,520,0,557,"2023","009"
"39885","CASALMORANO",99,2471,0,2570,"2023","022"
"39886","CASALMORO",428,188,268,884,"2023","010"
"39887","CASALNOCETO",30,0,0,30,"2023","040"
"39888","CASALOLDO",822,1646,382,2850,"2023","011"
"39889","CASALPUSTERLENGO",3806,995,0,4801,"2023","010"
"39890","CASALROMANO",261,240,179,680,"2023","012"
"39891","CASALSERUGO",89,0,0,89,"2023","028"
"39892","CASALVOLONE",3,39,0,42,"2023","041"
"39893","CASALZUIGNO",4,90,8,102,"2023","037"
"39894","CASARGO",12,14,2,28,"2023","015"
"39895","CASARILE",129,0,0,129,"2023","055"
"39896","CASATENOVO",440,0,2,442,"2023","016"
"39897","CASAZZA",9,0,7,16,"2023","058"
"39898","CASCIAGO",20,18,0,38,"2023","038"
"39899","CASEI GEROLA",551,0,0,551,"2023","033"
"39900","CASELETTE",100,288,42,430,"2023","062"
"39901","CASELLE LANDI",259,417,24,700,"2023","011"
"39902","CASELLE LURANI",65,470,0,535,"2023","012"
"39903","CASELLE TORINESE",225,1183,65,1473,"2023","063"
"39904","CASIER",9,50,0,59,"2023","010"
"39905","CASINA",73,782,0,855,"2023","013"
"39906","CASIRATE D'ADDA",112,318,0,430,"2023","059"
"39907","CASLINO D'ERBA",10,0,5,15,"2023","052"
"39908","CASNIGO",40,115,0,155,"2023","060"
"39909","CASOLA VALSENIO",283,21,0,304,"2023","005"
"39910","CASORATE PRIMO",29,141,0,170,"2023","034"
"39911","CASOREZZO",0,246,0,246,"2023","058"
"39912","CASORZO",12,0,0,12,"2023","020"
"39913","CASPOGGIO",1,45,0,46,"2023","013"
"39914","CASSAGO BRIANZA",0,60,10,70,"2023","017"
"39915","CASSANO D'ADDA",209,272,0,481,"2023","059"
"39916","CASSANO MAGNAGO",59,65,0,124,"2023","040"
"39917","CASSANO SPINOLA",219,0,0,219,"2023","042"
"39918","CASSANO VALCUVIA",1,0,0,1,"2023","041"
"39919","CASSINA DE' PECCHI",0,247,0,247,"2023","060"
"39920","CASSINA VALSASSINA",13,27,3,43,"2023","018"
"39921","CASSINASCO",27,0,19,46,"2023","021"
"39922","CASSINE",410,0,0,410,"2023","043"
"39923","CASSINELLE",3,0,0,3,"2023","044"
"39924","CASSINETTA DI LUGAGNANO",0,203,0,203,"2023","061"
"39925","CASSOLA",263,23,0,286,"2023","026"
"39926","CASSOLNOVO",34,0,0,34,"2023","035"
"39927","CASTAGNARO",251,0,0,251,"2023","020"
"39928","CASTAGNETO PO",28,0,0,28,"2023","064"
"39929","CASTAGNITO",98,0,0,98,"2023","046"
"39930","CASTAGNOLE DELLE LANZE",259,0,0,259,"2023","022"
"39931","CASTAGNOLE MONFERRATO",86,0,0,86,"2023","023"
"39932","CASTAGNOLE PIEMONTE",1220,697,65,1982,"2023","065"
"39933","CASTANA",3,0,0,3,"2023","036"
"39934","CASTANO PRIMO",144,0,0,144,"2023","062"
"39935","CASTEGGIO",850,0,0,850,"2023","037"
"39936","CASTEGNATO",54,1091,0,1145,"2023","040"
"39937","CASTEGNERO",28,26,0,54,"2023","027"
"39938","CASTEL BOGLIONE",3,0,0,3,"2023","024"
"39939","CASTEL BOLOGNESE",33,0,0,33,"2023","006"
"39940","CASTEL D'AIANO",104,704,0,808,"2023","013"
"39941","CASTEL D'ARIO",829,17,269,1115,"2023","014"
"39942","CASTEL D'AZZANO",1801,117,0,1918,"2023","021"
"39943","CASTEL DEL RIO",84,0,0,84,"2023","014"
"39944","CASTEL DI CASIO",68,10,0,78,"2023","015"
"39945","CASTEL GABBIANO",0,1755,0,1755,"2023","024"
"39946","CASTEL GOFFREDO",1959,335,515,2809,"2023","015"
"39947","CASTEL GUELFO DI BOLOGNA",134,259,0,393,"2023","016"
"39948","CASTEL MELLA",6,365,0,371,"2023","042"
"39949","CASTEL ROZZONE",0,27,0,27,"2023","063"
"39950","CASTEL SAN GIOVANNI",40,640,0,680,"2023","013"
"39951","CASTEL SAN PIETRO TERME",960,321,0,1281,"2023","020"
"39952","CASTELBELFORTE",1575,0,0,1575,"2023","013"
"39953","CASTELCOVATI",4,350,2,356,"2023","041"
"39954","CASTELCUCCO",49,197,36,282,"2023","011"
"39955","CASTELDELCI",413,0,0,413,"2023","021"
"39956","CASTELDELFINO",78,0,0,78,"2023","047"
"39957","CASTELDIDONE",87,0,0,87,"2023","023"
"39958","CASTELFRANCO EMILIA",2077,2814,0,4891,"2023","006"
"39959","CASTELFRANCO VENETO",5142,152,0,5294,"2023","012"
"39960","CASTELGERUNDO",67,1837,0,1904,"2023",NA
"39961","CASTELGOMBERTO",140,413,7,560,"2023","028"
"39962","CASTELGUGLIELMO",586,0,0,586,"2023","011"
"39963","CASTELL'ALFERO",529,0,0,529,"2023","025"
"39964","CASTELL'ARQUATO",128,744,0,872,"2023","012"
"39965","CASTELLAMONTE",375,206,65,646,"2023","066"
"39966","CASTELLARANO",32,261,0,293,"2023","014"
"39967","CASTELLAZZO BORMIDA",238,161,0,399,"2023","047"
"39968","CASTELLEONE",762,4579,0,5341,"2023","025"
"39969","CASTELLERO",3,0,0,3,"2023","026"
"39970","CASTELLETTO CERVO",76,29,0,105,"2023","015"
"39971","CASTELLETTO D'ORBA",10,0,0,10,"2023","049"
"39972","CASTELLETTO MERLI",45,0,0,45,"2023","050"
"39973","CASTELLETTO MONFERRATO",173,0,0,173,"2023","051"
"39974","CASTELLETTO SOPRA TICINO",61,35,35,131,"2023","043"
"39975","CASTELLETTO STURA",1682,57,90,1829,"2023","049"
"39976","CASTELLETTO UZZONE",14,0,0,14,"2023","050"
"39977","CASTELLI CALEPIO",8,215,0,223,"2023","062"
"39978","CASTELLINALDO D'ALBA",879,0,0,879,"2023",NA
"39979","CASTELLINO TANARO",143,0,0,143,"2023","052"
"39980","CASTELLO CABIAGLIO",5,15,0,20,"2023","043"
"39981","CASTELLO D'AGOGNA",28,0,0,28,"2023",NA
"39982","CASTELLO D'ARGILE",75,0,0,75,"2023","017"
"39983","CASTELLO DELL'ACQUA",19,14,0,33,"2023","014"
"39984","CASTELLO DI ANNONE",208,0,0,208,"2023","028"
"39985","CASTELLO DI BRIANZA",5,0,19,24,"2023","019"
"39986","CASTELLO DI GODEGO",5469,145,0,5614,"2023","013"
"39987","CASTELLUCCHIO",732,2703,570,4005,"2023","016"
"39988","CASTELMAGNO",2,43,1,46,"2023","053"
"39989","CASTELMARTE",20,0,0,20,"2023","058"
"39990","CASTELMASSA",564,87,0,651,"2023","012"
"39991","CASTELNOVO BARIANO",1559,0,0,1559,"2023","013"
"39992","CASTELNOVO DI SOTTO",9,1111,0,1120,"2023","015"
"39993","CASTELNOVO NE' MONTI",48,1483,0,1531,"2023","016"
"39994","CASTELNUOVO BOCCA D'ADDA",2253,323,0,2576,"2023","013"
"39995","CASTELNUOVO BORMIDA",28,0,0,28,"2023","052"
"39996","CASTELNUOVO BOZZENTE",4,3,0,7,"2023","059"
"39997","CASTELNUOVO CALCEA",10,0,0,10,"2023","030"
"39998","CASTELNUOVO DEL GARDA",3110,210,9,3329,"2023","022"
"39999","CASTELNUOVO DON BOSCO",241,0,0,241,"2023","031"
"40000","CASTELNUOVO NIGRA",47,0,0,47,"2023","067"
"40001","CASTELNUOVO RANGONE",0,1027,0,1027,"2023","007"
"40002","CASTELNUOVO SCRIVIA",71,0,0,71,"2023","053"
"40003","CASTELSEPRIO",3,0,2,5,"2023","044"
"40004","CASTELSPINA",29,0,0,29,"2023","054"
"40005","CASTELVECCANA",6,0,0,6,"2023","045"
"40006","CASTELVERDE",88,3199,0,3287,"2023","026"
"40007","CASTELVETRO DI MODENA",54,947,0,1001,"2023","008"
"40008","CASTELVETRO PIACENTINO",863,1211,0,2074,"2023","014"
"40009","CASTELVISCONTI",2,1570,341,1913,"2023","027"
"40010","CASTENASO",83,105,0,188,"2023","021"
"40011","CASTENEDOLO",853,1076,4,1933,"2023","043"
"40012","CASTIGLIONE D'ADDA",0,268,0,268,"2023","014"
"40013","CASTIGLIONE DEI PEPOLI",198,40,0,238,"2023","022"
"40014","CASTIGLIONE DELLE STIVIERE",3670,2968,281,6919,"2023","017"
"40015","CASTIGLIONE FALLETTO",29,0,0,29,"2023","055"
"40016","CASTIGLIONE OLONA",9,0,7,16,"2023","046"
"40017","CASTIGLIONE TINELLA",60,0,0,60,"2023","056"
"40018","CASTIGLIONE TORINESE",13,0,0,13,"2023","068"
"40019","CASTINO",108,0,0,108,"2023","057"
"40020","CASTIONE ANDEVENNO",23,56,0,79,"2023","015"
"40021","CASTIONE DELLA PRESOLANA",12,3,0,15,"2023","064"
"40022","CASTIRAGA VIDARDO",14,377,0,391,"2023","015"
"40023","CASTO",33,28,6,67,"2023","044"
"40024","CASTREZZATO",349,1046,128,1523,"2023","045"
"40025","CASTROCARO TERME E TERRA DEL SOLE",34,6,0,40,"2023","005"
"40026","CASTRONNO",2,0,0,2,"2023","047"
"40027","CAVAGLIA'",1380,105,0,1485,"2023","016"
"40028","CAVAGLIETTO",12,193,0,205,"2023","044"
"40029","CAVAGNOLO",41,0,0,41,"2023","069"
"40030","CAVAION VERONESE",2,0,0,2,"2023","023"
"40031","CAVALLERLEONE",394,1249,54,1697,"2023","058"
"40032","CAVALLERMAGGIORE",2567,2423,53,5043,"2023","059"
"40033","CAVALLINO-TREPORTI",6,0,0,6,"2023","044"
"40034","CAVALLIRIO",4,0,0,4,"2023","047"
"40035","CAVARGNA",7,0,0,7,"2023","062"
"40036","CAVARIA CON PREMEZZO",21,0,0,21,"2023","048"
"40037","CAVARZERE",5076,0,0,5076,"2023","006"
"40038","CAVASO DEL TOMBA",50,56,2,108,"2023","014"
"40039","CAVATORE",9,0,0,9,"2023","055"
"40040","CAVENAGO D'ADDA",2,816,0,818,"2023","017"
"40041","CAVEZZO",0,312,0,312,"2023","009"
"40042","CAVOUR",4618,1033,586,6237,"2023","070"
"40043","CAVRIAGO",10,516,0,526,"2023","017"
"40044","CAVRIANA",1294,1950,202,3446,"2023","018"
"40045","CAZZAGO SAN MARTINO",2187,137,46,2370,"2023","046"
"40046","CAZZANO DI TRAMIGNA",0,113,0,113,"2023","024"
"40047","CAZZANO SANT'ANDREA",290,8,0,298,"2023","067"
"40048","CECIMA",30,0,0,30,"2023","042"
"40049","CEDEGOLO",2,9,2,13,"2023","047"
"40050","CEDRASCO",0,62,0,62,"2023","016"
"40051","CEGGIA",9,0,0,9,"2023","007"
"40052","CELLA DATI",3354,136,12,3502,"2023","028"
"40053","CELLA MONTE",82,0,0,82,"2023","056"
"40054","CELLARENGO",324,96,176,596,"2023","033"
"40055","CELLATICA",2,85,2,89,"2023","048"
"40056","CELLE DI MACRA",39,0,13,52,"2023","060"
"40057","CELLE ENOMONDO",250,0,0,250,"2023","034"
"40058","CELLIO CON BREIA",2,0,0,2,"2023",NA
"40059","CENATE SOPRA",14,3,0,17,"2023","068"
"40060","CENATE SOTTO",18,0,0,18,"2023","069"
"40061","CENCENIGHE AGORDINO",0,1,0,1,"2023","010"
"40062","CENE",39,68,0,107,"2023","070"
"40063","CENESELLI",7,192,21,220,"2023","014"
"40064","CENTALLO",4911,757,367,6035,"2023","061"
"40065","CENTO",19,0,0,19,"2023","004"
"40066","CENTRO VALLE INTELVI",101,17,10,128,"2023",NA
"40067","CEPPO MORELLI",26,0,0,26,"2023","021"
"40068","CERANO",8,0,0,8,"2023","049"
"40069","CERANO D'INTELVI",17,0,39,56,"2023","063"
"40070","CERANOVA",0,562,0,562,"2023","043"
"40071","CERCENASCO",142,322,0,464,"2023","071"
"40072","CERCINO",69,7,30,106,"2023","017"
"40073","CEREA",844,169,0,1013,"2023","025"
"40074","CERES",6,0,0,6,"2023","072"
"40075","CERESARA",1164,342,103,1609,"2023","019"
"40076","CERESETO",92,0,0,92,"2023","057"
"40077","CERESOLE ALBA",3432,715,0,4147,"2023","062"
"40078","CERESOLE REALE",0,5,0,5,"2023","073"
"40079","CERETE",18,123,0,141,"2023","071"
"40080","CERETTO LOMELLINA",2,0,0,2,"2023","044"
"40081","CERIANO LAGHETTO",0,24,0,24,"2023",NA
"40082","CERIGNALE",16,0,0,16,"2023","015"
"40083","CERMENATE",17,137,3,157,"2023","064"
"40084","CERNUSCO LOMBARDONE",14,0,1,15,"2023","020"
"40085","CERNUSCO SUL NAVIGLIO",27,104,0,131,"2023","070"
"40086","CERRETO D'ASTI",3,0,0,3,"2023","035"
"40087","CERRETO GRUE",77,0,0,77,"2023","058"
"40088","CERRETTO LANGHE",1,0,0,1,"2023","063"
"40089","CERRINA MONFERRATO",59,27,14,100,"2023","059"
"40090","CERRIONE",246,148,0,394,"2023","018"
"40091","CERRO AL LAMBRO",16,900,0,916,"2023","071"
"40092","CERRO MAGGIORE",8,76,0,84,"2023","072"
"40093","CERRO TANARO",259,0,0,259,"2023","036"
"40094","CERRO VERONESE",17,145,0,162,"2023","026"
"40095","CERTOSA DI PAVIA",14,0,0,14,"2023","046"
"40096","CERVARESE SANTA CROCE",24,145,0,169,"2023","030"
"40097","CERVASCA",1462,37,315,1814,"2023","064"
"40098","CERVENO",39,0,5,44,"2023","049"
"40099","CERVERE",2046,140,0,2186,"2023","065"
"40100","CERVIA",7,0,0,7,"2023","007"
"40101","CERVIGNANO D'ADDA",0,947,0,947,"2023","018"
"40102","CESANA BRIANZA",2,14,2,18,"2023","021"
"40103","CESANA TORINESE",28,11,32,71,"2023","074"
"40104","CESANO BOSCONE",0,53,0,53,"2023","074"
"40105","CESARA",1,0,0,1,"2023","022"
"40106","CESATE",2,0,0,2,"2023","076"
"40107","CESENA",58,18,0,76,"2023","007"
"40108","CESENATICO",5,0,0,5,"2023","008"
"40109","CESIOMAGGIORE",153,105,9,267,"2023","011"
"40110","CESSALTO",36,89,0,125,"2023","015"
"40111","CESSOLE",186,0,0,186,"2023","037"
"40112","CETO",11,43,2,56,"2023","050"
"40113","CEVA",1504,0,0,1504,"2023","066"
"40114","CEVO",0,46,2,48,"2023","051"
"40115","CHERASCO",4656,988,127,5771,"2023","067"
"40116","CHIALAMBERTO",8,0,6,14,"2023","075"
"40117","CHIAMPO",17,53,3,73,"2023","029"
"40118","CHIANOCCO",24,0,6,30,"2023","076"
"40119","CHIARANO",4,495,0,499,"2023","016"
"40120","CHIARI",903,5735,178,6816,"2023","052"
"40121","CHIAVENNA",7,0,3,10,"2023","018"
"40122","CHIAVERANO",33,0,0,33,"2023","077"
"40123","CHIERI",2230,475,47,2752,"2023","078"
"40124","CHIES D'ALPAGO",17,6,0,23,"2023","012"
"40125","CHIESA IN VALMALENCO",30,42,0,72,"2023","019"
"40126","CHIESANUOVA",2,0,0,2,"2023","079"
"40127","CHIEVE",0,1081,0,1081,"2023","029"
"40128","CHIGNOLO D'ISOLA",51,343,0,394,"2023","072"
"40129","CHIGNOLO PO",8,108,0,116,"2023","048"
"40130","CHIOGGIA",3278,0,0,3278,"2023","008"
"40131","CHIOMONTE",0,26,0,26,"2023","080"
"40132","CHIUDUNO",12,0,0,12,"2023","073"
"40133","CHIUPPANO",1,19,0,20,"2023","030"
"40134","CHIURO",6,7,0,13,"2023","020"
"40135","CHIUSA DI PESIO",1569,301,80,1950,"2023","068"
"40136","CHIUSA DI SAN MICHELE",0,0,63,63,"2023","081"
"40137","CHIUSANO D'ASTI",5,0,0,5,"2023","038"
"40138","CHIVASSO",1085,292,0,1377,"2023","082"
"40139","CICOGNOLO",0,1205,0,1205,"2023","030"
"40140","CICONIO",124,90,0,214,"2023","083"
"40141","CIGLIANO",255,64,33,352,"2023","042"
"40142","CIGLIE'",529,0,0,529,"2023","069"
"40143","CIGOGNOLA",1,0,0,1,"2023","049"
"40144","CIGOLE",2056,1416,0,3472,"2023","053"
"40145","CILAVEGNA",6,0,0,6,"2023","050"
"40146","CIMADOLMO",210,81,0,291,"2023","017"
"40147","CIMBERGO",8,0,2,10,"2023","054"
"40148","CINAGLIO",549,9,0,558,"2023","039"
"40149","CINGIA DE' BOTTI",36,1150,0,1186,"2023","031"
"40150","CINO",21,7,0,28,"2023","021"
"40151","CINTANO",22,0,0,22,"2023","084"
"40152","CINTO CAOMAGGIORE",443,0,19,462,"2023","009"
"40153","CINTO EUGANEO",9,34,0,43,"2023","031"
"40154","CINZANO",11,0,0,11,"2023","085"
"40155","CIRIE'",240,206,133,579,"2023","086"
"40156","CIRIMIDO",1,10,0,11,"2023","068"
"40157","CISANO BERGAMASCO",36,0,0,36,"2023","074"
"40158","CISERANO",13,43,0,56,"2023","075"
"40159","CISLAGO",8,0,0,8,"2023","050"
"40160","CISLIANO",86,507,0,593,"2023","078"
"40161","CISON DI VALMARINO",72,0,0,72,"2023","018"
"40162","CISTERNA D'ASTI",56,0,0,56,"2023","040"
"40163","CITTADELLA",2022,945,139,3106,"2023","032"
"40164","CITTIGLIO",11,13,0,24,"2023","051"
"40165","CIVATE",1,0,2,3,"2023","022"
"40166","CIVIASCO",0,4,0,4,"2023","043"
"40167","CIVIDATE AL PIANO",811,639,0,1450,"2023","076"
"40168","CIVIDATE CAMUNO",6,0,0,6,"2023","055"
"40169","CIVITELLA DI ROMAGNA",661,6,28,695,"2023","009"
"40170","CIVO",16,13,0,29,"2023","022"
"40171","CLAINO CON OSTENO",0,0,7,7,"2023","071"
"40172","CLAVESANA",303,0,0,303,"2023","071"
"40173","CLIVIO",35,87,0,122,"2023","052"
"40174","CLUSONE",137,214,0,351,"2023","077"
"40175","COASSOLO TORINESE",29,0,1,30,"2023","088"
"40176","COAZZE",1,0,18,19,"2023","089"
"40177","COAZZOLO",41,0,0,41,"2023","041"
"40178","COCCAGLIO",95,1081,3,1179,"2023","056"
"40179","COCCONATO",64,1,0,65,"2023","042"
"40180","COCQUIO-TREVISAGO",23,0,0,23,"2023","053"
"40181","CODEVIGO",372,115,0,487,"2023","033"
"40182","CODIGORO",3337,206,0,3543,"2023","005"
"40183","CODOGNE'",51,126,5,182,"2023","019"
"40184","CODOGNO",7,1145,0,1152,"2023","019"
"40185","COGGIOLA",12,4,0,16,"2023","019"
"40186","COGLIATE",0,0,65,65,"2023",NA
"40187","COGOLLO DEL CENGIO",382,98,0,480,"2023","032"
"40188","COLCERESA",16,387,18,421,"2023",NA
"40189","COLERE",3,0,0,3,"2023","078"
"40190","COLI",85,0,0,85,"2023","016"
"40191","COLICO",140,86,40,266,"2023","023"
"40192","COLLE BRIANZA",3,0,0,3,"2023","024"
"40193","COLLE SANTA LUCIA",0,11,0,11,"2023","014"
"40194","COLLE UMBERTO",21,116,0,137,"2023","020"
"40195","COLLECCHIO",0,2420,0,2420,"2023","009"
"40196","COLLEGNO",256,202,3,461,"2023","090"
"40197","COLLERETTO CASTELNUOVO",14,28,0,42,"2023","091"
"40198","COLLERETTO GIACOSA",18,0,0,18,"2023","092"
"40199","COLLI VERDI",196,0,0,196,"2023",NA
"40200","COLLIO",75,52,21,148,"2023","058"
"40201","COLOGNA VENETA",9649,236,0,9885,"2023","027"
"40202","COLOGNE",427,658,0,1085,"2023","059"
"40203","COLOGNO AL SERIO",77,913,0,990,"2023","079"
"40204","COLORINA",46,411,0,457,"2023","023"
"40205","COLORNO",6,782,0,788,"2023","010"
"40206","COLTURANO",0,6,0,6,"2023","082"
"40207","COLVERDE",13,105,17,135,"2023",NA
"40208","COLZATE",50,75,0,125,"2023","080"
"40209","COMABBIO",2,0,0,2,"2023",NA
"40210","COMACCHIO",480,262,0,742,"2023","006"
"40211","COMAZZO",50,816,59,925,"2023","020"
"40212","COMELICO SUPERIORE",17,118,0,135,"2023","015"
"40213","COMERIO",3,0,0,3,"2023","055"
"40214","COMEZZANO-CIZZAGO",181,1872,1,2054,"2023","060"
"40215","COMMESSAGGIO",12,16,15,43,"2023","020"
"40216","COMO",6,35,2,43,"2023","075"
"40217","COMPIANO",21,29,0,50,"2023","011"
"40218","COMUN NUOVO",110,0,0,110,"2023","081"
"40219","CONA",15577,0,21,15598,"2023","010"
"40220","CONCAMARISE",0,270,0,270,"2023","029"
"40221","CONCESIO",9,4,0,13,"2023","061"
"40222","CONCORDIA SAGITTARIA",1111,0,0,1111,"2023","011"
"40223","CONCORDIA SULLA SECCHIA",60,284,0,344,"2023","010"
"40224","CONCOREZZO",2,28,0,30,"2023",NA
"40225","CONDOVE",109,26,26,161,"2023","093"
"40226","CONEGLIANO",12,22,0,34,"2023","021"
"40227","CONFIENZA",53,17,0,70,"2023","052"
"40228","CONIOLO",86,0,0,86,"2023","060"
"40229","CONSELICE",482,190,0,672,"2023","008"
"40230","CONSELVE",1063,35,0,1098,"2023","034"
"40231","CONZANO",146,0,0,146,"2023","061"
"40232","COPPARO",123,0,0,123,"2023","007"
"40233","CORBETTA",63,50,4,117,"2023","085"
"40234","CORBOLA",27,135,0,162,"2023","017"
"40235","CORDIGNANO",65,110,0,175,"2023","022"
"40236","CORIANO",65,114,0,179,"2023","003"
"40237","CORIO",122,0,41,163,"2023","094"
"40238","CORNA IMAGNA",43,39,0,82,"2023","082"
"40239","CORNALBA",4,12,0,16,"2023","249"
"40240","CORNAREDO",6,247,10,263,"2023","087"
"40241","CORNATE D'ADDA",33,95,3,131,"2023",NA
"40242","CORNEDO VICENTINO",4,105,0,109,"2023","034"
"40243","CORNEGLIANO LAUDENSE",0,162,0,162,"2023","021"
"40244","CORNELIANO D'ALBA",146,0,0,146,"2023","072"
"40245","CORNIGLIO",19,318,0,337,"2023","012"
"40246","CORNO GIOVINE",211,57,0,268,"2023","022"
"40247","CORNOVECCHIO",92,0,0,92,"2023","023"
"40248","CORNUDA",338,387,16,741,"2023","023"
"40249","CORREGGIO",1,2108,0,2109,"2023","020"
"40250","CORREZZANA",6,0,0,6,"2023",NA
"40251","CORREZZOLA",4500,15,0,4515,"2023","035"
"40252","CORRIDO",68,19,4,91,"2023","077"
"40253","CORSIONE",8,0,0,8,"2023","044"
"40254","CORTANDONE",5,0,0,5,"2023",NA
"40255","CORTANZE",179,0,0,179,"2023","046"
"40256","CORTAZZONE",24,0,0,24,"2023","047"
"40257","CORTE BRUGNATELLA",242,12,0,254,"2023","017"
"40258","CORTE DE' CORTESI CON CIGNONE",2,11,250,263,"2023","032"
"40259","CORTE DE' FRATI",25,921,225,1171,"2023","033"
"40260","CORTE FRANCA",110,36,4,150,"2023","062"
"40261","CORTE PALASIO",44,2037,0,2081,"2023","024"
"40262","CORTEMAGGIORE",183,2135,0,2318,"2023","018"
"40263","CORTEMILIA",150,0,0,150,"2023","073"
"40264","CORTENO GOLGI",18,105,13,136,"2023","063"
"40265","CORTENOVA",2,35,0,37,"2023","025"
"40266","CORTENUOVA",167,1187,0,1354,"2023","083"
"40267","CORTEOLONA E GENZONE",109,0,0,109,"2023",NA
"40268","CORTINA D'AMPEZZO",0,27,0,27,"2023","016"
"40269","CORZANO",111,250,0,361,"2023","064"
"40270","COSIO VALTELLINO",19,723,0,742,"2023","024"
"40271","COSSANO BELBO",284,0,0,284,"2023","074"
"40272","COSSANO CANAVESE",2,0,0,2,"2023","095"
"40273","COSSATO",479,182,0,661,"2023","020"
"40274","COSSOGNO",7,0,0,7,"2023","023"
"40275","COSTA DE' NOBILI",61,19,12,92,"2023","058"
"40276","COSTA DI MEZZATE",23,0,0,23,"2023","084"
"40277","COSTA DI ROVIGO",0,218,0,218,"2023","018"
"40278","COSTA MASNAGA",5,0,0,5,"2023","026"
"40279","COSTA SERINA",19,4,0,23,"2023","247"
"40280","COSTA VALLE IMAGNA",2,1,0,3,"2023","085"
"40281","COSTA VESCOVATO",23,0,0,23,"2023","062"
"40282","COSTA VOLPINO",39,58,7,104,"2023","086"
"40283","COSTABISSARA",36,21,3,60,"2023","035"
"40284","COSTERMANO",15,29,0,44,"2023","030"
"40285","COSTIGLIOLE D'ASTI",653,0,0,653,"2023","050"
"40286","COSTIGLIOLE SALUZZO",338,0,10,348,"2023","075"
"40287","COTIGNOLA",44,0,0,44,"2023","009"
"40288","COVO",1,1595,0,1596,"2023","087"
"40289","CRANDOLA VALSASSINA",0,2,1,3,"2023","027"
"40290","CRAVAGLIANA",0,29,0,29,"2023","048"
"40291","CRAVEGGIA",16,0,0,16,"2023","024"
"40292","CREAZZO",14,16,0,30,"2023","036"
"40293","CREDARO",0,181,10,191,"2023","088"
"40294","CREDERA RUBBIANO",19,1262,31,1312,"2023","034"
"40295","CREMA",356,2520,147,3023,"2023","035"
"40296","CREMELLA",4,0,0,4,"2023","028"
"40297","CREMENO",0,21,13,34,"2023","029"
"40298","CREMIA",5,0,4,9,"2023","083"
"40299","CREMOLINO",104,0,0,104,"2023","063"
"40300","CREMONA",364,1205,17,1586,"2023","036"
"40301","CREMOSANO",36,368,0,404,"2023","037"
"40302","CRESCENTINO",115,0,41,156,"2023","049"
"40303","CRESPADORO",26,31,3,60,"2023","037"
"40304","CRESPIATICA",6,257,0,263,"2023","025"
"40305","CRESPINO",2042,0,0,2042,"2023","019"
"40306","CRESSA",22,299,0,321,"2023","055"
"40307","CREVACUORE",5,0,0,5,"2023","021"
"40308","CREVALCORE",149,52,0,201,"2023","024"
"40309","CREVOLADOSSOLA",75,20,3,98,"2023","025"
"40310","CROCETTA DEL MONTELLO",17,34,0,51,"2023","025"
"40311","CRODO",54,100,34,188,"2023","026"
"40312","CROTTA D'ADDA",0,375,0,375,"2023","038"
"40313","CUASSO AL MONTE",20,0,0,20,"2023","058"
"40314","CUCCIAGO",4,0,0,4,"2023","084"
"40315","CUCEGLIO",42,0,0,42,"2023","096"
"40316","CUGGIONO",554,59,0,613,"2023","096"
"40317","CUMIANA",1015,646,0,1661,"2023","097"
"40318","CUMIGNANO SUL NAVIGLIO",0,1276,0,1276,"2023","039"
"40319","CUNARDO",1,0,0,1,"2023","060"
"40320","CUNEO",8709,727,799,10235,"2023","078"
"40321","CUNICO",1854,0,0,1854,"2023","051"
"40322","CUORGNE'",177,40,0,217,"2023","098"
"40323","CURA CARPIGNANO",29,130,1,160,"2023","060"
"40324","CUREGGIO",12,0,25,37,"2023","058"
"40325","CURIGLIA CON MONTEVIASCO",8,0,0,8,"2023","061"
"40326","CURINO",1,0,0,1,"2023","023"
"40327","CURNO",3,41,0,44,"2023","089"
"40328","CURTAROLO",111,161,0,272,"2023","036"
"40329","CURTATONE",3315,1851,508,5674,"2023","021"
"40330","CUSAGO",0,732,0,732,"2023","097"
"40331","CUSINO",34,0,0,34,"2023","085"
"40332","CUVEGLIO",5,7,0,12,"2023","062"
"40333","CUVIO",11,81,0,92,"2023","063"
"40334","DAIRAGO",0,55,0,55,"2023","099"
"40335","DALMINE",106,105,0,211,"2023","091"
"40336","DARFO BOARIO TERME",7,298,8,313,"2023","065"
"40337","DAVERIO",23,0,0,23,"2023","064"
"40338","DAZIO",0,9,0,9,"2023","025"
"40339","DELEBIO",26,211,2,239,"2023","026"
"40340","DELLO",700,2082,0,2782,"2023","066"
"40341","DEMONTE",874,85,0,959,"2023","079"
"40342","DENICE",4,0,0,4,"2023","065"
"40343","DERNICE",14,0,1,15,"2023","066"
"40344","DEROVERE",0,269,2,271,"2023","040"
"40345","DERVIO",1,0,0,1,"2023","030"
"40346","DESANA",17,0,0,17,"2023","054"
"40347","DESENZANO DEL GARDA",207,1576,618,2401,"2023","067"
"40348","DESIO",21,0,0,21,"2023",NA
"40349","DIANO D'ALBA",64,0,0,64,"2023","080"
"40350","DIVIGNANO",35,0,1,36,"2023","060"
"40351","DIZZASCO",0,0,6,6,"2023","087"
"40352","DOGLIANI",1638,0,5,1643,"2023","081"
"40353","DOLO",494,315,0,809,"2023","012"
"40354","DOMASO",0,2,1,3,"2023","089"
"40355","DOMODOSSOLA",11,38,10,59,"2023","028"
"40356","DONATO",221,0,51,272,"2023","024"
"40357","DONGO",3,0,4,7,"2023","090"
"40358","DORMELLETTO",3,0,0,3,"2023","062"
"40359","DORNO",17,27,0,44,"2023","061"
"40360","DORZANO",1,0,0,1,"2023","025"
"40361","DOSOLO",0,356,105,461,"2023","022"
"40362","DOSSENA",39,104,0,143,"2023","092"
"40363","DOSSO DEL LIRO",2,0,8,10,"2023","092"
"40364","DOVADOLA",258,0,0,258,"2023","011"
"40365","DOVERA",48,1097,0,1145,"2023","041"
"40366","DOZZA",14,0,0,14,"2023","025"
"40367","DRONERO",2133,162,20,2315,"2023","082"
"40368","DRUENTO",522,38,3,563,"2023","099"
"40369","DRUOGNO",15,0,8,23,"2023","029"
"40370","DUBINO",335,446,21,802,"2023","027"
"40371","DUE CARRARE",158,0,0,158,"2023","106"
"40372","DUEVILLE",378,663,0,1041,"2023","038"
"40373","DUMENZA",8,0,7,15,"2023","065"
"40374","DUNO",2,0,0,2,"2023",NA
"40375","DUSINO SAN MICHELE",408,46,0,454,"2023","052"
"40376","EDOLO",27,57,16,100,"2023","068"
"40377","ELLO",1,0,0,1,"2023","033"
"40378","ELVA",32,0,46,78,"2023","083"
"40379","ENDINE GAIANO",126,87,0,213,"2023","093"
"40380","ENEGO",6,175,2,183,"2023","039"
"40381","ENTRACQUE",179,0,0,179,"2023","084"
"40382","ENTRATICO",60,0,0,60,"2023","094"
"40383","ENVIE",1570,332,320,2222,"2023","085"
"40384","ERACLEA",4398,195,0,4593,"2023","013"
"40385","ERBA",34,388,2,424,"2023","095"
"40386","ERBE'",266,37,0,303,"2023","032"
"40387","ERBEZZO",56,580,3,639,"2023","033"
"40388","ERBUSCO",217,0,15,232,"2023","069"
"40389","ERVE",1,0,0,1,"2023","034"
"40390","ESINE",5,177,11,193,"2023","070"
"40391","ESINO LARIO",6,0,29,35,"2023","035"
"40392","ESTE",536,46,0,582,"2023","037"
"40393","EUPILIO",37,0,45,82,"2023","097"
"40394","EXILLES",1,0,0,1,"2023",NA
"40395","FABBRICA CURONE",4,17,0,21,"2023","067"
"40396","FABBRICO",0,144,0,144,"2023","021"
"40397","FAEDO VALTELLINO",1,30,0,31,"2023","028"
"40398","FAENZA",227,54,0,281,"2023","010"
"40399","FAGGETO LARIO",0,0,2,2,"2023","098"
"40400","FAGNANO OLONA",7,0,0,7,"2023","067"
"40401","FALCADE",11,27,0,38,"2023","019"
"40402","FALOPPIO",2,0,0,2,"2023","099"
"40403","FANANO",28,463,0,491,"2023","011"
"40404","FARA GERA D'ADDA",32,780,0,812,"2023","096"
"40405","FARA NOVARESE",3,0,0,3,"2023","065"
"40406","FARA OLIVANA CON SOLA",0,217,0,217,"2023","097"
"40407","FARA VICENTINO",528,369,106,1003,"2023","040"
"40408","FARIGLIANO",538,0,0,538,"2023","086"
"40409","FARINI",119,92,0,211,"2023","019"
"40410","FARRA DI SOLIGO",41,23,6,70,"2023","026"
"40411","FAULE",10,0,134,144,"2023","087"
"40412","FAVRIA",342,589,62,993,"2023","101"
"40413","FEISOGLIO",71,0,0,71,"2023","088"
"40414","FELETTO",21,4,0,25,"2023","102"
"40415","FELINO",13,1071,0,1084,"2023","013"
"40416","FELIZZANO",58,0,0,58,"2023","068"
"40417","FELTRE",159,1084,26,1269,"2023","021"
"40418","FENEGRO'",36,0,32,68,"2023","100"
"40419","FENESTRELLE",31,0,0,31,"2023","103"
"40420","FERNO",0,0,6,6,"2023","068"
"40421","FERRARA",243,100,0,343,"2023","008"
"40422","FERRARA DI MONTE BALDO",75,9,0,84,"2023","034"
"40423","FERRERA DI VARESE",26,0,0,26,"2023","069"
"40424","FERRERA ERBOGNONE",36,0,0,36,"2023","062"
"40425","FERRERE",796,0,0,796,"2023","053"
"40426","FERRIERE",184,3,0,187,"2023","020"
"40427","FIANO",20,0,0,20,"2023","104"
"40428","FICAROLO",14,0,0,14,"2023","021"
"40429","FIDENZA",33,3757,0,3790,"2023","014"
"40430","FIESCO",5,654,0,659,"2023","043"
"40431","FIESSE",614,398,188,1200,"2023","071"
"40432","FIESSO D'ARTICO",7,15,0,22,"2023","014"
"40433","FIESSO UMBERTIANO",1,0,0,1,"2023","022"
"40434","FIGINO SERENZA",65,76,2,143,"2023","101"
"40435","FILAGO",193,0,0,193,"2023","098"
"40436","FILIGHERA",0,83,0,83,"2023","063"
"40437","FINALE EMILIA",4,60,0,64,"2023","012"
"40438","FINO DEL MONTE",5,40,0,45,"2023","099"
"40439","FINO MORNASCO",15,0,0,15,"2023","102"
"40440","FIORANO AL SERIO",5,17,0,22,"2023","100"
"40441","FIORANO MODENESE",11,75,0,86,"2023","013"
"40442","FIORENZUOLA D'ARDA",176,1823,0,1999,"2023","021"
"40443","FISCAGLIA",1308,114,1,1423,"2023",NA
"40444","FIUMALBO",137,75,0,212,"2023","014"
"40445","FLERO",472,184,61,717,"2023","072"
"40446","FOBELLO",11,0,1,12,"2023","057"
"40447","FOGLIZZO",176,0,0,176,"2023","106"
"40448","FOLLINA",378,68,4,450,"2023","027"
"40449","FOMBIO",0,627,0,627,"2023","026"
"40450","FONTANELICE",435,48,0,483,"2023","026"
"40451","FONTANELLA",1914,2062,0,3976,"2023","101"
"40452","FONTANELLATO",18,2220,0,2238,"2023","015"
"40453","FONTANELLE",66,392,3,461,"2023","028"
"40454","FONTANETO D'AGOGNA",8,122,0,130,"2023","066"
"40455","FONTANETTO PO",2,0,0,2,"2023","058"
"40456","FONTANILE",3,0,0,3,"2023","054"
"40457","FONTANIVA",176,345,3,524,"2023","038"
"40458","FONTE",1004,567,31,1602,"2023","029"
"40459","FONTENO",13,0,0,13,"2023","102"
"40460","FONTEVIVO",0,1904,0,1904,"2023","016"
"40461","FONZASO",25,41,12,78,"2023","022"
"40462","FOPPOLO",0,5,0,5,"2023","103"
"40463","FORCOLA",50,128,0,178,"2023","029"
"40464","FORESTO SPARSO",26,71,0,97,"2023","104"
"40465","FORLI'",448,58,0,506,"2023","012"
"40466","FORLIMPOPOLI",6,0,0,6,"2023","013"
"40467","FORMAZZA",2,23,2,27,"2023","031"
"40468","FORMIGARA",10,1328,0,1338,"2023","044"
"40469","FORMIGINE",4,2347,0,2351,"2023","015"
"40470","FORMIGLIANA",26,0,0,26,"2023","059"
"40471","FORNO CANAVESE",40,0,6,46,"2023","107"
"40472","FORNOVO DI TARO",1,675,0,676,"2023","017"
"40473","FORNOVO SAN GIOVANNI",51,581,0,632,"2023","105"
"40474","FORTUNAGO",96,0,0,96,"2023","064"
"40475","FOSSALTA DI PIAVE",1,0,0,1,"2023","015"
"40476","FOSSALTA DI PORTOGRUARO",2,758,0,760,"2023","016"
"40477","FOSSANO",17791,4508,880,23179,"2023","089"
"40478","FOSSO'",81,21,0,102,"2023","017"
"40479","FOZA",42,8,31,81,"2023","041"
"40480","FRABOSA SOPRANA",309,0,142,451,"2023","090"
"40481","FRABOSA SOTTANA",67,33,25,125,"2023","091"
"40482","FRACONALTO",55,0,0,55,"2023","069"
"40483","FRASCAROLO",625,50,2,677,"2023","065"
"40484","FRASSINELLE POLESINE",189,0,0,189,"2023","023"
"40485","FRASSINELLO MONFERRATO",90,0,0,90,"2023","072"
"40486","FRASSINETO PO",43,0,0,43,"2023","073"
"40487","FRASSINETTO",43,4,0,47,"2023","108"
"40488","FRASSINO",37,0,0,37,"2023","092"
"40489","FRASSINORO",86,65,0,151,"2023","016"
"40490","FRATTA POLESINE",114,121,0,235,"2023","024"
"40491","FREGONA",19,22,1,42,"2023","030"
"40492","FRESONARA",55,0,0,55,"2023","074"
"40493","FRINCO",334,0,0,334,"2023","055"
"40494","FRONT",40,0,26,66,"2023","109"
"40495","FROSSASCO",1559,6,144,1709,"2023","110"
"40496","FRUGAROLO",139,136,0,275,"2023","075"
"40497","FUBINE MONFERRATO",412,0,0,412,"2023",NA
"40498","FUIPIANO VALLE IMAGNA",18,28,0,46,"2023","106"
"40499","FUMANE",11,34,6,51,"2023","035"
"40500","FUSIGNANO",4,0,0,4,"2023","011"
"40501","FUSINE",11,23,0,34,"2023","030"
"40502","GABBIONETA-BINANUOVA",47,795,0,842,"2023","045"
"40503","GABIANO",49,0,0,49,"2023","077"
"40504","GADESCO-PIEVE DELMONA",120,452,0,572,"2023","046"
"40505","GAGGIANO",28,366,4,398,"2023","103"
"40506","GAGGIO MONTANO",277,346,0,623,"2023","027"
"40507","GAGLIANICO",6,0,0,6,"2023","026"
"40508","GAIARINE",772,0,0,772,"2023","031"
"40509","GAIBA",9,0,0,9,"2023","025"
"40510","GAIOLA",10,0,0,10,"2023","093"
"40511","GALBIATE",49,23,8,80,"2023","036"
"40512","GALEATA",480,0,0,480,"2023","014"
"40513","GALGAGNANO",0,972,0,972,"2023","027"
"40514","GALLARATE",13,0,23,36,"2023","070"
"40515","GALLIATE",7,95,0,102,"2023","068"
"40516","GALLIATE LOMBARDO",19,0,0,19,"2023","071"
"40517","GALLIERA VENETA",3183,149,0,3332,"2023","039"
"40518","GALLIO",11,206,7,224,"2023","042"
"40519","GALZIGNANO TERME",4,0,0,4,"2023","040"
"40520","GAMALERO",18,0,0,18,"2023","078"
"40521","GAMBARA",4807,2879,73,7759,"2023","073"
"40522","GAMBASCA",2,0,0,2,"2023","094"
"40523","GAMBOLO'",110,85,0,195,"2023","068"
"40524","GAMBUGLIANO",0,32,21,53,"2023","044"
"40525","GANDELLINO",21,17,0,38,"2023","107"
"40526","GANDINO",98,129,0,227,"2023","108"
"40527","GANDOSSO",8,0,0,8,"2023","109"
"40528","GARBAGNA",142,0,0,142,"2023","079"
"40529","GARBAGNA NOVARESE",2,0,0,2,"2023","069"
"40530","GARBAGNATE MILANESE",11,0,0,11,"2023",NA
"40531","GARBAGNATE MONASTERO",6,0,0,6,"2023","037"
"40532","GARDONE RIVIERA",3,0,6,9,"2023","074"
"40533","GARDONE VAL TROMPIA",37,0,0,37,"2023","075"
"40534","GARESSIO",174,0,15,189,"2023","095"
"40535","GARGNANO",52,1,6,59,"2023","076"
"40536","GARLASCO",22,0,0,22,"2023","069"
"40537","GARZENO",6,11,13,30,"2023","106"
"40538","GARZIGLIANA",185,0,0,185,"2023","111"
"40539","GASSINO TORINESE",28,0,0,28,"2023","112"
"40540","GATTATICO",11,2890,0,2901,"2023","022"
"40541","GATTICO-VERUNO",7,340,49,396,"2023",NA
"40542","GATTINARA",54,0,0,54,"2023","061"
"40543","GAVARDO",85,549,67,701,"2023","077"
"40544","GAVELLO",124,0,0,124,"2023",NA
"40545","GAVERINA TERME",9,42,0,51,"2023","110"
"40546","GAVI",2,0,0,2,"2023","081"
"40547","GAVIRATE",37,0,0,37,"2023","072"
"40548","GAZOLDO DEGLI IPPOLITI",539,88,4,631,"2023","024"
"40549","GAZZADA SCHIANNO",14,0,6,20,"2023","073"
"40550","GAZZANIGA",30,20,0,50,"2023","111"
"40551","GAZZO",47,2820,0,2867,"2023","041"
"40552","GAZZO VERONESE",1168,322,0,1490,"2023","037"
"40553","GAZZOLA",287,1686,0,1973,"2023","022"
"40554","GAZZUOLO",40,30,2,72,"2023","025"
"40555","GEMMANO",31,48,0,79,"2023","004"
"40556","GEMONIO",2,0,0,2,"2023","074"
"40557","GENIVOLTA",39,1535,36,1610,"2023","047"
"40558","GENOLA",1943,2230,243,4416,"2023","096"
"40559","GERA LARIO",37,325,18,380,"2023","107"
"40560","GERENZANO",108,109,0,217,"2023","075"
"40561","GERMAGNANO",23,0,0,23,"2023","113"
"40562","GERMAGNO",1,0,0,1,"2023","032"
"40563","GERMIGNAGA",12,66,0,78,"2023","076"
"40564","GERRE DE' CAPRIOLI",0,573,0,573,"2023","048"
"40565","GESSATE",7,391,0,398,"2023","106"
"40566","GHEDI",3041,7226,25,10292,"2023","078"
"40567","GHEMME",29,5,13,47,"2023","073"
"40568","GHIFFA",1,0,5,6,"2023","033"
"40569","GHISALBA",2,798,0,800,"2023","113"
"40570","GHISLARENGO",37,0,0,37,"2023","062"
"40571","GIAGLIONE",40,0,0,40,"2023","114"
"40572","GIANICO",87,109,238,434,"2023","079"
"40573","GIAVENO",161,268,168,597,"2023","115"
"40574","GIAVERA DEL MONTELLO",966,171,0,1137,"2023","032"
"40575","GIGNESE",8,0,0,8,"2023","034"
"40576","GIUSSAGO",19,119,66,204,"2023","072"
"40577","GIVOLETTO",18,0,0,18,"2023","116"
"40578","GODEGA DI SANT'URBANO",36,59,32,127,"2023","033"
"40579","GODIASCO",22,0,6,28,"2023","073"
"40580","GOITO",3240,5981,500,9721,"2023","026"
"40581","GOLASECCA",13,0,0,13,"2023","077"
"40582","GOLFERENZO",0,0,24,24,"2023","074"
"40583","GOMBITO",8,1111,0,1119,"2023","049"
"40584","GONZAGA",19637,4791,414,24842,"2023","027"
"40585","GORDONA",194,112,26,332,"2023","032"
"40586","GORGO AL MONTICANO",76,278,0,354,"2023","034"
"40587","GORGONZOLA",59,215,0,274,"2023","108"
"40588","GORLA MAGGIORE",3,159,0,162,"2023","078"
"40589","GORLA MINORE",76,0,0,76,"2023","079"
"40590","GORLAGO",84,304,0,388,"2023","114"
"40591","GORNATE-OLONA",16,0,2,18,"2023","080"
"40592","GORNO",24,77,0,101,"2023","116"
"40593","GORZEGNO",52,0,0,52,"2023","097"
"40594","GOSALDO",4,0,0,4,"2023",NA
"40595","GOSSOLENGO",4,957,0,961,"2023","023"
"40596","GOTTASECCA",38,0,0,38,"2023","098"
"40597","GOTTOLENGO",13428,1332,89,14849,"2023","080"
"40598","GOVONE",263,0,0,263,"2023","099"
"40599","GRAFFIGNANA",68,251,19,338,"2023","028"
"40600","GRAGLIA",155,23,72,250,"2023","028"
"40601","GRAGNANO TREBBIENSE",56,4216,0,4272,"2023","024"
"40602","GRANA",56,0,0,56,"2023","056"
"40603","GRANAROLO DELL'EMILIA",371,242,0,613,"2023","030"
"40604","GRANDOLA ED UNITI",2,8,45,55,"2023","111"
"40605","GRANOZZO CON MONTICELLO",0,46,0,46,"2023","077"
"40606","GRANTOLA",74,0,0,74,"2023","081"
"40607","GRANTORTO",68,833,0,901,"2023","042"
"40608","GRANZE",61,0,0,61,"2023","043"
"40609","GRASSOBBIO",8,110,0,118,"2023","117"
"40610","GRAVEDONA ED UNITI",8,12,34,54,"2023","249"
"40611","GRAVELLONA LOMELLINA",0,0,11,11,"2023","075"
"40612","GRAVELLONA TOCE",12,0,0,12,"2023","035"
"40613","GRAVERE",2,0,0,2,"2023","117"
"40614","GRAZZANO BADOGLIO",397,0,0,397,"2023","057"
"40615","GREMIASCO",33,0,0,33,"2023","083"
"40616","GREZZAGO",7,0,0,7,"2023","110"
"40617","GREZZANA",135,444,16,595,"2023","038"
"40618","GRIANTE",7,0,6,13,"2023","113"
"40619","GRIGNASCO",50,0,0,50,"2023","079"
"40620","GRINZANE CAVOUR",11,0,0,11,"2023","100"
"40621","GRISIGNANO DI ZOCCO",32,475,0,507,"2023","046"
"40622","GRIZZANA MORANDI",105,0,0,105,"2023","031"
"40623","GROMO",53,115,0,168,"2023","118"
"40624","GRONDONA",9,0,0,9,"2023","085"
"40625","GRONE",37,34,0,71,"2023","119"
"40626","GRONTARDO",121,2003,15,2139,"2023","050"
"40627","GROPELLO CAIROLI",61,0,0,61,"2023","076"
"40628","GROPPARELLO",142,16,0,158,"2023","025"
"40629","GROSCAVALLO",11,0,0,11,"2023","118"
"40630","GROSIO",16,214,2,232,"2023","033"
"40631","GROSOTTO",7,109,5,121,"2023","034"
"40632","GROSSO",52,0,34,86,"2023","119"
"40633","GRUARO",7,208,0,215,"2023","018"
"40634","GRUGLIASCO",90,0,70,160,"2023","120"
"40635","GRUMELLO CREMONESE ED UNITI",74,2003,0,2077,"2023","051"
"40636","GRUMELLO DEL MONTE",7,84,0,91,"2023","120"
"40637","GRUMOLO DELLE ABBADESSE",17,143,49,209,"2023","047"
"40638","GUALTIERI",1218,477,0,1695,"2023","023"
"40639","GUANZATE",5,0,17,22,"2023","114"
"40640","GUARDA VENETA",634,0,0,634,"2023","028"
"40641","GUARDABOSONE",61,9,0,70,"2023","066"
"40642","GUARDAMIGLIO",30,644,0,674,"2023","029"
"40643","GUARENE",276,0,0,276,"2023","101"
"40644","GUASTALLA",5,1311,2,1318,"2023","024"
"40645","GUDO VISCONTI",12,0,0,12,"2023","112"
"40646","GUIDIZZOLO",1310,821,183,2314,"2023","028"
"40647","GUIGLIA",39,368,0,407,"2023","017"
"40648","GUSSAGO",47,1107,153,1307,"2023","081"
"40649","GUSSOLA",0,48,4,52,"2023","052"
"40650","IDRO",4,0,9,13,"2023","082"
"40651","IGLIANO",70,0,17,87,"2023","102"
"40652","ILLASI",0,38,0,38,"2023","039"
"40653","IMBERSAGO",0,0,2,2,"2023","039"
"40654","IMOLA",100,0,0,100,"2023","032"
"40655","INARZO",15,0,0,15,"2023","082"
"40656","INCISA SCAPACCINO",35,0,0,35,"2023","058"
"40657","INDUNO OLONA",3,85,0,88,"2023","083"
"40658","INTROBIO",7,12,91,110,"2023","040"
"40659","INVERIGO",125,0,67,192,"2023","118"
"40660","INVERNO E MONTELEONE",57,230,21,308,"2023","077"
"40661","INVERSO PINASCA",26,0,0,26,"2023","122"
"40662","INVERUNO",37,42,0,79,"2023","113"
"40663","INVORIO",74,71,0,145,"2023","082"
"40664","INZAGO",401,425,78,904,"2023","114"
"40665","IRMA",18,0,0,18,"2023","084"
"40666","ISASCA",13,0,0,13,"2023","103"
"40667","ISEO",31,30,0,61,"2023","085"
"40668","ISOLA D'ASTI",678,0,0,678,"2023","059"
"40669","ISOLA DELLA SCALA",6779,382,0,7161,"2023","040"
"40670","ISOLA DI FONDRA",3,18,0,21,"2023","121"
"40671","ISOLA DOVARESE",0,614,0,614,"2023","053"
"40672","ISOLA RIZZA",1967,354,0,2321,"2023","041"
"40673","ISOLA SANT'ANTONIO",1,0,0,1,"2023","087"
"40674","ISOLA VICENTINA",1832,694,29,2555,"2023","048"
"40675","ISOLABELLA",14,470,0,484,"2023","123"
"40676","ISORELLA",10855,271,2,11128,"2023","086"
"40677","ISPRA",124,184,0,308,"2023","084"
"40678","ISSIGLIO",104,18,14,136,"2023","124"
"40679","ISSO",10,1047,0,1057,"2023","122"
"40680","ISTRANA",2398,310,17,2725,"2023","035"
"40681","IVREA",353,221,0,574,"2023","125"
"40682","IZANO",1,1019,0,1020,"2023","054"
"40683","JERAGO CON ORAGO",2,0,0,2,"2023","085"
"40684","JESOLO",2,80,0,82,"2023",NA
"40685","JOLANDA DI SAVOIA",4292,0,0,4292,"2023","010"
"40686","LA CASSA",0,354,0,354,"2023","126"
"40687","LA LOGGIA",261,0,0,261,"2023","127"
"40688","LA MORRA",30,0,0,30,"2023","105"
"40689","LA VALLE AGORDINA",3,21,12,36,"2023","027"
"40690","LA VALLETTA BRIANZA",12,14,1,27,"2023",NA
"40691","LACCHIARELLA",30,0,0,30,"2023","115"
"40692","LAGNASCO",28,0,54,82,"2023","104"
"40693","LAGOSANTO",72,0,0,72,"2023","011"
"40694","LAINATE",31,0,0,31,"2023","116"
"40695","LAINO",11,1,0,12,"2023","120"
"40696","LAMA MOCOGNO",93,404,0,497,"2023","018"
"40697","LAMBRUGO",1,101,0,102,"2023","121"
"40698","LAMON",3,30,0,33,"2023","026"
"40699","LAMPORO",24,0,0,24,"2023","067"
"40700","LANDIONA",0,12,0,12,"2023",NA
"40701","LANDRIANO",1,204,0,205,"2023","078"
"40702","LANGHIRANO",17,898,0,915,"2023","018"
"40703","LANGOSCO",6,0,0,6,"2023","079"
"40704","LANZADA",34,71,6,111,"2023","036"
"40705","LANZO TORINESE",78,0,5,83,"2023","128"
"40706","LARDIRAGO",0,0,35,35,"2023",NA
"40707","LASNIGO",2,29,0,31,"2023","123"
"40708","LASTEBASSE",7,0,0,7,"2023",NA
"40709","LAURIANO",9,0,0,9,"2023","129"
"40710","LAVAGNO",3,0,0,3,"2023",NA
"40711","LAVENA PONTE TRESA",11,0,0,11,"2023","086"
"40712","LAVENO-MOMBELLO",1,0,0,1,"2023","087"
"40713","LAVENONE",30,0,0,30,"2023","087"
"40714","LAZISE",5,0,0,5,"2023","043"
"40715","LAZZATE",1,0,25,26,"2023",NA
"40716","LECCO",29,14,5,48,"2023","042"
"40717","LEFFE",13,90,0,103,"2023","124"
"40718","LEGGIUNO",3,0,0,3,"2023","088"
"40719","LEGNAGO",65,46,90,201,"2023","044"
"40720","LEGNANO",1,90,0,91,"2023","118"
"40721","LEGNARO",134,51,0,185,"2023","044"
"40722","LEINI",648,582,59,1289,"2023",NA
"40723","LEMIE",6,0,0,6,"2023","131"
"40724","LENDINARA",596,133,0,729,"2023","029"
"40725","LENNA",28,1,0,29,"2023","125"
"40726","LENO",5859,7396,626,13881,"2023","088"
"40727","LENTA",17,0,0,17,"2023","068"
"40728","LENTATE SUL SEVESO",0,179,20,199,"2023",NA
"40729","LEQUIO BERRIA",17,0,0,17,"2023","106"
"40730","LEQUIO TANARO",2176,0,0,2176,"2023","107"
"40731","LERMA",15,0,0,15,"2023","088"
"40732","LESA",3,0,0,3,"2023","084"
"40733","LESEGNO",1644,0,0,1644,"2023","108"
"40734","LESIGNANO DE' BAGNI",35,1496,0,1531,"2023","019"
"40735","LESMO",2,165,34,201,"2023",NA
"40736","LESSOLO",161,0,22,183,"2023","132"
"40737","LESSONA",9,0,0,9,"2023","029"
"40738","LEVICE",39,0,0,39,"2023","109"
"40739","LEZZENO",0,0,1,1,"2023","126"
"40740","LIERNA",7,4,2,13,"2023","043"
"40741","LIMANA",164,66,0,230,"2023","029"
"40742","LIMBIATE",1,0,0,1,"2023",NA
"40743","LIMENA",827,672,51,1550,"2023","045"
"40744","LIMIDO COMASCO",3,27,0,30,"2023","128"
"40745","LIMONE PIEMONTE",23,0,0,23,"2023","110"
"40746","LINAROLO",12,353,0,365,"2023","081"
"40747","LIRIO",84,0,0,84,"2023","082"
"40748","LISCATE",6,0,0,6,"2023","122"
"40749","LISIO",44,0,0,44,"2023","111"
"40750","LISSONE",47,0,67,114,"2023",NA
"40751","LIVIGNO",156,315,0,471,"2023","037"
"40752","LIVINALLONGO DEL COL DI LANA",8,60,0,68,"2023","030"
"40753","LIVO",3,25,0,28,"2023","130"
"40754","LIVORNO FERRARIS",5,51,0,56,"2023","071"
"40755","LIVRAGA",143,1033,20,1196,"2023","030"
"40756","LIZZANO IN BELVEDERE",13,86,8,107,"2023","033"
"40757","LOAZZOLO",7,0,7,14,"2023","060"
"40758","LOCANA",119,51,20,190,"2023","134"
"40759","LOCATE DI TRIULZI",0,1161,0,1161,"2023","125"
"40760","LOCATE VARESINO",8,0,0,8,"2023","131"
"40761","LOCATELLO",54,19,0,73,"2023","127"
"40762","LODI",16,1301,0,1317,"2023","031"
"40763","LODI VECCHIO",1,1575,0,1576,"2023","032"
"40764","LODRINO",23,8,0,31,"2023","090"
"40765","LOGRATO",599,816,14,1429,"2023","091"
"40766","LOIANO",89,193,0,282,"2023","034"
"40767","LOMBARDORE",11,12,0,23,"2023","135"
"40768","LOMBRIASCO",100,139,0,239,"2023","136"
"40769","LOMELLO",57,165,0,222,"2023","083"
"40770","LONATE CEPPINO",1,292,0,293,"2023","089"
"40771","LONATE POZZOLO",1,0,5,6,"2023","090"
"40772","LONATO DEL GARDA",2278,4828,616,7722,"2023",NA
"40773","LONGARE",55,192,0,247,"2023","051"
"40774","LONGARONE",6,0,0,6,"2023","031"
"40775","LONGHENA",0,467,0,467,"2023","093"
"40776","LONGIANO",42,0,0,42,"2023","018"
"40777","LONIGO",5247,423,0,5670,"2023","052"
"40778","LORANZE'",46,0,0,46,"2023","137"
"40779","LOREGGIA",184,432,0,616,"2023","046"
"40780","LOREGLIA",7,0,0,7,"2023","038"
"40781","LORENZAGO DI CADORE",1,1,0,2,"2023","032"
"40782","LOREO",862,34,0,896,"2023","030"
"40783","LORIA",5527,42,19,5588,"2023","036"
"40784","LOSINE",4,4,0,8,"2023","094"
"40785","LOVERE",9,37,0,46,"2023","128"
"40786","LOVERO",1,0,0,1,"2023","038"
"40787","LOZIO",7,0,0,7,"2023","095"
"40788","LOZZA",0,121,0,121,"2023","091"
"40789","LOZZO ATESTINO",1529,0,0,1529,"2023","047"
"40790","LU E CUCCARO MONFERRATO",87,0,0,87,"2023",NA
"40791","LUGAGNANO VAL D'ARDA",96,100,0,196,"2023","026"
"40792","LUGO",89,65,0,154,"2023","012"
"40793","LUGO DI VICENZA",7,109,0,116,"2023","053"
"40794","LUINO",0,1,0,1,"2023","092"
"40795","LUISAGO",5,0,10,15,"2023","135"
"40796","LUMEZZANE",32,0,0,32,"2023","096"
"40797","LURAGO D'ERBA",4,0,8,12,"2023","136"
"40798","LURAGO MARINONE",0,163,0,163,"2023","137"
"40799","LURANO",14,19,0,33,"2023","129"
"40800","LURATE CACCIVIO",54,134,0,188,"2023","138"
"40801","LUSERNA SAN GIOVANNI",389,57,71,517,"2023","139"
"40802","LUSERNETTA",83,0,0,83,"2023","140"
"40803","LUSIA",7,0,0,7,"2023","031"
"40804","LUSIANA CONCO",32,271,5,308,"2023",NA
"40805","LUSIGLIE'",76,0,0,76,"2023","141"
"40806","LUZZANA",22,0,0,22,"2023","130"
"40807","LUZZARA",1780,1274,0,3054,"2023","026"
"40808","MACCAGNO CON PINO E VEDDASCA",5,14,0,19,"2023",NA
"40809","MACCASTORNA",1132,0,0,1132,"2023","033"
"40810","MACELLO",1753,177,331,2261,"2023","142"
"40811","MACLODIO",34,164,0,198,"2023","097"
"40812","MACRA",4,0,0,4,"2023",NA
"40813","MACUGNAGA",2,14,0,16,"2023","039"
"40814","MADIGNANO",36,793,0,829,"2023","055"
"40815","MADONNA DEL SASSO",17,0,0,17,"2023","040"
"40816","MAGASA",13,6,2,21,"2023","098"
"40817","MAGENTA",56,872,26,954,"2023","130"
"40818","MAGGIORA",97,66,0,163,"2023","088"
"40819","MAGHERNO",0,2,0,2,"2023","085"
"40820","MAGLIANO ALFIERI",412,0,0,412,"2023","113"
"40821","MAGLIANO ALPI",431,152,0,583,"2023","114"
"40822","MAGNACAVALLO",0,650,153,803,"2023","029"
"40823","MAGNAGO",90,0,0,90,"2023","131"
"40824","MAGNANO",74,15,0,89,"2023","030"
"40825","MAIOLO",163,0,0,163,"2023","022"
"40826","MAIRAGO",0,464,0,464,"2023","034"
"40827","MAIRANO",327,448,0,775,"2023","099"
"40828","MALAGNINO",146,719,0,865,"2023","056"
"40829","MALCESINE",13,104,12,129,"2023","045"
"40830","MALEGNO",43,25,4,72,"2023","100"
"40831","MALEO",70,1386,0,1456,"2023","035"
"40832","MALESCO",21,11,5,37,"2023","041"
"40833","MALNATE",12,24,0,36,"2023","096"
"40834","MALO",2045,250,0,2295,"2023","055"
"40835","MALONNO",13,165,70,248,"2023","101"
"40836","MALVICINO",12,0,0,12,"2023","090"
"40837","MANDELLO DEL LARIO",19,6,3,28,"2023","046"
"40838","MANDELLO VITTA",1,0,0,1,"2023","090"
"40839","MANERBA DEL GARDA",0,0,22,22,"2023","102"
"40840","MANERBIO",42,1130,0,1172,"2023","103"
"40841","MANGO",5,0,0,5,"2023","115"
"40842","MANSUE'",55,180,0,235,"2023","037"
"40843","MANTELLO",3,99,0,102,"2023","039"
"40844","MANTOVA",579,782,109,1470,"2023","030"
"40845","MAPELLO",36,0,0,36,"2023","132"
"40846","MARANELLO",71,569,0,640,"2023","019"
"40847","MARANO DI VALPOLICELLA",12,41,4,57,"2023","046"
"40848","MARANO SUL PANARO",25,678,0,703,"2023","020"
"40849","MARANO TICINO",0,214,0,214,"2023","091"
"40850","MARANO VICENTINO",274,256,35,565,"2023","056"
"40851","MARCALLO CON CASONE",0,367,0,367,"2023","134"
"40852","MARCARIA",3067,3087,637,6791,"2023","031"
"40853","MARCHENO",23,19,0,42,"2023","104"
"40854","MARCHIROLO",1,0,0,1,"2023","097"
"40855","MARCIGNAGO",1,0,0,1,"2023","086"
"40856","MARCON",302,9,0,311,"2023","020"
"40857","MARENE",3268,2038,116,5422,"2023","117"
"40858","MARENO DI PIAVE",1215,100,2,1317,"2023","038"
"40859","MARENTINO",86,0,0,86,"2023","144"
"40860","MARETTO",167,0,0,167,"2023","062"
"40861","MARGARITA",644,0,0,644,"2023","118"
"40862","MARGNO",4,12,1,17,"2023","047"
"40863","MARIANA MANTOVANA",58,417,60,535,"2023","032"
"40864","MARIANO COMENSE",583,49,8,640,"2023","143"
"40865","MARMENTINO",21,24,2,47,"2023","105"
"40866","MARMIROLO",3653,2794,2728,9175,"2023","033"
"40867","MARMORA",0,0,96,96,"2023","119"
"40868","MARONE",39,0,35,74,"2023","106"
"40869","MAROSTICA",88,531,18,637,"2023","057"
"40870","MARSAGLIA",69,0,0,69,"2023","120"
"40871","MARTELLAGO",24,0,32,56,"2023","021"
"40872","MARTINENGO",169,2549,0,2718,"2023","133"
"40873","MARTINIANA PO",187,0,21,208,"2023","121"
"40874","MARUDO",0,52,0,52,"2023","036"
"40875","MARZABOTTO",17,118,0,135,"2023","036"
"40876","MARZANO",2,261,0,263,"2023","087"
"40877","MARZIO",3,0,5,8,"2023","099"
"40878","MASATE",157,0,0,157,"2023","136"
"40879","MASCIAGO PRIMO",118,0,0,118,"2023","100"
"40880","MASER",4255,26,0,4281,"2023","039"
"40881","MASERA",22,22,0,44,"2023","042"
"40882","MASERA' DI PADOVA",370,94,0,464,"2023","048"
"40883","MASERADA SUL PIAVE",1900,125,10,2035,"2023","040"
"40884","MASI",45,0,0,45,"2023","049"
"40885","MASI TORELLO",6,90,0,96,"2023","012"
"40886","MASIO",767,0,0,767,"2023","091"
"40887","MASSA LOMBARDA",28,0,0,28,"2023","013"
"40888","MASSALENGO",0,113,0,113,"2023","037"
"40889","MASSANZAGO",393,130,0,523,"2023","050"
"40890","MASSAZZA",83,0,0,83,"2023","031"
"40891","MASSELLO",7,0,0,7,"2023","145"
"40892","MASSERANO",140,0,0,140,"2023","032"
"40893","MASSINO VISCONTI",11,0,0,11,"2023","093"
"40894","MASSIOLA",2,0,0,2,"2023","043"
"40895","MATHI",113,0,73,186,"2023","146"
"40896","MATTIE",6,0,6,12,"2023","147"
"40897","MAZZANO",36,507,311,854,"2023","107"
"40898","MAZZE'",946,0,71,1017,"2023","148"
"40899","MAZZO DI VALTELLINA",11,20,11,42,"2023","040"
"40900","MEANA DI SUSA",2,0,0,2,"2023","149"
"40901","MEDE",49,0,0,49,"2023","088"
"40902","MEDESANO",174,1355,0,1529,"2023","020"
"40903","MEDICINA",13,109,0,122,"2023","037"
"40904","MEDIGLIA",21,1302,0,1323,"2023","139"
"40905","MEDOLAGO",17,0,0,17,"2023","250"
"40906","MEDOLE",479,2326,299,3104,"2023","034"
"40907","MEDOLLA",0,474,0,474,"2023","021"
"40908","MEDUNA DI LIVENZA",12,14,0,26,"2023","041"
"40909","MEGLIADINO SAN VITALE",2285,0,0,2285,"2023","052"
"40910","MELAZZO",136,0,0,136,"2023","092"
"40911","MELDOLA",217,0,0,217,"2023","019"
"40912","MELEGNANO",0,176,0,176,"2023","140"
"40913","MELETI",1010,132,0,1142,"2023","038"
"40914","MELLE",62,5,12,79,"2023","122"
"40915","MELLO",74,32,4,110,"2023","041"
"40916","MELZO",0,142,182,324,"2023","142"
"40917","MENAGGIO",3,0,0,3,"2023","145"
"40918","MENCONICO",17,0,0,17,"2023","089"
"40919","MEOLO",502,100,0,602,"2023","022"
"40920","MERANA",48,0,0,48,"2023","093"
"40921","MERATE",34,273,3,310,"2023","048"
"40922","MERCATO SARACENO",340,14,0,354,"2023","020"
"40923","MERCENASCO",305,0,0,305,"2023","150"
"40924","MERGOZZO",23,0,0,23,"2023","044"
"40925","MERLARA",694,0,0,694,"2023","053"
"40926","MERLINO",0,1335,10,1345,"2023","039"
"40927","MERONE",37,10,0,47,"2023","147"
"40928","MESE",66,39,30,135,"2023","043"
"40929","MESENZANA",3,20,0,23,"2023","102"
"40930","MESERO",4,18,0,22,"2023","144"
"40931","MESOLA",890,217,0,1107,"2023","014"
"40932","MESTRINO",68,71,0,139,"2023","054"
"40933","MEZZANA BIGLI",86,0,0,86,"2023","090"
"40934","MEZZANE DI SOTTO",1,12,0,13,"2023","047"
"40935","MEZZENILE",44,0,8,52,"2023","152"
"40936","MEZZOLDO",2,18,0,20,"2023","134"
"40937","MEZZOMERICO",6,0,0,6,"2023","097"
"40938","MIAGLIANO",14,0,0,14,"2023","034"
"40939","MIANE",4,7,1,12,"2023","042"
"40940","MIASINO",0,0,38,38,"2023","098"
"40941","MIAZZINA",2,0,0,2,"2023","045"
"40942","MILANO",279,146,72,497,"2023","146"
"40943","MILZANO",1,974,0,975,"2023","108"
"40944","MINERBE",1348,223,70,1641,"2023","048"
"40945","MINERBIO",93,0,0,93,"2023","038"
"40946","MIRA",2190,196,7,2393,"2023","023"
"40947","MIRABELLO MONFERRATO",78,0,0,78,"2023","094"
"40948","MIRADOLO TERME",7,0,20,27,"2023","093"
"40949","MIRANDOLA",259,1604,0,1863,"2023","022"
"40950","MIRANO",682,645,0,1327,"2023","024"
"40951","MISANO ADRIATICO",8,0,0,8,"2023","005"
"40952","MISANO DI GERA D'ADDA",13,247,0,260,"2023","135"
"40953","MISSAGLIA",15,416,2,433,"2023","049"
"40954","MOASCA",2,0,0,2,"2023",NA
"40955","MODENA",99,2120,0,2219,"2023","023"
"40956","MODIGLIANA",142,0,0,142,"2023","022"
"40957","MOGLIA",7033,1500,28,8561,"2023","035"
"40958","MOGLIANO VENETO",1043,571,2,1616,"2023","043"
"40959","MOIO DE' CALVI",5,6,0,11,"2023","136"
"40960","MOIOLA",2,0,29,31,"2023","123"
"40961","MOLINELLA",2169,395,0,2564,"2023","039"
"40962","MOLLIA",0,7,0,7,"2023","078"
"40963","MOLTENO",11,51,0,62,"2023","051"
"40964","MOMBALDONE",73,0,2,75,"2023","064"
"40965","MOMBARCARO",82,0,0,82,"2023","124"
"40966","MOMBARUZZO",2,0,0,2,"2023","065"
"40967","MOMBASIGLIO",63,0,0,63,"2023","125"
"40968","MOMBELLO DI TORINO",42,0,0,42,"2023","153"
"40969","MOMBELLO MONFERRATO",7,0,0,7,"2023","097"
"40970","MOMBERCELLI",59,0,0,59,"2023","066"
"40971","MOMO",192,498,36,726,"2023","100"
"40972","MOMPERONE",2,0,0,2,"2023","098"
"40973","MONALE",25,0,0,25,"2023","067"
"40974","MONASTERO BORMIDA",396,0,0,396,"2023","068"
"40975","MONASTERO DI LANZO",6,0,0,6,"2023","155"
"40976","MONASTERO DI VASCO",410,0,59,469,"2023","126"
"40977","MONASTEROLO CASOTTO",28,0,0,28,"2023","127"
"40978","MONASTEROLO DEL CASTELLO",14,32,0,46,"2023","137"
"40979","MONASTEROLO DI SAVIGLIANO",502,253,92,847,"2023","128"
"40980","MONASTIER DI TREVISO",1930,45,155,2130,"2023","044"
"40981","MONCALIERI",118,379,0,497,"2023","156"
"40982","MONCALVO",149,0,0,149,"2023","069"
"40983","MONCENISIO",1,0,0,1,"2023","157"
"40984","MONCHIERO",203,0,0,203,"2023","129"
"40985","MONCHIO DELLE CORTI",70,141,0,211,"2023","022"
"40986","MONCRIVELLO",94,234,0,328,"2023","079"
"40987","MONCUCCO TORINESE",45,0,0,45,"2023","070"
"40988","MONDAINO",4,0,0,4,"2023","006"
"40989","MONDOVI'",5299,16,340,5655,"2023","130"
"40990","MONESIGLIO",68,0,0,68,"2023","131"
"40991","MONFORTE D'ALBA",230,0,0,230,"2023","132"
"40992","MONFUMO",28,157,4,189,"2023","045"
"40993","MONGARDINO",35,0,0,35,"2023","071"
"40994","MONGHIDORO",33,96,0,129,"2023","040"
"40995","MONGIARDINO LIGURE",11,0,3,14,"2023","100"
"40996","MONGRANDO",109,133,0,242,"2023","035"
"40997","MONGUZZO",29,0,0,29,"2023","153"
"40998","MONNO",3,56,6,65,"2023","110"
"40999","MONSELICE",188,29,0,217,"2023","055"
"41000","MONTA'",408,0,0,408,"2023","133"
"41001","MONTABONE",15,0,0,15,"2023","072"
"41002","MONTAFIA",28,0,0,28,"2023","073"
"41003","MONTAGNA IN VALTELLINA",15,65,0,80,"2023","044"
"41004","MONTAGNANA",1227,0,0,1227,"2023","056"
"41005","MONTALDO DI MONDOVI'",88,0,20,108,"2023","134"
"41006","MONTALDO SCARAMPI",40,0,0,40,"2023","074"
"41007","MONTALDO TORINESE",578,0,0,578,"2023","158"
"41008","MONTALTO DORA",41,0,0,41,"2023","160"
"41009","MONTALTO PAVESE",143,0,0,143,"2023","094"
"41010","MONTANARO",143,52,73,268,"2023","161"
"41011","MONTANASO LOMBARDO",68,1519,0,1587,"2023","040"
"41012","MONTANERA",1876,909,80,2865,"2023","136"
"41013","MONTANO LUCINO",4,0,3,7,"2023","154"
"41014","MONTE CREMASCO",213,125,0,338,"2023","058"
"41015","MONTE DI MALO",24,97,0,121,"2023","063"
"41016","MONTE ISOLA",17,0,0,17,"2023","111"
"41017","MONTE MARENZO",8,0,0,8,"2023","052"
"41018","MONTE SAN PIETRO",121,167,0,288,"2023","042"
"41019","MONTEBELLO DELLA BATTAGLIA",0,25,0,25,"2023","095"
"41020","MONTEBELLO VICENTINO",362,0,3,365,"2023","060"
"41021","MONTEBELLUNA",2766,418,2,3186,"2023","046"
"41022","MONTECALVO VERSIGGIA",3,0,0,3,"2023",NA
"41023","MONTECASTELLO",2,0,0,2,"2023","105"
"41024","MONTECCHIA DI CROSARA",603,6,0,609,"2023","049"
"41025","MONTECCHIO EMILIA",2,1800,0,1802,"2023","027"
"41026","MONTECCHIO MAGGIORE",166,37,0,203,"2023","061"
"41027","MONTECCHIO PRECALCINO",321,149,0,470,"2023","062"
"41028","MONTECHIARO D'ACQUI",66,0,0,66,"2023","106"
"41029","MONTECHIARO D'ASTI",633,0,0,633,"2023","075"
"41030","MONTECHIARUGOLO",55,3529,0,3584,"2023","023"
"41031","MONTECOPIOLO",547,27,9,583,"2023",NA
"41032","MONTECRESTESE",21,104,0,125,"2023","046"
"41033","MONTECRETO",9,588,0,597,"2023","024"
"41034","MONTEFIORE CONCA",24,11,0,35,"2023","008"
"41035","MONTEFIORINO",110,256,0,366,"2023","025"
"41036","MONTEFORTE D'ALPONE",823,5,0,828,"2023","050"
"41037","MONTEGALDA",24,323,0,347,"2023","064"
"41038","MONTEGALDELLA",12,325,1,338,"2023","065"
"41039","MONTEGIOCO",22,0,0,22,"2023","107"
"41040","MONTEGRIDOLFO",2,0,0,2,"2023","009"
"41041","MONTEGRINO VALTRAVAGLIA",12,0,0,12,"2023","103"
"41042","MONTEGROSSO D'ASTI",27,0,0,27,"2023","076"
"41043","MONTEGROTTO TERME",3,30,0,33,"2023","057"
"41044","MONTELUPO ALBESE",93,0,0,93,"2023","137"
"41045","MONTEMAGNO",289,0,0,289,"2023","077"
"41046","MONTEMALE DI CUNEO",189,0,0,189,"2023","138"
"41047","MONTERENZIO",561,142,0,703,"2023","041"
"41048","MONTEROSSO GRANA",6,122,8,136,"2023","139"
"41049","MONTESCUDO-MONTE COLOMBO",179,0,0,179,"2023",NA
"41050","MONTESE",115,1286,0,1401,"2023","026"
"41051","MONTESEGALE",24,0,0,24,"2023","098"
"41052","MONTEU DA PO",70,0,0,70,"2023","162"
"41053","MONTEU ROERO",411,0,0,411,"2023","140"
"41054","MONTEVECCHIA",13,0,0,13,"2023","053"
"41055","MONTEVIALE",48,0,0,48,"2023","066"
"41056","MONTEZEMOLO",91,0,0,91,"2023","141"
"41057","MONTICELLI BRUSATI",18,242,2,262,"2023","112"
"41058","MONTICELLI D'ONGINA",263,785,0,1048,"2023","027"
"41059","MONTICELLI PAVESE",1421,328,0,1749,"2023","099"
"41060","MONTICELLO BRIANZA",20,0,95,115,"2023","054"
"41061","MONTICELLO CONTE OTTO",223,791,39,1053,"2023","067"
"41062","MONTICELLO D'ALBA",70,0,0,70,"2023","142"
"41063","MONTICHIARI",8660,6940,468,16068,"2023","113"
"41064","MONTIGLIO MONFERRATO",306,0,0,306,"2023","121"
"41065","MONTIRONE",3937,428,0,4365,"2023","114"
"41066","MONTODINE",88,1165,0,1253,"2023","059"
"41067","MONTORFANO",1,0,0,1,"2023","157"
"41068","MONTORSO VICENTINO",680,105,5,790,"2023","068"
"41069","MONTU' BECCARIA",1,0,0,1,"2023","100"
"41070","MONVALLE",15,0,0,15,"2023","104"
"41071","MONZA",47,48,0,95,"2023",NA
"41072","MONZAMBANO",1349,618,225,2192,"2023","036"
"41073","MONZUNO",23,55,0,78,"2023","044"
"41074","MORANO SUL PO",1,0,0,1,"2023","109"
"41075","MORANSENGO-TONENGO",434,0,0,434,"2023",NA
"41076","MORAZZONE",11,95,27,133,"2023","105"
"41077","MORBEGNO",15,55,3,73,"2023","045"
"41078","MORBELLO",7,0,0,7,"2023","110"
"41079","MORENGO",55,0,0,55,"2023","140"
"41080","MORETTA",1463,384,186,2033,"2023","143"
"41081","MORFASSO",173,6,0,179,"2023","028"
"41082","MORGANO",1704,0,0,1704,"2023","047"
"41083","MORIAGO DELLA BATTAGLIA",1531,63,0,1594,"2023","048"
"41084","MORIMONDO",43,1625,0,1668,"2023","150"
"41085","MORIONDO TORINESE",275,0,0,275,"2023","163"
"41086","MORNAGO",30,0,0,30,"2023","106"
"41087","MORNESE",40,0,0,40,"2023","111"
"41088","MORNICO AL SERIO",401,533,0,934,"2023","141"
"41089","MORNICO LOSANA",9,0,0,9,"2023","101"
"41090","MOROZZO",2228,495,314,3037,"2023","144"
"41091","MORSASCO",226,0,0,226,"2023","112"
"41092","MORTARA",55,0,0,55,"2023","102"
"41093","MORTERONE",5,0,13,18,"2023","055"
"41094","MOSCAZZANO",7,1342,0,1349,"2023","060"
"41095","MOTTA BALUFFI",3,116,0,119,"2023","061"
"41096","MOTTA DI LIVENZA",20,12,0,32,"2023","049"
"41097","MOTTALCIATA",68,29,1,98,"2023","037"
"41098","MOTTEGGIANA",1,2110,60,2171,"2023","037"
"41099","MOZZANICA",17,617,0,634,"2023","142"
"41100","MOZZATE",12,81,0,93,"2023","159"
"41101","MOZZECANE",3345,1535,0,4880,"2023","051"
"41102","MULAZZANO",14,787,0,801,"2023","041"
"41103","MURA",30,1,24,55,"2023","115"
"41104","MURAZZANO",272,0,24,296,"2023","145"
"41105","MURELLO",415,1196,190,1801,"2023","146"
"41106","MURISENGO",398,0,0,398,"2023","113"
"41107","MUSCOLINE",353,561,9,923,"2023","116"
"41108","MUSILE DI PIAVE",15,7,0,22,"2023","025"
"41109","MUSSO",2,0,4,6,"2023","160"
"41110","MUSSOLENTE",191,214,0,405,"2023","070"
"41111","MUZZANO",24,0,1,25,"2023","038"
"41112","NANTO",302,201,0,503,"2023","071"
"41113","NARZOLE",1757,174,0,1931,"2023","147"
"41114","NAVE",43,182,14,239,"2023","117"
"41115","NEBBIUNO",29,0,15,44,"2023","103"
"41116","NEGRAR DI VALPOLICELLA",8,84,8,100,"2023",NA
"41117","NEIVE",16,0,0,16,"2023","148"
"41118","NEMBRO",60,0,0,60,"2023","144"
"41119","NERVESA DELLA BATTAGLIA",615,174,17,806,"2023","050"
"41120","NERVIANO",42,91,0,133,"2023","154"
"41121","NESSO",0,7,0,7,"2023","161"
"41122","NETRO",102,35,5,142,"2023","039"
"41123","NEVIANO DEGLI ARDUINI",57,1909,0,1966,"2023","024"
"41124","NEVIGLIE",2,0,0,2,"2023","149"
"41125","NIARDO",20,137,14,171,"2023","118"
"41126","NICHELINO",30,0,20,50,"2023","164"
"41127","NICORVO",1,0,0,1,"2023","103"
"41128","NIELLA BELBO",130,0,0,130,"2023","150"
"41129","NIELLA TANARO",588,0,0,588,"2023","151"
"41130","NIZZA MONFERRATO",36,4,0,40,"2023","080"
"41131","NOALE",343,62,1,406,"2023","026"
"41132","NOASCA",4,0,41,45,"2023","165"
"41133","NOCETO",56,3633,0,3689,"2023","025"
"41134","NOGARA",2821,544,0,3365,"2023","053"
"41135","NOGAROLE ROCCA",255,361,0,616,"2023","054"
"41136","NOGAROLE VICENTINO",10,10,0,20,"2023","072"
"41137","NOLE",221,42,99,362,"2023","166"
"41138","NONANTOLA",54,106,0,160,"2023","027"
"41139","NONE",732,1298,275,2305,"2023","168"
"41140","NONIO",18,0,0,18,"2023",NA
"41141","NOSATE",15,0,0,15,"2023","155"
"41142","NOVA MILANESE",0,77,0,77,"2023",NA
"41143","NOVAFELTRIA",1092,232,0,1324,"2023","023"
"41144","NOVALESA",61,19,6,86,"2023","169"
"41145","NOVARA",35,281,0,316,"2023","106"
"41146","NOVATE MEZZOLA",6,0,18,24,"2023","046"
"41147","NOVE",17,210,0,227,"2023","073"
"41148","NOVEDRATE",229,0,0,229,"2023","163"
"41149","NOVELLARA",3538,2255,0,5793,"2023","028"
"41150","NOVELLO",841,0,0,841,"2023","152"
"41151","NOVENTA DI PIAVE",2,5,0,7,"2023","027"
"41152","NOVENTA PADOVANA",3,0,0,3,"2023","058"
"41153","NOVENTA VICENTINA",3053,0,0,3053,"2023","074"
"41154","NOVI DI MODENA",831,770,0,1601,"2023","028"
"41155","NOVI LIGURE",741,0,0,741,"2023","114"
"41156","NOVIGLIO",15,406,0,421,"2023","158"
"41157","NUVOLENTO",7,1154,0,1161,"2023","119"
"41158","NUVOLERA",1059,440,0,1499,"2023","120"
"41159","OCCHIEPPO INFERIORE",12,123,0,135,"2023","040"
"41160","OCCHIEPPO SUPERIORE",16,38,31,85,"2023","041"
"41161","OCCHIOBELLO",6,133,0,139,"2023","033"
"41162","OCCIMIANO",33,0,0,33,"2023","115"
"41163","ODALENGO GRANDE",120,0,0,120,"2023","116"
"41164","ODERZO",27,293,0,320,"2023","051"
"41165","ODOLO",7,0,6,13,"2023","121"
"41166","OFFANENGO",263,801,4,1068,"2023","062"
"41167","OFFLAGA",4,4135,0,4139,"2023","122"
"41168","OGGEBBIO",2,0,0,2,"2023","049"
"41169","OGGIONA CON SANTO STEFANO",0,21,0,21,"2023","107"
"41170","OGGIONO",64,0,19,83,"2023","057"
"41171","OGLIANICO",111,307,0,418,"2023","170"
"41172","OLEGGIO",217,1130,26,1373,"2023","108"
"41173","OLEGGIO CASTELLO",2,0,0,2,"2023","109"
"41174","OLGIATE COMASCO",41,34,19,94,"2023","165"
"41175","OLGIATE MOLGORA",20,63,0,83,"2023","058"
"41176","OLGIATE OLONA",2,0,0,2,"2023","108"
"41177","OLGINATE",9,0,0,9,"2023","059"
"41178","OLIVA GESSI",7,5,0,12,"2023",NA
"41179","OLIVETO LARIO",21,0,3,24,"2023","060"
"41180","OLMENETA",17,551,0,568,"2023","063"
"41181","OLMO AL BREMBO",1,5,0,6,"2023","145"
"41182","OLMO GENTILE",57,0,8,65,"2023","081"
"41183","OLTRE IL COLLE",19,77,0,96,"2023","146"
"41184","OLTRESSENDA ALTA",4,38,0,42,"2023","147"
"41185","OLTRONA DI SAN MAMETTE",29,0,0,29,"2023","169"
"41186","OME",10,4,0,14,"2023","123"
"41187","OMEGNA",52,0,0,52,"2023","050"
"41188","ONETA",8,37,0,45,"2023","148"
"41189","ONO SAN PIETRO",1,7,2,10,"2023","124"
"41190","ONORE",0,18,0,18,"2023","149"
"41191","OPERA",0,114,0,114,"2023","159"
"41192","OPPEANO",5595,649,0,6244,"2023","055"
"41193","ORBASSANO",484,0,3,487,"2023","171"
"41194","ORGIANO",264,26,0,290,"2023","075"
"41195","ORIGGIO",109,0,0,109,"2023","109"
"41196","ORIO LITTA",2,119,3,124,"2023","042"
"41197","ORMEA",128,0,34,162,"2023","155"
"41198","ORMELLE",21,26,0,47,"2023","052"
"41199","ORNAGO",11,53,0,64,"2023",NA
"41200","ORNAVASSO",26,0,0,26,"2023","051"
"41201","ORNICA",3,0,0,3,"2023","151"
"41202","ORSAGO",2,16,0,18,"2023","053"
"41203","ORSARA BORMIDA",13,0,0,13,"2023","119"
"41204","ORSENIGO",3,52,6,61,"2023","170"
"41205","ORTA SAN GIULIO",1,0,0,1,"2023","112"
"41206","ORZINUOVI",522,4890,10,5422,"2023","125"
"41207","ORZIVECCHI",2,903,0,905,"2023","126"
"41208","OSASCO",326,0,93,419,"2023","173"
"41209","OSASIO",287,113,131,531,"2023","174"
"41210","OSIO SOPRA",4,579,0,583,"2023","152"
"41211","OSIO SOTTO",4,0,0,4,"2023","153"
"41212","OSNAGO",181,69,0,250,"2023","061"
"41213","OSPEDALETTO EUGANEO",219,0,0,219,"2023","059"
"41214","OSPEDALETTO LODIGIANO",0,859,0,859,"2023","043"
"41215","OSPITALETTO",193,135,0,328,"2023","127"
"41216","OSSAGO LODIGIANO",36,1582,0,1618,"2023","044"
"41217","OSSIMO",3,7,4,14,"2023","128"
"41218","OSSONA",55,0,0,55,"2023","164"
"41219","OSTELLATO",4930,0,0,4930,"2023","017"
"41220","OSTIANO",327,1270,0,1597,"2023","064"
"41221","OSTIGLIA",63,53,0,116,"2023","038"
"41222","OTTIGLIO",177,0,0,177,"2023","120"
"41223","OTTOBIANO",0,38,0,38,"2023","106"
"41224","OTTONE",263,2,0,265,"2023","030"
"41225","OULX",51,0,0,51,"2023","175"
"41226","OVADA",41,0,0,41,"2023","121"
"41227","OVIGLIO",75,13,0,88,"2023","122"
"41228","OZEGNA",236,0,0,236,"2023","176"
"41229","OZZANO DELL'EMILIA",225,232,0,457,"2023","046"
"41230","OZZANO MONFERRATO",134,0,0,134,"2023","123"
"41231","OZZERO",9,33,49,91,"2023","165"
"41232","PADENGHE SUL GARDA",42,0,10,52,"2023","129"
"41233","PADERNO D'ADDA",0,18,0,18,"2023","062"
"41234","PADERNO DUGNANO",3,0,0,3,"2023","166"
"41235","PADERNO FRANCIACORTA",83,148,59,290,"2023","130"
"41236","PADERNO PONCHIELLI",139,1820,128,2087,"2023","065"
"41237","PADOVA",477,234,47,758,"2023","060"
"41238","PAESANA",674,10,0,684,"2023","157"
"41239","PAESE",2118,513,182,2813,"2023","055"
"41240","PAGNO",55,0,0,55,"2023","158"
"41241","PAGNONA",0,5,2,7,"2023","063"
"41242","PAISCO LOVENO",2,13,5,20,"2023","131"
"41243","PAITONE",13,11,1,25,"2023","132"
"41244","PALADINA",10,0,0,10,"2023","155"
"41245","PALAGANO",35,585,0,620,"2023","029"
"41246","PALANZANO",13,477,0,490,"2023","026"
"41247","PALAZZAGO",135,59,0,194,"2023","156"
"41248","PALAZZO CANAVESE",15,0,0,15,"2023","177"
"41249","PALAZZO PIGNANO",20,733,0,753,"2023","066"
"41250","PALAZZOLO SULL'OGLIO",1011,1310,82,2403,"2023","133"
"41251","PALAZZOLO VERCELLESE",12,0,0,12,"2023","090"
"41252","PALESTRO",2,0,24,26,"2023","107"
"41253","PALLANZENO",67,0,0,67,"2023","052"
"41254","PALOSCO",441,453,0,894,"2023","157"
"41255","PALU'",218,0,0,218,"2023","056"
"41256","PAMPARATO",49,0,0,49,"2023","159"
"41257","PANCALIERI",187,26,0,213,"2023","178"
"41258","PANDINO",7,3498,0,3505,"2023","067"
"41259","PANTIGLIATE",1,0,0,1,"2023","167"
"41260","PAPOZZE",2,171,0,173,"2023","034"
"41261","PARABIAGO",60,39,0,99,"2023","168"
"41262","PARATICO",9,49,0,58,"2023","134"
"41263","PARETO",71,2,0,73,"2023","125"
"41264","PARMA",124,9794,0,9918,"2023","027"
"41265","PARODI LIGURE",53,0,43,96,"2023","126"
"41266","PAROLDO",20,0,3,23,"2023","160"
"41267","PARRE",31,73,0,104,"2023","158"
"41268","PARUZZARO",37,35,0,72,"2023","114"
"41269","PARZANICA",7,17,0,24,"2023","159"
"41270","PASPARDO",3,3,1,7,"2023","135"
"41271","PASSERANO MARMORITO",94,0,0,94,"2023","082"
"41272","PASSIRANO",71,148,0,219,"2023","136"
"41273","PASTRENGO",0,97,0,97,"2023","057"
"41274","PASTURANA",2,0,0,2,"2023",NA
"41275","PASTURO",77,110,41,228,"2023","065"
"41276","PAULLO",0,495,0,495,"2023","169"
"41277","PAVAROLO",42,0,0,42,"2023","180"
"41278","PAVIA",83,263,1,347,"2023","110"
"41279","PAVONE CANAVESE",112,0,0,112,"2023","181"
"41280","PAVONE DEL MELLA",2725,249,2,2976,"2023","137"
"41281","PAVULLO NEL FRIGNANO",196,3674,0,3870,"2023","030"
"41282","PECETTO DI VALENZA",24,0,0,24,"2023","128"
"41283","PECETTO TORINESE",86,0,0,86,"2023","183"
"41284","PEDAVENA",3,124,4,131,"2023","036"
"41285","PEDEMONTE",1,0,11,12,"2023","076"
"41286","PEDEROBBA",46,121,0,167,"2023","056"
"41287","PEDRENGO",29,257,0,286,"2023","160"
"41288","PEGLIO",1,7,9,17,"2023","178"
"41289","PEGOGNAGA",1547,3773,146,5466,"2023","039"
"41290","PEIA",10,12,0,22,"2023","161"
"41291","PELLEGRINO PARMENSE",123,697,0,820,"2023","028"
"41292","PENANGO",59,0,0,59,"2023","083"
"41293","PENNABILLI",514,0,0,514,"2023","024"
"41294","PERLEDO",1,0,0,1,"2023","067"
"41295","PERLETTO",170,0,0,170,"2023","161"
"41296","PERLO",30,0,0,30,"2023","162"
"41297","PERNUMIA",18,137,0,155,"2023","061"
"41298","PEROSA ARGENTINA",60,0,2,62,"2023","184"
"41299","PEROSA CANAVESE",145,198,0,343,"2023","185"
"41300","PERRERO",28,0,0,28,"2023","186"
"41301","PERSICO DOSIMO",2,1691,70,1763,"2023","068"
"41302","PERTICA ALTA",22,12,3,37,"2023","139"
"41303","PERTICA BASSA",41,41,21,103,"2023","140"
"41304","PERTUSIO",70,0,9,79,"2023","187"
"41305","PESCANTINA",147,19,0,166,"2023","058"
"41306","PESCAROLO ED UNITI",19,742,0,761,"2023","069"
"41307","PESCHIERA BORROMEO",77,366,0,443,"2023","171"
"41308","PESSANO CON BORNAGO",44,144,0,188,"2023","172"
"41309","PESSINA CREMONESE",523,3109,155,3787,"2023","070"
"41310","PETTENASCO",6,0,0,6,"2023","116"
"41311","PETTINENGO",1,25,0,26,"2023","042"
"41312","PETTORAZZA GRIMANI",6,187,0,193,"2023","035"
"41313","PEVERAGNO",968,431,15,1414,"2023","163"
"41314","PEZZAZE",39,23,0,62,"2023","141"
"41315","PEZZOLO VALLE UZZONE",46,0,0,46,"2023","164"
"41316","PIACENZA",483,1759,0,2242,"2023","032"
"41317","PIACENZA D'ADIGE",587,0,0,587,"2023","062"
"41318","PIADENA DRIZZONA",78,794,83,955,"2023",NA
"41319","PIAN CAMUNO",0,271,0,271,"2023","142"
"41320","PIANCOGNO",0,123,4,127,"2023","206"
"41321","PIANELLO DEL LARIO",12,0,5,17,"2023","183"
"41322","PIANELLO VAL TIDONE",612,106,0,718,"2023","033"
"41323","PIANENGO",1,264,0,265,"2023","072"
"41324","PIANEZZA",237,359,126,722,"2023","189"
"41325","PIANEZZE",131,93,0,224,"2023","077"
"41326","PIANFEI",825,34,12,871,"2023","165"
"41327","PIANICO",9,79,0,88,"2023","162"
"41328","PIANIGA",40,3,0,43,"2023","028"
"41329","PIANORO",205,143,0,348,"2023","047"
"41330","PIANTEDO",5,237,0,242,"2023","048"
"41331","PIARIO",40,0,0,40,"2023","163"
"41332","PIASCO",221,245,0,466,"2023","166"
"41333","PIATEDA",28,37,0,65,"2023","049"
"41334","PIATTO",17,0,0,17,"2023","043"
"41335","PIAZZA BREMBANA",5,0,0,5,"2023","164"
"41336","PIAZZATORRE",7,0,0,7,"2023","165"
"41337","PIAZZOLA SUL BRENTA",2752,1005,0,3757,"2023","063"
"41338","PIEA",94,0,0,94,"2023","084"
"41339","PIEDIMULERA",0,21,0,21,"2023","053"
"41340","PIERANICA",40,40,0,80,"2023","073"
"41341","PIETRA DE' GIORGI",9,0,0,9,"2023","111"
"41342","PIEVE D'OLMI",0,2132,0,2132,"2023","074"
"41343","PIEVE DEL CAIRO",0,58,0,58,"2023","113"
"41344","PIEVE DEL GRAPPA",1061,719,22,1802,"2023",NA
"41345","PIEVE DI CADORE",2,18,0,20,"2023","039"
"41346","PIEVE DI SOLIGO",27,118,4,149,"2023","057"
"41347","PIEVE EMANUELE",0,298,182,480,"2023","173"
"41348","PIEVE FISSIRAGA",251,1196,0,1447,"2023","045"
"41349","PIEVE PORTO MORONE",147,0,0,147,"2023","114"
"41350","PIEVE SAN GIACOMO",0,1921,0,1921,"2023","075"
"41351","PIEVE VERGONTE",46,4,61,111,"2023","054"
"41352","PIEVEPELAGO",47,85,0,132,"2023","031"
"41353","PINAROLO PO",2442,0,0,2442,"2023","115"
"41354","PINASCA",122,0,42,164,"2023","190"
"41355","PINCARA",381,0,0,381,"2023","036"
"41356","PINEROLO",1507,157,159,1823,"2023","191"
"41357","PINO TORINESE",373,0,42,415,"2023","192"
"41358","PIOBESI TORINESE",415,988,287,1690,"2023","193"
"41359","PIODE",0,5,0,5,"2023","097"
"41360","PIOMBINO DESE",3975,158,2,4135,"2023","064"
"41361","PIOSSASCO",327,958,44,1329,"2023","194"
"41362","PIOVA' MASSAIA",262,0,0,262,"2023","086"
"41363","PIOVE DI SACCO",4006,133,0,4139,"2023","065"
"41364","PIOVENE ROCCHETTE",1846,133,2,1981,"2023","078"
"41365","PIOZZANO",333,0,0,333,"2023","034"
"41366","PIOZZO",285,0,0,285,"2023","169"
"41367","PISCINA",1461,0,0,1461,"2023","195"
"41368","PISOGNE",15,195,15,225,"2023","143"
"41369","PIUBEGA",4956,1134,134,6224,"2023","041"
"41370","PIURO",27,211,0,238,"2023","050"
"41371","PIVERONE",72,16,34,122,"2023","196"
"41372","PIZZIGHETTONE",76,2880,0,2956,"2023","076"
"41373","POCAPAGLIA",101,32,0,133,"2023","170"
"41374","PODENZANO",52,662,0,714,"2023","035"
"41375","POGGIO RENATICO",21,597,0,618,"2023","018"
"41376","POGGIO RUSCO",332,1000,15,1347,"2023","042"
"41377","POGGIO TORRIANA",351,0,0,351,"2023",NA
"41378","POGGIRIDENTI",8,0,0,8,"2023","051"
"41379","POGNANO",104,305,0,409,"2023","167"
"41380","POIRINO",3326,431,0,3757,"2023","197"
"41381","POJANA MAGGIORE",1170,32,0,1202,"2023","079"
"41382","POLAVENO",26,21,0,47,"2023","144"
"41383","POLESINE ZIBELLO",52,1664,0,1716,"2023",NA
"41384","POLINAGO",70,667,0,737,"2023","032"
"41385","POLLONE",193,47,0,240,"2023","046"
"41386","POLONGHERA",185,143,74,402,"2023","171"
"41387","POLPENAZZE DEL GARDA",7,118,0,125,"2023","145"
"41388","POLVERARA",3,11,0,14,"2023","066"
"41389","POMARETTO",30,0,14,44,"2023","198"
"41390","POMARO MONFERRATO",7,0,240,247,"2023","131"
"41391","POMBIA",2,12,0,14,"2023","121"
"41392","POMPIANO",17,1473,0,1490,"2023","146"
"41393","POMPONESCO",21,428,13,462,"2023","043"
"41394","PONCARALE",410,617,38,1065,"2023","147"
"41395","PONDERANO",57,33,37,127,"2023","047"
"41396","PONNA",3,2,3,8,"2023","187"
"41397","PONSO",10,0,0,10,"2023","067"
"41398","PONT CANAVESE",37,36,1,74,"2023",NA
"41399","PONTE DELL'OLIO",229,116,0,345,"2023","036"
"41400","PONTE DI LEGNO",9,2,1,12,"2023","148"
"41401","PONTE DI PIAVE",52,30,1,83,"2023","058"
"41402","PONTE IN VALTELLINA",25,1,0,26,"2023","052"
"41403","PONTE LAMBRO",8,3,0,11,"2023","188"
"41404","PONTE NELLE ALPI",21,57,0,78,"2023","040"
"41405","PONTE NIZZA",173,28,0,201,"2023","117"
"41406","PONTE NOSSA",0,26,0,26,"2023","168"
"41407","PONTE SAN NICOLO'",1,42,0,43,"2023","069"
"41408","PONTE SAN PIETRO",4,0,0,4,"2023","170"
"41409","PONTECCHIO POLESINE",1743,0,0,1743,"2023","038"
"41410","PONTECHIANALE",34,0,0,34,"2023","172"
"41411","PONTECURONE",7,0,0,7,"2023","132"
"41412","PONTELONGO",362,0,2,364,"2023","068"
"41413","PONTENURE",48,155,0,203,"2023","037"
"41414","PONTERANICA",2,0,0,2,"2023","169"
"41415","PONTESTURA",26,0,0,26,"2023","133"
"41416","PONTEVICO",215,3412,318,3945,"2023","149"
"41417","PONTI",120,0,10,130,"2023","134"
"41418","PONTI SUL MINCIO",130,379,37,546,"2023","044"
"41419","PONTIDA",46,0,0,46,"2023","171"
"41420","PONTIROLO NUOVO",213,581,0,794,"2023","172"
"41421","PONTOGLIO",625,1519,0,2144,"2023","150"
"41422","PONZANO MONFERRATO",53,0,0,53,"2023","135"
"41423","PONZANO VENETO",294,121,0,415,"2023","059"
"41424","PONZONE",40,0,6,46,"2023","136"
"41425","PORLEZZA",7,21,12,40,"2023","189"
"41426","PORTACOMARO",53,0,0,53,"2023","087"
"41427","PORTALBERA",2,0,0,2,"2023","118"
"41428","PORTE",16,0,0,16,"2023","200"
"41429","PORTICO E SAN BENEDETTO",127,0,0,127,"2023","031"
"41430","PORTO CERESIO",1,0,0,1,"2023","113"
"41431","PORTO MANTOVANO",1747,1228,1431,4406,"2023","045"
"41432","PORTO TOLLE",7,0,0,7,"2023","039"
"41433","PORTO VALTRAVAGLIA",9,0,15,24,"2023","114"
"41434","PORTO VIRO",4321,0,0,4321,"2023","052"
"41435","PORTOBUFFOLE'",0,0,1,1,"2023","060"
"41436","PORTOGRUARO",1103,74,0,1177,"2023","029"
"41437","PORTOMAGGIORE",1274,356,0,1630,"2023","019"
"41438","PORTULA",1,0,0,1,"2023","048"
"41439","POSINA",1,13,0,14,"2023","080"
"41440","POSSAGNO",8,9,0,17,"2023","061"
"41441","POSTALESIO",1,0,0,1,"2023","053"
"41442","POSTUA",7,0,0,7,"2023","102"
"41443","POVE DEL GRAPPA",23,0,0,23,"2023","081"
"41444","POVEGLIANO",169,173,2,344,"2023","062"
"41445","POVEGLIANO VERONESE",2512,492,1,3005,"2023","060"
"41446","POVIGLIO",10,1441,0,1451,"2023","029"
"41447","POZZAGLIO ED UNITI",30,2083,200,2313,"2023","077"
"41448","POZZO D'ADDA",334,0,0,334,"2023","177"
"41449","POZZOL GROPPO",56,0,0,56,"2023","137"
"41450","POZZOLENGO",529,371,12,912,"2023","151"
"41451","POZZOLEONE",113,2110,18,2241,"2023","082"
"41452","POZZOLO FORMIGARO",172,0,0,172,"2023","138"
"41453","POZZONOVO",1754,0,0,1754,"2023","070"
"41454","POZZUOLO MARTESANA",7,230,0,237,"2023","178"
"41455","PRADALUNGA",40,0,0,40,"2023","173"
"41456","PRADLEVES",0,18,0,18,"2023","173"
"41457","PRAGELATO",9,0,0,9,"2023","201"
"41458","PRALBOINO",1762,703,50,2515,"2023","152"
"41459","PRALI",33,0,10,43,"2023","202"
"41460","PRALORMO",1043,186,217,1446,"2023","203"
"41461","PRALUNGO",66,0,17,83,"2023","049"
"41462","PRAMAGGIORE",3,1,0,4,"2023","030"
"41463","PRAMOLLO",8,0,0,8,"2023","204"
"41464","PRAROSTINO",26,3,0,29,"2023","205"
"41465","PRASCO",46,0,0,46,"2023","139"
"41466","PRASCORSANO",1,0,0,1,"2023","206"
"41467","PRATA CAMPORTACCIO",30,129,37,196,"2023","054"
"41468","PRATIGLIONE",1,0,0,1,"2023","207"
"41469","PRATO SESIA",1,7,0,8,"2023","122"
"41470","PRAY",66,0,0,66,"2023","050"
"41471","PRAZZO",85,21,27,133,"2023","174"
"41472","PREDAPPIO",438,2,0,440,"2023","032"
"41473","PREDORE",45,0,0,45,"2023","174"
"41474","PREDOSA",556,101,0,657,"2023","140"
"41475","PREGANZIOL",16,175,0,191,"2023","063"
"41476","PREGNANA MILANESE",5,119,0,124,"2023","179"
"41477","PREMANA",2,4,2,8,"2023","069"
"41478","PREMIA",28,219,1,248,"2023","056"
"41479","PREMILCUORE",587,0,18,605,"2023","033"
"41480","PREMOLO",22,8,0,30,"2023","175"
"41481","PREMOSELLO-CHIOVENDA",14,0,0,14,"2023","057"
"41482","PRESEGLIE",93,0,8,101,"2023","153"
"41483","PRESSANA",3673,0,37,3710,"2023","061"
"41484","PREVALLE",17,636,15,668,"2023","155"
"41485","PRIERO",27,0,0,27,"2023","175"
"41486","PRIGNANO SULLA SECCHIA",144,1360,0,1504,"2023","033"
"41487","PRIMALUNA",21,36,14,71,"2023","070"
"41488","PRIOCCA",647,0,0,647,"2023","176"
"41489","PRIOLA",83,0,0,83,"2023","177"
"41490","PROSERPIO",1,5,0,6,"2023","192"
"41491","PROVAGLIO D'ISEO",126,173,0,299,"2023","156"
"41492","PROVAGLIO VAL SABBIA",22,0,13,35,"2023","157"
"41493","PRUNETTO",55,0,0,55,"2023","178"
"41494","PUEGNAGO SUL GARDA",15,71,0,86,"2023","158"
"41495","PUMENENGO",2192,833,0,3025,"2023","177"
"41496","QUAREGNA CERRETO",176,0,0,176,"2023",NA
"41497","QUARGNENTO",892,0,0,892,"2023","141"
"41498","QUARNA SOPRA",3,0,0,3,"2023","058"
"41499","QUARNA SOTTO",14,0,0,14,"2023","059"
"41500","QUARONA",5,0,0,5,"2023","107"
"41501","QUARTO D'ALTINO",4,0,0,4,"2023","031"
"41502","QUASSOLO",23,10,12,45,"2023","209"
"41503","QUATTORDIO",326,0,0,326,"2023","142"
"41504","QUATTRO CASTELLA",3,1390,0,1393,"2023","030"
"41505","QUERO VAS",4,66,3,73,"2023",NA
"41506","QUINCINETTO",33,31,0,64,"2023","210"
"41507","QUINGENTOLE",142,45,67,254,"2023","046"
"41508","QUINTANO",1,415,1,417,"2023","078"
"41509","QUINTO DI TREVISO",133,161,11,305,"2023","064"
"41510","QUINTO VERCELLESE",2,0,0,2,"2023","108"
"41511","QUINTO VICENTINO",22,540,0,562,"2023","083"
"41512","QUINZANO D'OGLIO",176,3232,0,3408,"2023","159"
"41513","QUISTELLO",83,1722,122,1927,"2023","047"
"41514","RACCONIGI",2020,2072,198,4290,"2023","179"
"41515","RANCIO VALCUVIA",4,0,0,4,"2023","115"
"41516","RANCO",0,0,5,5,"2023","116"
"41517","RANICA",23,11,0,34,"2023","178"
"41518","RANZANICO",21,11,0,32,"2023","179"
"41519","RASURA",0,9,0,9,"2023","055"
"41520","RAVENNA",1028,1470,0,2498,"2023","014"
"41521","RE",24,0,0,24,"2023","060"
"41522","REANO",17,0,3,20,"2023","211"
"41523","RECOARO TERME",50,98,0,148,"2023","084"
"41524","REDAVALLE",6,0,0,6,"2023","120"
"41525","REDONDESCO",276,805,840,1921,"2023","048"
"41526","REFRANCORE",27,0,0,27,"2023","089"
"41527","REFRONTOLO",11,32,1,44,"2023","065"
"41528","REGGIO NELL'EMILIA",104,10728,0,10832,"2023","033"
"41529","REGGIOLO",553,2584,0,3137,"2023","032"
"41530","REMEDELLO",7372,2780,4,10156,"2023","160"
"41531","RENATE",1,0,2,3,"2023",NA
"41532","RESANA",2672,53,12,2737,"2023","066"
"41533","REVELLO",7319,1787,208,9314,"2023","180"
"41534","REVIGLIASCO D'ASTI",268,0,0,268,"2023","090"
"41535","REVINE LAGO",13,0,0,13,"2023","067"
"41536","REZZATO",2,672,0,674,"2023","161"
"41537","RHO",21,506,0,527,"2023","182"
"41538","RIBORDONE",6,0,0,6,"2023","212"
"41539","RICENGO",20,3076,0,3096,"2023","079"
"41540","RIESE PIO X",7361,388,1,7750,"2023","068"
"41541","RIFREDDO",1105,5,53,1163,"2023","181"
"41542","RIMELLA",7,9,0,16,"2023","113"
"41543","RIMINI",69,87,0,156,"2023","014"
"41544","RIO SALICETO",962,365,0,1327,"2023","034"
"41545","RIOLO TERME",413,0,0,413,"2023","015"
"41546","RIOLUNATO",55,12,0,67,"2023","035"
"41547","RIPALTA ARPINA",0,512,0,512,"2023","080"
"41548","RIPALTA CREMASCA",6,385,0,391,"2023","081"
"41549","RIPALTA GUERINA",3,508,0,511,"2023","082"
"41550","RIVA DEL PO",1504,90,0,1594,"2023",NA
"41551","RIVA DI SOLTO",5,0,0,5,"2023","180"
"41552","RIVA PRESSO CHIERI",2950,167,166,3283,"2023","215"
"41553","RIVALBA",69,0,0,69,"2023","213"
"41554","RIVALTA DI TORINO",85,0,0,85,"2023","214"
"41555","RIVAMONTE AGORDINO",0,13,0,13,"2023","043"
"41556","RIVANAZZANO",102,0,0,102,"2023","122"
"41557","RIVARA",115,100,0,215,"2023","216"
"41558","RIVAROLO CANAVESE",950,224,547,1721,"2023","217"
"41559","RIVAROLO DEL RE ED UNITI",3268,320,148,3736,"2023","083"
"41560","RIVAROLO MANTOVANO",53,1323,117,1493,"2023","050"
"41561","RIVAROSSA",5,155,0,160,"2023","218"
"41562","RIVERGARO",82,970,0,1052,"2023","038"
"41563","RIVOLI",1230,0,13,1243,"2023","219"
"41564","RIVOLI VERONESE",159,5,0,164,"2023","062"
"41565","RIVOLTA D'ADDA",2127,2365,106,4598,"2023","084"
"41566","ROANA",21,378,0,399,"2023","085"
"41567","ROASCIO",4,0,0,4,"2023","184"
"41568","ROASIO",3,0,0,3,"2023","116"
"41569","ROATTO",261,0,0,261,"2023","091"
"41570","ROBASSOMERO",61,90,22,173,"2023","220"
"41571","ROBBIO",2,170,0,172,"2023","123"
"41572","ROBECCHETTO CON INDUNO",401,216,0,617,"2023","183"
"41573","ROBECCO D'OGLIO",0,3202,0,3202,"2023","085"
"41574","ROBECCO PAVESE",8,0,0,8,"2023","124"
"41575","ROBECCO SUL NAVIGLIO",152,706,54,912,"2023","184"
"41576","ROBELLA",607,0,0,607,"2023","092"
"41577","ROBILANTE",248,0,0,248,"2023","185"
"41578","ROBURENT",17,0,0,17,"2023","186"
"41579","ROCCA CANAVESE",120,0,0,120,"2023","221"
"41580","ROCCA CIGLIE'",8,0,0,8,"2023","188"
"41581","ROCCA D'ARAZZO",278,0,0,278,"2023","093"
"41582","ROCCA DE' BALDI",2667,942,773,4382,"2023","189"
"41583","ROCCA GRIMALDA",10,0,0,10,"2023","147"
"41584","ROCCA PIETORE",0,17,0,17,"2023","044"
"41585","ROCCA SAN CASCIANO",188,0,0,188,"2023","036"
"41586","ROCCA SUSELLA",2,0,0,2,"2023",NA
"41587","ROCCABIANCA",0,1445,0,1445,"2023","030"
"41588","ROCCABRUNA",132,38,8,178,"2023","187"
"41589","ROCCAFORTE LIGURE",73,0,0,73,"2023","146"
"41590","ROCCAFORTE MONDOVI'",1166,0,17,1183,"2023","190"
"41591","ROCCAFRANCA",1877,1789,13,3679,"2023","162"
"41592","ROCCASPARVERA",390,0,0,390,"2023","191"
"41593","ROCCAVERANO",92,0,10,102,"2023","094"
"41594","ROCCAVIONE",22,0,0,22,"2023","192"
"41595","ROCCHETTA LIGURE",1,0,0,1,"2023","148"
"41596","ROCCHETTA PALAFEA",5,0,0,5,"2023","095"
"41597","ROCCHETTA TANARO",545,0,0,545,"2023","096"
"41598","RODANO",30,59,78,167,"2023","185"
"41599","RODDI",80,5,0,85,"2023","194"
"41600","RODDINO",67,0,0,67,"2023","195"
"41601","RODELLO",109,0,0,109,"2023","196"
"41602","RODENGO-SAIANO",14,220,82,316,"2023","163"
"41603","RODERO",4,8,2,14,"2023",NA
"41604","RODIGO",852,1387,1119,3358,"2023","051"
"41605","ROE' VOLCIANO",5,0,0,5,"2023","164"
"41606","ROGENO",23,328,14,365,"2023","072"
"41607","ROGNANO",29,0,0,29,"2023","127"
"41608","ROGNO",12,61,0,73,"2023","182"
"41609","ROGOLO",3,15,0,18,"2023","056"
"41610","ROLETTO",85,87,0,172,"2023","222"
"41611","ROLO",92,270,0,362,"2023","035"
"41612","ROMAGNANO SESIA",17,0,0,17,"2023","130"
"41613","ROMAGNESE",201,0,0,201,"2023","128"
"41614","ROMANENGO",4,2220,0,2224,"2023","086"
"41615","ROMANO CANAVESE",19,0,0,19,"2023","223"
"41616","ROMANO D'EZZELINO",201,480,0,681,"2023","086"
"41617","ROMANO DI LOMBARDIA",64,3637,0,3701,"2023","183"
"41618","ROMENTINO",14,0,0,14,"2023","131"
"41619","RONAGO",9,18,0,27,"2023","199"
"41620","RONCA'",1,0,0,1,"2023","063"
"41621","RONCADE",2251,54,0,2305,"2023","069"
"41622","RONCADELLE",227,741,0,968,"2023","165"
"41623","RONCARO",1,0,0,1,"2023","129"
"41624","RONCO ALL'ADIGE",5219,0,0,5219,"2023","064"
"41625","RONCO BIELLESE",22,31,0,53,"2023","053"
"41626","RONCO BRIANTINO",33,114,0,147,"2023",NA
"41627","RONCOFERRARO",2594,875,311,3780,"2023","052"
"41628","RONCOFREDDO",27,21,0,48,"2023","037"
"41629","RONCOLA",34,45,0,79,"2023","185"
"41630","ROPPOLO",9,0,0,9,"2023","054"
"41631","RORA'",26,0,0,26,"2023","226"
"41632","ROSA'",52,762,4,818,"2023","087"
"41633","ROSATE",3634,476,0,4110,"2023","188"
"41634","ROSIGNANO MONFERRATO",84,0,0,84,"2023","149"
"41635","ROSOLINA",2,0,0,2,"2023","040"
"41636","ROSSA",6,21,0,27,"2023","121"
"41637","ROSSANA",111,31,0,142,"2023","197"
"41638","ROSSANO VENETO",333,179,8,520,"2023","088"
"41639","ROSTA",20,0,70,90,"2023","228"
"41640","ROTA D'IMAGNA",10,30,0,40,"2023","186"
"41641","ROTTOFRENO",845,547,0,1392,"2023","039"
"41642","ROTZO",129,0,6,135,"2023","089"
"41643","ROURE",8,0,0,8,"2023","227"
"41644","ROVASENDA",6,0,0,6,"2023","122"
"41645","ROVATO",1331,2274,20,3625,"2023","166"
"41646","ROVELLASCA",2,56,0,58,"2023","201"
"41647","ROVERBELLA",11900,916,105,12921,"2023","053"
"41648","ROVERCHIARA",4360,0,47,4407,"2023","065"
"41649","ROVERE' VERONESE",228,1000,0,1228,"2023","067"
"41650","ROVEREDO DI GUA'",1554,32,17,1603,"2023","066"
"41651","ROVESCALA",25,0,0,25,"2023","131"
"41652","ROVETTA",51,115,0,166,"2023","187"
"41653","ROVIGO",1447,2,0,1449,"2023","041"
"41654","ROVOLON",167,41,32,240,"2023","071"
"41655","RUBANO",97,12,0,109,"2023","072"
"41656","RUBIANA",10,0,1,11,"2023","229"
"41657","RUBIERA",8,488,0,496,"2023","036"
"41658","RUDIANO",245,1196,0,1441,"2023","167"
"41659","RUEGLIO",82,0,5,87,"2023","230"
"41660","RUFFIA",302,207,200,709,"2023","198"
"41661","RUSSI",8,0,0,8,"2023","016"
"41662","SABBIO CHIESE",11,67,12,90,"2023","168"
"41663","SABBIONETA",2,15,0,17,"2023","054"
"41664","SACCOLONGO",63,512,0,575,"2023","073"
"41665","SAGLIANO MICCA",42,0,0,42,"2023","056"
"41666","SALA BAGANZA",2,119,6,127,"2023","031"
"41667","SALA BIELLESE",6,0,0,6,"2023","057"
"41668","SALA BOLOGNESE",409,0,0,409,"2023","050"
"41669","SALA COMACINA",6,0,0,6,"2023","203"
"41670","SALA MONFERRATO",85,0,0,85,"2023","150"
"41671","SALARA",2,0,0,2,"2023","042"
"41672","SALASSA",21,0,0,21,"2023","231"
"41673","SALBERTRAND",2,0,28,30,"2023","232"
"41674","SALCEDO",793,72,0,865,"2023","090"
"41675","SALE",35,0,0,35,"2023","151"
"41676","SALE DELLE LANGHE",83,0,0,83,"2023","199"
"41677","SALE MARASINO",46,0,27,73,"2023","169"
"41678","SALE SAN GIOVANNI",51,0,0,51,"2023","200"
"41679","SALERANO CANAVESE",2,0,0,2,"2023",NA
"41680","SALERANO SUL LAMBRO",2,184,0,186,"2023","046"
"41681","SALGAREDA",1449,141,0,1590,"2023","070"
"41682","SALICETO",54,0,0,54,"2023","201"
"41683","SALIZZOLE",2303,396,48,2747,"2023","068"
"41684","SALMOUR",212,0,0,212,"2023","202"
"41685","SALO'",0,35,0,35,"2023","170"
"41686","SALSOMAGGIORE TERME",14,1126,0,1140,"2023","032"
"41687","SALTRIO",2,41,0,43,"2023","117"
"41688","SALUDECIO",91,0,0,91,"2023","015"
"41689","SALUGGIA",539,164,0,703,"2023","128"
"41690","SALUSSOLA",560,4,0,564,"2023","058"
"41691","SALUZZO",3415,3440,380,7235,"2023","203"
"41692","SALVIROLA",698,28,0,726,"2023","087"
"41693","SALZANO",331,22,0,353,"2023","032"
"41694","SAMARATE",9,0,0,9,"2023","118"
"41695","SAMBUCO",57,0,0,57,"2023","204"
"41696","SAMOLACO",235,780,33,1048,"2023","057"
"41697","SAMPEYRE",235,84,0,319,"2023","205"
"41698","SAN BARTOLOMEO VAL CAVARGNA",3,0,0,3,"2023","204"
"41699","SAN BASSANO",74,1748,0,1822,"2023","088"
"41700","SAN BELLINO",1184,0,0,1184,"2023","043"
"41701","SAN BENEDETTO BELBO",36,0,0,36,"2023","206"
"41702","SAN BENEDETTO PO",1096,2467,240,3803,"2023","055"
"41703","SAN BENEDETTO VAL DI SAMBRO",362,75,0,437,"2023","051"
"41704","SAN BENIGNO CANAVESE",166,0,1,167,"2023","236"
"41705","SAN BERNARDINO VERBANO",4,0,0,4,"2023","061"
"41706","SAN BIAGIO DI CALLALTA",780,0,0,780,"2023","071"
"41707","SAN BONIFACIO",2032,0,0,2032,"2023","069"
"41708","SAN CARLO CANAVESE",193,124,90,407,"2023","237"
"41709","SAN CESARIO SUL PANARO",15,969,0,984,"2023","036"
"41710","SAN CIPRIANO PO",0,432,0,432,"2023","133"
"41711","SAN CLEMENTE",12,0,0,12,"2023","016"
"41712","SAN COLOMBANO AL LAMBRO",30,284,0,314,"2023","191"
"41713","SAN COLOMBANO BELMONTE",5,15,0,20,"2023","238"
"41714","SAN CRISTOFORO",5,0,0,5,"2023","152"
"41715","SAN DAMIANO D'ASTI",3975,0,0,3975,"2023","097"
"41716","SAN DAMIANO MACRA",41,0,0,41,"2023","207"
"41717","SAN DANIELE PO",19,2010,0,2029,"2023","089"
"41718","SAN DIDERO",0,2,0,2,"2023","239"
"41719","SAN DONA' DI PIAVE",107,310,0,417,"2023","033"
"41720","SAN DONATO MILANESE",8,0,0,8,"2023","192"
"41721","SAN FELICE DEL BENACO",11,0,0,11,"2023","171"
"41722","SAN FELICE SUL PANARO",0,859,0,859,"2023","037"
"41723","SAN FERMO DELLA BATTAGLIA",70,0,5,75,"2023","206"
"41724","SAN FIOR",27,10,5,42,"2023","072"
"41725","SAN FIORANO",0,167,0,167,"2023","047"
"41726","SAN FRANCESCO AL CAMPO",641,330,0,971,"2023","240"
"41727","SAN GENESIO ED UNITI",2,686,0,688,"2023","135"
"41728","SAN GERMANO CHISONE",97,13,2,112,"2023","242"
"41729","SAN GERMANO VERCELLESE",6,0,0,6,"2023","131"
"41730","SAN GERVASIO BRESCIANO",1,270,0,271,"2023","172"
"41731","SAN GIACOMO DELLE SEGNATE",345,317,28,690,"2023","056"
"41732","SAN GIACOMO VERCELLESE",1909,0,0,1909,"2023","035"
"41733","SAN GILLIO",67,87,0,154,"2023","243"
"41734","SAN GIORGIO BIGARELLO",1748,289,90,2127,"2023",NA
"41735","SAN GIORGIO CANAVESE",304,17,0,321,"2023","244"
"41736","SAN GIORGIO DELLE PERTICHE",187,82,0,269,"2023","075"
"41737","SAN GIORGIO DI PIANO",35,0,0,35,"2023","052"
"41738","SAN GIORGIO IN BOSCO",301,549,7,857,"2023","076"
"41739","SAN GIORGIO MONFERRATO",28,0,0,28,"2023","153"
"41740","SAN GIORGIO PIACENTINO",756,972,0,1728,"2023","040"
"41741","SAN GIORGIO SCARAMPI",96,0,0,96,"2023","098"
"41742","SAN GIORIO DI SUSA",2,28,4,34,"2023","245"
"41743","SAN GIOVANNI BIANCO",68,15,0,83,"2023","188"
"41744","SAN GIOVANNI DEL DOSSO",0,341,66,407,"2023","058"
"41745","SAN GIOVANNI ILARIONE",750,0,0,750,"2023","070"
"41746","SAN GIOVANNI IN CROCE",0,440,2,442,"2023","090"
"41747","SAN GIOVANNI IN MARIGNANO",8,0,0,8,"2023","017"
"41748","SAN GIOVANNI IN PERSICETO",19,760,0,779,"2023","053"
"41749","SAN GIOVANNI LUPATOTO",785,88,0,873,"2023","071"
"41750","SAN GIULIANO MILANESE",70,508,92,670,"2023","195"
"41751","SAN GIUSTO CANAVESE",75,0,48,123,"2023","246"
"41752","SAN GREGORIO NELLE ALPI",1,62,2,65,"2023","045"
"41753","SAN LAZZARO DI SAVENA",4,0,0,4,"2023","054"
"41754","SAN LEO",408,109,0,517,"2023","025"
"41755","SAN MARTINO ALFIERI",1,0,0,1,"2023","099"
"41756","SAN MARTINO BUON ALBERGO",163,948,0,1111,"2023","073"
"41757","SAN MARTINO CANAVESE",61,0,0,61,"2023","247"
"41758","SAN MARTINO DALL'ARGINE",0,1521,14,1535,"2023","059"
"41759","SAN MARTINO DEL LAGO",11,0,0,11,"2023","091"
"41760","SAN MARTINO DI LUPARI",2500,373,2,2875,"2023","077"
"41761","SAN MARTINO IN RIO",0,1080,0,1080,"2023","037"
"41762","SAN MARTINO IN STRADA",0,871,2,873,"2023","048"
"41763","SAN MARTINO SICCOMARIO",12,0,0,12,"2023","137"
"41764","SAN MARZANO OLIVETO",99,0,0,99,"2023","100"
"41765","SAN MAURIZIO CANAVESE",166,260,148,574,"2023","248"
"41766","SAN MAURIZIO D'OPAGLIO",6,0,0,6,"2023","133"
"41767","SAN MAURO DI SALINE",96,281,0,377,"2023","074"
"41768","SAN MAURO TORINESE",4,0,0,4,"2023","249"
"41769","SAN MICHELE AL TAGLIAMENTO",2635,48,0,2683,"2023","034"
"41770","SAN MICHELE MONDOVI'",205,0,0,205,"2023","210"
"41771","SAN NAZZARO SESIA",123,0,0,123,"2023","134"
"41772","SAN NAZZARO VAL CAVARGNA",6,0,5,11,"2023","207"
"41773","SAN NICOLO' DI COMELICO",2,13,0,15,"2023","046"
"41774","SAN PAOLO",533,2878,12,3423,"2023","138"
"41775","SAN PAOLO D'ARGON",40,3,0,43,"2023","189"
"41776","SAN PAOLO SOLBRITO",67,0,0,67,"2023","101"
"41777","SAN PELLEGRINO TERME",89,21,0,110,"2023","190"
"41778","SAN PIETRO DI CADORE",0,62,0,62,"2023","047"
"41779","SAN PIETRO DI FELETTO",23,7,6,36,"2023","073"
"41780","SAN PIETRO DI MORUBIO",2,0,0,2,"2023","075"
"41781","SAN PIETRO IN CARIANO",2,0,0,2,"2023","076"
"41782","SAN PIETRO IN CASALE",2,463,0,465,"2023","055"
"41783","SAN PIETRO IN CERRO",88,910,0,998,"2023","041"
"41784","SAN PIETRO IN GU",710,3032,0,3742,"2023","078"
"41785","SAN PIETRO MOSEZZO",1,0,0,1,"2023","135"
"41786","SAN PIETRO MUSSOLINO",19,0,0,19,"2023","094"
"41787","SAN PIETRO VAL LEMINA",8,0,0,8,"2023","250"
"41788","SAN PIETRO VIMINARIO",37,3,0,40,"2023","079"
"41789","SAN POLO D'ENZA",3,670,0,673,"2023","038"
"41790","SAN POLO DI PIAVE",906,50,0,956,"2023","074"
"41791","SAN PONSO",1,48,0,49,"2023","251"
"41792","SAN POSSIDONIO",0,524,0,524,"2023","038"
"41793","SAN PROSPERO",0,410,0,410,"2023","039"
"41794","SAN RAFFAELE CIMENA",40,0,0,40,"2023","252"
"41795","SAN ROCCO AL PORTO",183,572,0,755,"2023","049"
"41796","SAN SALVATORE MONFERRATO",235,0,0,235,"2023","154"
"41797","SAN SEBASTIANO DA PO",449,0,0,449,"2023","253"
"41798","SAN SECONDO DI PINEROLO",377,31,11,419,"2023","254"
"41799","SAN SECONDO PARMENSE",2,1342,0,1344,"2023","033"
"41800","SAN SIRO",4,0,8,12,"2023","248"
"41801","SAN VENDEMIANO",59,103,0,162,"2023","076"
"41802","SAN VITO DI CADORE",2,0,0,2,"2023","051"
"41803","SAN VITO DI LEGUZZANO",422,141,0,563,"2023","096"
"41804","SAN VITTORE OLONA",16,18,0,34,"2023","201"
"41805","SAN ZENO DI MONTAGNA",152,119,16,287,"2023","079"
"41806","SAN ZENO NAVIGLIO",0,445,0,445,"2023","173"
"41807","SAN ZENONE AL LAMBRO",0,979,0,979,"2023","202"
"41808","SAN ZENONE DEGLI EZZELINI",1659,459,4,2122,"2023","077"
"41809","SANDIGLIANO",66,94,13,173,"2023","059"
"41810","SANDRIGO",1375,1617,0,2992,"2023","091"
"41811","SANFRE'",608,0,0,608,"2023","208"
"41812","SANFRONT",2591,219,37,2847,"2023","209"
"41813","SANGANO",53,0,8,61,"2023","241"
"41814","SANGIANO",2,31,0,33,"2023","141"
"41815","SANGUINETTO",2,217,0,219,"2023","072"
"41816","SANNAZZARO DE' BURGONDI",8,30,0,38,"2023","138"
"41817","SANT'AGATA BOLOGNESE",0,610,0,610,"2023","056"
"41818","SANT'AGATA FELTRIA",496,18,0,514,"2023","026"
"41819","SANT'AGATA FOSSILI",44,0,0,44,"2023","156"
"41820","SANT'AGATA SUL SANTERNO",30,0,0,30,"2023","017"
"41821","SANT'ALBANO STURA",4100,813,205,5118,"2023","211"
"41822","SANT'AMBROGIO DI TORINO",58,24,0,82,"2023","255"
"41823","SANT'AMBROGIO DI VALPOLICELLA",3,41,0,44,"2023","077"
"41824","SANT'ANGELO DI PIOVE DI SACCO",336,66,0,402,"2023","082"
"41825","SANT'ANGELO LODIGIANO",52,394,0,446,"2023","050"
"41826","SANT'ANGELO LOMELLINA",0,545,0,545,"2023","144"
"41827","SANT'ANNA D'ALFAEDO",153,1381,118,1652,"2023","078"
"41828","SANT'ANTONINO DI SUSA",2,62,30,94,"2023","256"
"41829","SANT'ELENA",60,0,0,60,"2023","083"
"41830","SANT'ILARIO D'ENZA",2,719,0,721,"2023","039"
"41831","SANT'OMOBONO TERME",160,51,0,211,"2023","192"
"41832","SANT'URBANO",484,0,0,484,"2023","084"
"41833","SANTA BRIGIDA",14,25,0,39,"2023","191"
"41834","SANTA CRISTINA E BISSONE",11,237,0,248,"2023","139"
"41835","SANTA GIULETTA",15,0,0,15,"2023","140"
"41836","SANTA GIUSTINA",754,119,0,873,"2023","048"
"41837","SANTA GIUSTINA IN COLLE",1415,355,1,1771,"2023","080"
"41838","SANTA LUCIA DI PIAVE",31,41,6,78,"2023","075"
"41839","SANTA MARGHERITA DI STAFFORA",35,0,31,66,"2023","142"
"41840","SANTA MARIA DI SALA",61,145,7,213,"2023","035"
"41841","SANTA MARIA HOE'",6,0,0,6,"2023","074"
"41842","SANTA MARIA MAGGIORE",29,8,38,75,"2023","062"
"41843","SANTA SOFIA",571,0,7,578,"2023","043"
"41844","SANTA VITTORIA D'ALBA",40,0,0,40,"2023","212"
"41845","SANTARCANGELO DI ROMAGNA",24,0,0,24,"2023","018"
"41846","SANTENA",201,0,0,201,"2023","257"
"41847","SANTHIA'",304,25,0,329,"2023","133"
"41848","SANTO STEFANO BELBO",6,0,0,6,"2023","213"
"41849","SANTO STEFANO DI CADORE",0,23,5,28,"2023","050"
"41850","SANTO STEFANO LODIGIANO",163,321,4,488,"2023","051"
"41851","SANTO STEFANO ROERO",77,0,0,77,"2023","214"
"41852","SANTO STEFANO TICINO",23,20,0,43,"2023","200"
"41853","SANTO STINO DI LIVENZA",3966,91,1,4058,"2023","036"
"41854","SANTORSO",468,133,0,601,"2023","095"
"41855","SAONARA",267,0,2,269,"2023","085"
"41856","SARCEDO",1287,342,0,1629,"2023","097"
"41857","SAREGO",459,23,0,482,"2023","098"
"41858","SAREZZO",22,26,0,48,"2023","174"
"41859","SARMATO",0,367,0,367,"2023","042"
"41860","SARMEDE",41,12,0,53,"2023","078"
"41861","SARNICO",8,0,0,8,"2023","193"
"41862","SARONNO",7,0,0,7,"2023","119"
"41863","SARSINA",299,0,0,299,"2023","044"
"41864","SASSO MARCONI",117,118,0,235,"2023","057"
"41865","SASSOFELTRIO",43,25,0,68,"2023",NA
"41866","SASSUOLO",20,536,0,556,"2023","040"
"41867","SAUZE D'OULX",33,0,0,33,"2023","259"
"41868","SAUZE DI CESANA",65,0,2,67,"2023","258"
"41869","SAVIGLIANO",11426,4701,252,16379,"2023","215"
"41870","SAVIGNANO SUL PANARO",27,56,0,83,"2023","041"
"41871","SAVIGNANO SUL RUBICONE",57,0,0,57,"2023","045"
"41872","SAVIORE DELL'ADAMELLO",10,19,3,32,"2023","175"
"41873","SCAGNELLO",141,0,54,195,"2023","216"
"41874","SCALDASOLE",0,3,0,3,"2023","147"
"41875","SCALENGHE",1699,2310,187,4196,"2023","260"
"41876","SCANDIANO",35,1086,0,1121,"2023","040"
"41877","SCANDOLARA RAVARA",0,877,0,877,"2023","092"
"41878","SCANDOLARA RIPA D'OGLIO",48,824,266,1138,"2023","093"
"41879","SCANZOROSCIATE",51,0,0,51,"2023","194"
"41880","SCARMAGNO",5,14,0,19,"2023","261"
"41881","SCARNAFIGI",1358,1577,0,2935,"2023","217"
"41882","SCHIAVON",2181,2023,0,4204,"2023","099"
"41883","SCHIGNANO",30,23,6,59,"2023","211"
"41884","SCHILPARIO",5,55,0,60,"2023","195"
"41885","SCHIO",426,214,4,644,"2023","100"
"41886","SCIOLZE",146,0,0,146,"2023","262"
"41887","SCOPELLO",22,6,0,28,"2023","135"
"41888","SCORZE'",3727,41,0,3768,"2023","037"
"41889","SECUGNAGO",0,1288,0,1288,"2023","052"
"41890","SEDICO",1269,111,3,1383,"2023","053"
"41891","SEDRIANO",10,832,0,842,"2023","204"
"41892","SEDRINA",36,16,0,52,"2023","196"
"41893","SEGRATE",16,0,0,16,"2023","205"
"41894","SEGUSINO",10,49,7,66,"2023","079"
"41895","SELLERO",11,15,3,29,"2023","176"
"41896","SELVA DI CADORE",0,4,0,4,"2023","054"
"41897","SELVA DI PROGNO",54,418,65,537,"2023","080"
"41898","SELVAZZANO DENTRO",7,0,11,18,"2023","086"
"41899","SELVINO",3,0,0,3,"2023","197"
"41900","SENIGA",2000,1813,0,3813,"2023","177"
"41901","SENNA COMASCO",17,0,35,52,"2023","212"
"41902","SENNA LODIGIANA",0,893,0,893,"2023","053"
"41903","SEREGNO",4,0,0,4,"2023",NA
"41904","SEREN DEL GRAPPA",65,28,194,287,"2023","055"
"41905","SERGNANO",14,1388,0,1402,"2023","094"
"41906","SERIATE",117,86,0,203,"2023","198"
"41907","SERINA",33,99,0,132,"2023","199"
"41908","SERLE",21,56,22,99,"2023","178"
"41909","SERMIDE E FELONICA",0,359,0,359,"2023",NA
"41910","SERNAGLIA DELLA BATTAGLIA",878,0,3,881,"2023","080"
"41911","SERNIO",5,0,0,5,"2023","059"
"41912","SEROLE",98,0,3,101,"2023","104"
"41913","SERRALUNGA D'ALBA",13,0,0,13,"2023","218"
"41914","SERRALUNGA DI CREA",51,0,0,51,"2023","159"
"41915","SERRAMAZZONI",36,1439,0,1475,"2023","042"
"41916","SERRAVALLE A PO",65,0,143,208,"2023","062"
"41917","SERRAVALLE LANGHE",102,0,0,102,"2023","219"
"41918","SERRAVALLE SCRIVIA",20,0,0,20,"2023","160"
"41919","SERRAVALLE SESIA",15,0,0,15,"2023","137"
"41920","SESTO CALENDE",36,0,5,41,"2023","120"
"41921","SESTO ED UNITI",2,2190,2,2194,"2023","095"
"41922","SESTOLA",99,284,0,383,"2023","043"
"41923","SETTALA",60,350,0,410,"2023","210"
"41924","SETTIME",116,0,0,116,"2023","106"
"41925","SETTIMO MILANESE",17,293,4,314,"2023","211"
"41926","SETTIMO ROTTARO",32,0,0,32,"2023","264"
"41927","SETTIMO TORINESE",403,359,61,823,"2023","265"
"41928","SETTIMO VITTONE",115,114,40,269,"2023","266"
"41929","SEVESO",1,0,0,1,"2023",NA
"41930","SEZZADIO",101,0,0,101,"2023","161"
"41931","SILEA",5,122,0,127,"2023","081"
"41932","SILLAVENGO",34,0,132,166,"2023","138"
"41933","SILVANO D'ORBA",9,0,0,9,"2023","162"
"41934","SILVANO PIETRA",1,0,0,1,"2023",NA
"41935","SINIO",6,1,0,7,"2023","220"
"41936","SIRONE",5,146,2,153,"2023","075"
"41937","SIRTORI",3,0,0,3,"2023","076"
"41938","SISSA TRECASALI",10,723,0,733,"2023",NA
"41939","SIZIANO",130,74,0,204,"2023","150"
"41940","SIZZANO",211,22,55,288,"2023","139"
"41941","SOAVE",69,0,0,69,"2023","081"
"41942","SOGLIANO AL RUBICONE",343,19,0,362,"2023","046"
"41943","SOIANO DEL LAGO",1,0,4,5,"2023","180"
"41944","SOLAGNA",0,18,0,18,"2023","101"
"41945","SOLARO",0,28,0,28,"2023","213"
"41946","SOLAROLO RAINERIO",5,271,0,276,"2023","096"
"41947","SOLBIATE CON CAGNO",6,180,0,186,"2023",NA
"41948","SOLERO",235,0,0,235,"2023","163"
"41949","SOLESINO",2,0,0,2,"2023","087"
"41950","SOLFERINO",637,198,175,1010,"2023","063"
"41951","SOLIERA",30,1055,0,1085,"2023","044"
"41952","SOLIGNANO",77,266,0,343,"2023","035"
"41953","SOLONGHELLO",80,0,0,80,"2023","164"
"41954","SOLTO COLLINA",33,0,0,33,"2023","200"
"41955","SOMAGLIA",1,1266,0,1267,"2023","054"
"41956","SOMANO",37,0,0,37,"2023","221"
"41957","SOMMA LOMBARDO",44,32,0,76,"2023","123"
"41958","SOMMACAMPAGNA",1511,406,44,1961,"2023","082"
"41959","SOMMARIVA DEL BOSCO",1312,551,147,2010,"2023","222"
"41960","SOMMARIVA PERNO",14,0,0,14,"2023","223"
"41961","SOMMO",8,0,0,8,"2023","151"
"41962","SONA",2045,392,98,2535,"2023","083"
"41963","SONCINO",824,5360,153,6337,"2023","097"
"41964","SONDALO",23,72,6,101,"2023","060"
"41965","SONDRIO",49,45,0,94,"2023","061"
"41966","SONGAVAZZO",1,0,0,1,"2023","201"
"41967","SONICO",2,88,13,103,"2023","181"
"41968","SORAGNA",6,1507,0,1513,"2023","036"
"41969","SORBOLO MEZZANI",7,1978,0,1985,"2023",NA
"41970","SORDEVOLO",84,13,0,97,"2023","063"
"41971","SORDIO",0,221,0,221,"2023","055"
"41972","SORESINA",92,1173,210,1475,"2023","098"
"41973","SORGA'",1603,23,0,1626,"2023","084"
"41974","SORICO",17,13,81,111,"2023","216"
"41975","SORISO",11,0,0,11,"2023","140"
"41976","SORISOLE",86,70,0,156,"2023","202"
"41977","SORMANO",42,0,0,42,"2023","217"
"41978","SOSPIRO",55,468,1,524,"2023","099"
"41979","SOSPIROLO",6,74,3,83,"2023","056"
"41980","SOSSANO",6,328,0,334,"2023","102"
"41981","SOSTEGNO",2,18,0,20,"2023","064"
"41982","SOTTO IL MONTE GIOVANNI XXIII",234,0,0,234,"2023","203"
"41983","SOVERE",74,28,0,102,"2023","204"
"41984","SOVERZENE",2,0,0,2,"2023","057"
"41985","SOVIZZO",365,98,1,464,"2023","103"
"41986","SOVRAMONTE",3,68,2,73,"2023","058"
"41987","SPARONE",37,54,0,91,"2023","267"
"41988","SPESSA",20,0,0,20,"2023","152"
"41989","SPIGNO MONFERRATO",163,0,43,206,"2023","165"
"41990","SPILAMBERTO",1801,1386,0,3187,"2023","045"
"41991","SPINADESCO",2,0,0,2,"2023","100"
"41992","SPINEA",8,114,2,124,"2023","038"
"41993","SPINEDA",7,743,0,750,"2023","101"
"41994","SPINETO SCRIVIA",193,0,0,193,"2023","166"
"41995","SPINO D'ADDA",526,1625,224,2375,"2023","102"
"41996","SPINONE AL LAGO",4,0,0,4,"2023","205"
"41997","SPIRANO",6,964,0,970,"2023","206"
"41998","SPRESIANO",21,284,0,305,"2023","082"
"41999","STAGNO LOMBARDO",3,6567,0,6570,"2023","103"
"42000","STANGHELLA",475,0,0,475,"2023","088"
"42001","STAZZANO",7,0,0,7,"2023","167"
"42002","STAZZONA",3,5,0,8,"2023","218"
"42003","STEZZANO",347,391,0,738,"2023","207"
"42004","STIENTA",48,0,0,48,"2023","045"
"42005","STRA",10,0,0,10,"2023","039"
"42006","STRADELLA",5,33,0,38,"2023","153"
"42007","STRAMBINELLO",46,0,0,46,"2023",NA
"42008","STRAMBINO",177,0,0,177,"2023","269"
"42009","STRESA",88,0,0,88,"2023","064"
"42010","STREVI",33,0,0,33,"2023","168"
"42011","STROPPO",4,0,0,4,"2023","224"
"42012","STROZZA",4,0,0,4,"2023","208"
"42013","SUARDI",4,0,0,4,"2023","154"
"42014","SUEGLIO",0,0,1,1,"2023","077"
"42015","SUELLO",3,0,4,7,"2023","078"
"42016","SUISIO",3,109,0,112,"2023","209"
"42017","SULBIATE",60,0,0,60,"2023",NA
"42018","SULZANO",73,199,2,274,"2023","182"
"42019","SUMIRAGO",79,128,0,207,"2023","124"
"42020","SUNO",20,320,1,341,"2023","143"
"42021","SUSA",162,0,4,166,"2023","270"
"42022","SUSEGANA",823,51,0,874,"2023","083"
"42023","SUSTINENTE",776,841,16,1633,"2023","064"
"42024","SUZZARA",2934,1876,75,4885,"2023","065"
"42025","TACENO",2,0,16,18,"2023","079"
"42026","TAGLIO DI PO",8117,0,0,8117,"2023","046"
"42027","TAGLIOLO MONFERRATO",107,0,0,107,"2023","169"
"42028","TAIBON AGORDINO",0,20,0,20,"2023","059"
"42029","TAINO",41,138,0,179,"2023","125"
"42030","TALAMONA",42,108,0,150,"2023","063"
"42031","TALEGGIO",159,23,0,182,"2023","210"
"42032","TAMBRE",6,107,0,113,"2023","060"
"42033","TARANTASCA",2481,797,0,3278,"2023","225"
"42034","TARTANO",67,15,0,82,"2023","064"
"42035","TARZO",34,0,2,36,"2023","084"
"42036","TAVAGNASCO",102,11,0,113,"2023","271"
"42037","TAVAZZANO CON VILLAVESCO",0,1075,0,1075,"2023","056"
"42038","TAVERNOLA BERGAMASCA",9,0,0,9,"2023","211"
"42039","TAVERNOLE SUL MELLA",13,48,9,70,"2023","183"
"42040","TAVIGLIANO",1,0,0,1,"2023","066"
"42041","TEGLIO",117,242,20,379,"2023","065"
"42042","TELGATE",2147,150,0,2297,"2023","212"
"42043","TEMU'",40,7,2,49,"2023","184"
"42044","TEOLO",30,28,0,58,"2023","089"
"42045","TERDOBBIATE",14,137,0,151,"2023","144"
"42046","TERENZO",61,818,0,879,"2023","038"
"42047","TERNO D'ISOLA",10,0,0,10,"2023","213"
"42048","TERRANOVA DEI PASSERINI",49,292,17,358,"2023","057"
"42049","TERRASSA PADOVANA",1621,0,0,1621,"2023","090"
"42050","TERRAZZO",15,0,0,15,"2023","085"
"42051","TERRE DEL RENO",1,0,0,1,"2023",NA
"42052","TERRUGGIA",49,0,0,49,"2023","171"
"42053","TERZO",2,0,0,2,"2023","172"
"42054","TEZZE SUL BRENTA",73,168,0,241,"2023","104"
"42055","THIENE",459,233,0,692,"2023","105"
"42056","TICENGO",1,429,85,515,"2023","104"
"42057","TIGLIOLE",858,0,0,858,"2023","108"
"42058","TIGNALE",12,6,7,25,"2023","185"
"42059","TIRANO",1,11,2,14,"2023","066"
"42060","TIZZANO VAL PARMA",19,815,0,834,"2023","039"
"42061","TOANO",55,1873,0,1928,"2023","041"
"42062","TOCENO",32,4,17,53,"2023","065"
"42063","TOLLEGNO",30,0,11,41,"2023","068"
"42064","TOMBOLO",790,16,0,806,"2023","091"
"42065","TONCO",624,0,0,624,"2023","109"
"42066","TONEZZA DEL CIMONE",1,0,0,1,"2023","106"
"42067","TORBOLE CASAGLIA",27,819,51,897,"2023","186"
"42068","TORINO",157,0,1,158,"2023","272"
"42069","TORLINO VIMERCATI",0,261,0,261,"2023","105"
"42070","TORNACO",0,156,0,156,"2023",NA
"42071","TORNATA",0,155,0,155,"2023","106"
"42072","TORNO",1,0,0,1,"2023","223"
"42073","TORNOLO",137,3,0,140,"2023","040"
"42074","TORRAZZA COSTE",13,0,0,13,"2023","155"
"42075","TORRAZZA PIEMONTE",181,0,0,181,"2023","273"
"42076","TORRAZZO",5,0,0,5,"2023","069"
"42077","TORRE BERETTI E CASTELLARO",30,408,0,438,"2023","156"
"42078","TORRE BOLDONE",4,0,0,4,"2023","214"
"42079","TORRE BORMIDA",11,0,0,11,"2023","226"
"42080","TORRE D'ISOLA",0,988,0,988,"2023","159"
"42081","TORRE DE' BUSI",17,0,0,17,"2023","080"
"42082","TORRE DE' NEGRI",28,0,214,242,"2023","158"
"42083","TORRE DE' PICENARDI",82,2590,0,2672,"2023","107"
"42084","TORRE DE' ROVERI",10,0,0,10,"2023","216"
"42085","TORRE DI MOSTO",3,634,0,637,"2023","041"
"42086","TORRE DI SANTA MARIA",27,6,6,39,"2023","067"
"42087","TORRE MONDOVI'",1,0,0,1,"2023","227"
"42088","TORRE PALLAVICINA",189,359,0,548,"2023","217"
"42089","TORRE PELLICE",63,0,24,87,"2023","275"
"42090","TORRE SAN GIORGIO",48,4,8,60,"2023","228"
"42091","TORREBELVICINO",791,9,0,800,"2023","107"
"42092","TORREGLIA",6,0,0,6,"2023","092"
"42093","TORRESINA",3,0,0,3,"2023","229"
"42094","TORREVECCHIA PIA",96,12,11,119,"2023","160"
"42095","TORRI DI QUARTESOLO",35,135,0,170,"2023","108"
"42096","TORRICELLA VERZATE",1,0,0,1,"2023",NA
"42097","TORRILE",0,2368,0,2368,"2023","041"
"42098","TORTONA",2452,60,0,2512,"2023","174"
"42099","TOSCOLANO-MADERNO",12,0,2,14,"2023","187"
"42100","TOVO DI SANT'AGATA",12,65,1,78,"2023","068"
"42101","TRADATE",14,11,0,25,"2023","127"
"42102","TRANA",79,7,4,90,"2023","276"
"42103","TRAONA",152,202,0,354,"2023","069"
"42104","TRAREGO VIGGIONA",7,0,0,7,"2023","066"
"42105","TRASQUERA",22,0,7,29,"2023","067"
"42106","TRAVAGLIATO",476,407,0,883,"2023","188"
"42107","TRAVEDONA-MONATE",5,0,11,16,"2023","128"
"42108","TRAVERSELLA",21,13,15,49,"2023","278"
"42109","TRAVERSETOLO",82,1086,0,1168,"2023","042"
"42110","TRAVES",10,0,0,10,"2023","279"
"42111","TRAVO",89,29,0,118,"2023","043"
"42112","TREBASELEGHE",7008,70,2,7080,"2023","093"
"42113","TRECATE",0,118,0,118,"2023","149"
"42114","TRECENTA",1,78,46,125,"2023","047"
"42115","TREDOZIO",210,0,0,210,"2023","049"
"42116","TREGNAGO",578,113,0,691,"2023","087"
"42117","TREMEZZINA",35,20,33,88,"2023",NA
"42118","TREMOSINE",19,463,4,486,"2023","189"
"42119","TRENZANO",441,1363,130,1934,"2023","190"
"42120","TRESCORE BALNEARIO",41,48,0,89,"2023","218"
"42121","TRESCORE CREMASCO",19,422,0,441,"2023","109"
"42122","TRESIGNANA",2,0,0,2,"2023",NA
"42123","TRESIVIO",11,11,0,22,"2023","070"
"42124","TREVENZUOLO",505,1099,0,1604,"2023","088"
"42125","TREVIGLIO",999,1620,0,2619,"2023","219"
"42126","TREVIGNANO",1980,238,8,2226,"2023","085"
"42127","TREVILLE",15,0,0,15,"2023","175"
"42128","TREVIOLO",114,35,0,149,"2023","220"
"42129","TREVISO",511,94,7,612,"2023","086"
"42130","TREVISO BRESCIANO",21,33,2,56,"2023","191"
"42131","TREZZO SULL'ADDA",5,329,0,334,"2023","221"
"42132","TREZZO TINELLA",10,0,0,10,"2023","231"
"42133","TREZZONE",1,0,2,3,"2023","226"
"42134","TRIBIANO",0,67,0,67,"2023","222"
"42135","TRIGOLO",0,1023,0,1023,"2023","110"
"42136","TRINITA'",2939,519,176,3634,"2023","232"
"42137","TRINO",7,153,0,160,"2023","148"
"42138","TRISOBBIO",160,0,0,160,"2023","176"
"42139","TRISSINO",63,249,47,359,"2023","110"
"42140","TRIUGGIO",5,258,14,277,"2023",NA
"42141","TROFARELLO",541,50,0,591,"2023","280"
"42142","TROMELLO",19,449,82,550,"2023","164"
"42143","TRONTANO",13,4,0,17,"2023","068"
"42144","TRONZANO VERCELLESE",180,0,0,180,"2023","150"
"42145","TROVO",5,22,0,27,"2023","165"
"42146","TRUCCAZZANO",61,1646,0,1707,"2023","224"
"42147","TURANO LODIGIANO",60,2090,0,2150,"2023","058"
"42148","TURATE",1,0,0,1,"2023","227"
"42149","TURBIGO",0,39,0,39,"2023","226"
"42150","UBIALE CLANEZZO",4,0,0,4,"2023","221"
"42151","UBOLDO",4,0,0,4,"2023","130"
"42152","UGGIATE-TREVANO",25,53,7,85,"2023","228"
"42153","URAGO D'OGLIO",271,1218,0,1489,"2023","192"
"42154","URBANA",785,0,0,785,"2023","095"
"42155","URGNANO",254,172,0,426,"2023","222"
"42156","USMATE VELATE",7,20,2,29,"2023",NA
"42157","USSEAUX",9,33,34,76,"2023","281"
"42158","USSEGLIO",1,0,0,1,"2023","282"
"42159","VAIANO CREMASCO",227,480,0,707,"2023","111"
"42160","VAIE",24,49,0,73,"2023","283"
"42161","VAILATE",45,317,0,362,"2023","112"
"42162","VAL BREMBILLA",112,39,0,151,"2023",NA
"42163","VAL DELLA TORRE",204,0,23,227,"2023","284"
"42164","VAL DI CHY",47,6,0,53,"2023",NA
"42165","VAL DI NIZZA",4,0,0,4,"2023","166"
"42166","VAL DI ZOLDO",10,0,2,12,"2023",NA
"42167","VAL LIONA",358,142,0,500,"2023",NA
"42168","VAL MASINO",1,15,0,16,"2023","074"
"42169","VAL REZZO",29,0,19,48,"2023","233"
"42170","VALBONDIONE",2,10,0,12,"2023","223"
"42171","VALBREMBO",33,39,0,72,"2023","224"
"42172","VALBRENTA",30,17,2,49,"2023",NA
"42173","VALBRONA",8,0,1,9,"2023","229"
"42174","VALCHIUSA",90,90,33,213,"2023",NA
"42175","VALDAGNO",33,146,8,187,"2023","111"
"42176","VALDASTICO",1139,21,0,1160,"2023","112"
"42177","VALDENGO",36,12,0,48,"2023","071"
"42178","VALDIDENTRO",83,83,28,194,"2023","071"
"42179","VALDIERI",2,0,22,24,"2023","233"
"42180","VALDILANA",103,50,30,183,"2023",NA
"42181","VALDISOTTO",53,125,12,190,"2023","072"
"42182","VALDOBBIADENE",45,300,5,350,"2023","087"
"42183","VALEGGIO",64,0,0,64,"2023","167"
"42184","VALEGGIO SUL MINCIO",2074,2225,57,4356,"2023","089"
"42185","VALENZA",131,0,0,131,"2023","177"
"42186","VALERA FRATTA",277,346,0,623,"2023","059"
"42187","VALFENERA",1145,114,248,1507,"2023","112"
"42188","VALFURVA",40,111,1,152,"2023","073"
"42189","VALGANNA",27,0,0,27,"2023","131"
"42190","VALGIOIE",3,0,0,3,"2023",NA
"42191","VALGOGLIO",30,34,0,64,"2023","225"
"42192","VALGRANA",362,0,0,362,"2023","234"
"42193","VALGREGHENTINO",7,0,0,7,"2023","082"
"42194","VALLADA AGORDINA",0,7,0,7,"2023","062"
"42195","VALLE CANNOBINA",1,0,0,1,"2023",NA
"42196","VALLE LOMELLINA",51,789,0,840,"2023","168"
"42197","VALLE SAN NICOLAO",7,0,0,7,"2023","074"
"42198","VALLEVE",0,9,0,9,"2023","226"
"42199","VALLI DEL PASUBIO",3,6,0,9,"2023","113"
"42200","VALLIO TERME",5,0,1,6,"2023","193"
"42201","VALLO TORINESE",24,0,0,24,"2023","286"
"42202","VALMADRERA",15,0,10,25,"2023","083"
"42203","VALMOREA",1,32,0,33,"2023","232"
"42204","VALMOZZOLA",94,12,0,106,"2023","044"
"42205","VALPERGA",139,108,78,325,"2023","287"
"42206","VALSAMOGGIA",272,784,0,1056,"2023",NA
"42207","VALSOLDA",7,1,2,10,"2023","234"
"42208","VALSTRONA",16,0,0,16,"2023","069"
"42209","VALTORTA",0,31,0,31,"2023","229"
"42210","VALVESTINO",0,26,0,26,"2023","194"
"42211","VANZAGO",38,0,0,38,"2023","229"
"42212","VAPRIO D'ADDA",7,442,0,449,"2023","230"
"42213","VARALLO",13,39,0,52,"2023","156"
"42214","VARANO DE' MELEGARI",34,292,0,326,"2023","045"
"42215","VAREDO",1,0,0,1,"2023",NA
"42216","VARESE",119,14,0,133,"2023","133"
"42217","VARISELLA",167,0,0,167,"2023","289"
"42218","VARSI",3,440,0,443,"2023","046"
"42219","VARZI",193,7,0,200,"2023","171"
"42220","VARZO",12,10,9,31,"2023","071"
"42221","VAUDA CANAVESE",34,0,0,34,"2023","290"
"42222","VAZZOLA",1282,55,2,1339,"2023","088"
"42223","VEDANO OLONA",0,188,0,188,"2023","134"
"42224","VEDELAGO",21168,701,169,22038,"2023","089"
"42225","VEDESETA",15,127,0,142,"2023","230"
"42226","VEGGIANO",337,75,0,412,"2023","096"
"42227","VELESO",0,0,3,3,"2023","236"
"42228","VELLEZZO BELLINI",12,313,2,327,"2023","173"
"42229","VELO D'ASTICO",739,20,0,759,"2023","115"
"42230","VELO VERONESE",495,1455,36,1986,"2023","090"
"42231","VENARIA REALE",40,249,0,289,"2023","292"
"42232","VENASCA",46,0,0,46,"2023","237"
"42233","VENAUS",6,0,44,50,"2023","291"
"42234","VENEGONO INFERIORE",0,73,0,73,"2023","136"
"42235","VENEGONO SUPERIORE",2,0,0,2,"2023","137"
"42236","VENEZIA",1636,178,0,1814,"2023","042"
"42237","VENIANO",52,83,0,135,"2023","238"
"42238","VENTASSO",120,384,0,504,"2023",NA
"42239","VERBANIA",63,0,1,64,"2023","072"
"42240","VERCANA",6,3,0,9,"2023","239"
"42241","VERCEIA",13,0,3,16,"2023","075"
"42242","VERCELLI",79,257,0,336,"2023","158"
"42243","VERDELLINO",0,23,0,23,"2023","232"
"42244","VERDELLO",220,91,0,311,"2023","233"
"42245","VERDERIO",23,0,73,96,"2023",NA
"42246","VERGATO",41,0,0,41,"2023","059"
"42247","VERGHERETO",1365,0,0,1365,"2023","050"
"42248","VERGIATE",31,0,0,31,"2023","138"
"42249","VERMEZZO CON ZELO",28,503,0,531,"2023",NA
"42250","VERNANTE",74,0,53,127,"2023","239"
"42251","VERNASCA",62,67,0,129,"2023","044"
"42252","VERNATE",6,68,0,74,"2023","236"
"42253","VEROLANUOVA",769,1859,5,2633,"2023","195"
"42254","VEROLAVECCHIA",6,3628,0,3634,"2023","196"
"42255","VEROLENGO",518,39,0,557,"2023","293"
"42256","VERONA",3478,797,0,4275,"2023","091"
"42257","VERONELLA",4823,267,0,5090,"2023","092"
"42258","VERRETTO",3,0,0,3,"2023","174"
"42259","VERRONE",35,0,0,35,"2023","076"
"42260","VERRUA SAVOIA",506,0,0,506,"2023","294"
"42261","VERTEMATE CON MINOPRIO",7,0,0,7,"2023","242"
"42262","VERTOVA",24,20,0,44,"2023","234"
"42263","VERUCCHIO",232,0,0,232,"2023","020"
"42264","VERVIO",39,49,0,88,"2023","076"
"42265","VERZUOLO",49,0,0,49,"2023","240"
"42266","VESCOVANA",6,0,0,6,"2023","097"
"42267","VESCOVATO",2640,1469,0,4109,"2023","113"
"42268","VESIME",469,0,0,469,"2023","113"
"42269","VESPOLATE",0,138,0,138,"2023","158"
"42270","VESTENANOVA",431,210,1,642,"2023","093"
"42271","VESTIGNE'",7,52,0,59,"2023","295"
"42272","VESTONE",17,0,0,17,"2023","197"
"42273","VETTO",6,341,0,347,"2023","042"
"42274","VEZZA D'ALBA",2,0,0,2,"2023","241"
"42275","VEZZA D'OGLIO",6,177,1,184,"2023","198"
"42276","VEZZANO SUL CROSTOLO",10,88,0,98,"2023","043"
"42277","VIADANA",95,1439,4,1538,"2023","066"
"42278","VIADANICA",8,21,0,29,"2023","235"
"42279","VIALE",307,0,0,307,"2023","114"
"42280","VIALFRE'",15,0,3,18,"2023","296"
"42281","VIANO",1,748,0,749,"2023","044"
"42282","VIARIGI",34,0,0,34,"2023","115"
"42283","VICENZA",151,899,12,1062,"2023","116"
"42284","VICOFORTE",419,0,0,419,"2023","242"
"42285","VIDIGULFO",20,216,0,236,"2023","176"
"42286","VIDOR",15,433,0,448,"2023","090"
"42287","VIDRACCO",3,0,0,3,"2023","298"
"42288","VIGANO SAN MARTINO",13,0,0,13,"2023","236"
"42289","VIGASIO",442,663,1,1106,"2023","094"
"42290","VIGEVANO",116,0,10,126,"2023","177"
"42291","VIGGIU'",37,0,0,37,"2023","139"
"42292","VIGHIZZOLO D'ESTE",88,17,0,105,"2023","098"
"42293","VIGLIANO BIELLESE",1,0,0,1,"2023","077"
"42294","VIGLIANO D'ASTI",68,0,0,68,"2023","116"
"42295","VIGNALE MONFERRATO",215,0,0,215,"2023","179"
"42296","VIGNATE",0,257,0,257,"2023","237"
"42297","VIGNOLA",1,90,0,91,"2023","046"
"42298","VIGNOLE BORBERA",22,0,0,22,"2023","180"
"42299","VIGNOLO",1510,0,0,1510,"2023","243"
"42300","VIGNONE",1,0,0,1,"2023","074"
"42301","VIGO DI CADORE",3,14,0,17,"2023","065"
"42302","VIGODARZERE",184,53,0,237,"2023","099"
"42303","VIGOLO",8,219,1,228,"2023","237"
"42304","VIGOLZONE",86,516,0,602,"2023","045"
"42305","VIGONE",3293,1192,164,4649,"2023","299"
"42306","VIGONOVO",6,0,0,6,"2023","043"
"42307","VIGONZA",67,706,170,943,"2023","100"
"42308","VILLA BARTOLOMEA",278,0,0,278,"2023","095"
"42309","VILLA CARCINA",1,0,0,1,"2023","199"
"42310","VILLA CORTESE",16,0,0,16,"2023","248"
"42311","VILLA D'ADDA",13,0,0,13,"2023","238"
"42312","VILLA D'ALME'",150,9,0,159,"2023","239"
"42313","VILLA D'OGNA",3,25,0,28,"2023","241"
"42314","VILLA DEL CONTE",846,585,2,1433,"2023","101"
"42315","VILLA DI CHIAVENNA",1,25,3,29,"2023","077"
"42316","VILLA DI SERIO",18,0,0,18,"2023","240"
"42317","VILLA DI TIRANO",21,167,18,206,"2023","078"
"42318","VILLA ESTENSE",77,43,0,120,"2023","102"
"42319","VILLA GUARDIA",125,0,27,152,"2023","245"
"42320","VILLA MINOZZO",23,709,0,732,"2023","045"
"42321","VILLA SAN SECONDO",4,0,0,4,"2023","119"
"42322","VILLACHIARA",394,3571,6,3971,"2023","200"
"42323","VILLADEATI",37,0,0,37,"2023","182"
"42324","VILLADOSE",0,0,63,63,"2023","048"
"42325","VILLADOSSOLA",13,0,0,13,"2023","075"
"42326","VILLAFALLETTO",2157,747,293,3197,"2023","244"
"42327","VILLAFRANCA D'ASTI",382,0,0,382,"2023","117"
"42328","VILLAFRANCA DI VERONA",7790,3472,155,11417,"2023","096"
"42329","VILLAFRANCA PADOVANA",746,2253,81,3080,"2023","103"
"42330","VILLAFRANCA PIEMONTE",2565,2330,181,5076,"2023","300"
"42331","VILLAGA",146,204,0,350,"2023","117"
"42332","VILLALVERNIA",1,0,0,1,"2023",NA
"42333","VILLAMARZANA",988,89,0,1077,"2023","049"
"42334","VILLANOVA BIELLESE",417,0,0,417,"2023","079"
"42335","VILLANOVA CANAVESE",25,0,4,29,"2023","301"
"42336","VILLANOVA D'ARDENGHI",2,0,0,2,"2023","179"
"42337","VILLANOVA D'ASTI",4719,65,0,4784,"2023","118"
"42338","VILLANOVA DEL GHEBBO",19,0,0,19,"2023","050"
"42339","VILLANOVA DEL SILLARO",2,1014,0,1016,"2023","060"
"42340","VILLANOVA DI CAMPOSAMPIERO",27,0,5,32,"2023","104"
"42341","VILLANOVA MARCHESANA",0,92,0,92,"2023","051"
"42342","VILLANOVA MONDOVI'",2327,412,144,2883,"2023","245"
"42343","VILLANOVA MONFERRATO",0,0,2,2,"2023","185"
"42344","VILLANOVA SOLARO",293,605,0,898,"2023","246"
"42345","VILLANOVA SULL'ARDA",5,1545,0,1550,"2023","046"
"42346","VILLANTERIO",2,0,230,232,"2023","180"
"42347","VILLANUOVA SUL CLISI",7,0,0,7,"2023","201"
"42348","VILLAR DORA",77,0,31,108,"2023","303"
"42349","VILLAR FOCCHIARDO",14,31,85,130,"2023","305"
"42350","VILLAR PELLICE",265,28,30,323,"2023","306"
"42351","VILLAR PEROSA",10,21,0,31,"2023","307"
"42352","VILLAR SAN COSTANZO",412,232,3,647,"2023","247"
"42353","VILLARBASSE",224,8,1,233,"2023","302"
"42354","VILLARBOIT",1,0,0,1,"2023","163"
"42355","VILLAREGGIA",29,0,0,29,"2023","304"
"42356","VILLAROMAGNANO",56,0,0,56,"2023","186"
"42357","VILLASTELLONE",490,453,158,1101,"2023","308"
"42358","VILLATA",11,23,0,34,"2023","164"
"42359","VILLAVERLA",82,1658,0,1740,"2023","118"
"42360","VILLETTE",23,0,33,56,"2023","076"
"42361","VILLIMPENTA",69,29,1,99,"2023","068"
"42362","VILLONGO",9,0,0,9,"2023","242"
"42363","VILLORBA",127,0,0,127,"2023","091"
"42364","VILMINORE DI SCALVE",12,140,0,152,"2023","243"
"42365","VIMERCATE",2,26,0,28,"2023",NA
"42366","VINADIO",191,0,0,191,"2023","248"
"42367","VINCHIO",1,0,0,1,"2023","120"
"42368","VINOVO",428,157,24,609,"2023","309"
"42369","VINZAGLIO",1,43,0,44,"2023","164"
"42370","VIOLA",62,0,0,62,"2023","249"
"42371","VIONE",19,40,0,59,"2023","202"
"42372","VIRLE PIEMONTE",361,234,174,769,"2023","310"
"42373","VISANO",2347,362,0,2709,"2023","203"
"42374","VISCHE",25,0,0,25,"2023","311"
"42375","VISONE",66,0,0,66,"2023","187"
"42376","VISTARINO",2,0,0,2,"2023","181"
"42377","VISTRORIO",19,0,0,19,"2023","312"
"42378","VITTORIO VENETO",168,131,2,301,"2023","092"
"42379","VITTUONE",1,216,0,217,"2023","243"
"42380","VIU'",39,0,4,43,"2023","313"
"42381","VIVERONE",27,0,0,27,"2023","080"
"42382","VIZZOLO PREDABISSI",15,73,0,88,"2023","244"
"42383","VO'",61,78,0,139,"2023","105"
"42384","VOBARNO",32,104,19,155,"2023","204"
"42385","VOCCA",0,14,0,14,"2023","166"
"42386","VODO CADORE",0,0,21,21,"2023","066"
"42387","VOGHERA",41,0,0,41,"2023","182"
"42388","VOGOGNA",21,0,0,21,"2023","077"
"42389","VOLPAGO DEL MONTELLO",1088,596,28,1712,"2023","093"
"42390","VOLPEDO",3,0,0,3,"2023","188"
"42391","VOLPIANO",271,102,63,436,"2023","314"
"42392","VOLTA MANTOVANA",3326,1183,868,5377,"2023","070"
"42393","VOLTAGGIO",42,0,81,123,"2023","190"
"42394","VOLVERA",1092,223,122,1437,"2023","315"
"42395","VOTTIGNASCO",1596,35,91,1722,"2023","250"
"42396","ZANDOBBIO",14,0,0,14,"2023","244"
"42397","ZANE'",270,84,0,354,"2023","119"
"42398","ZANICA",216,1159,0,1375,"2023","245"
"42399","ZAVATTARELLO",137,0,0,137,"2023","184"
"42400","ZECCONE",13,225,0,238,"2023","185"
"42401","ZELBIO",0,0,9,9,"2023","246"
"42402","ZELO BUON PERSICO",2,1467,0,1469,"2023","061"
"42403","ZEME",152,0,0,152,"2023","186"
"42404","ZENEVREDO",1,0,0,1,"2023","187"
"42405","ZERBOLO'",0,190,0,190,"2023","189"
"42406","ZERMEGHEDO",0,23,0,23,"2023","120"
"42407","ZERO BRANCO",230,157,0,387,"2023","095"
"42408","ZEVIO",3526,477,96,4099,"2023","097"
"42409","ZIANO PIACENTINO",149,0,0,149,"2023","048"
"42410","ZIBIDO SAN GIACOMO",41,292,28,361,"2023","247"
"42411","ZIMELLA",8218,345,0,8563,"2023","098"
"42412","ZINASCO",47,0,0,47,"2023","190"
"42413","ZOCCA",45,737,0,782,"2023","047"
"42414","ZOGNO",128,59,0,187,"2023","246"
"42415","ZOLA PREDOSA",20,170,0,190,"2023","060"
"42416","ZONE",3,31,0,34,"2023","205"
"42417","ZOVENCEDO",6,0,0,6,"2023","121"
"42418","ZUBIENA",52,0,17,69,"2023","082"
"42419","ZUGLIANO",587,118,4,709,"2023","122"
"42420","ZUMAGLIA",8,0,0,8,"2023","083"
"42421","ABANO TERME",44,142,0,186,"2024","001"
"42422","ABBADIA CERRETO",44,1130,0,1174,"2024","001"
"42423","ABBADIA LARIANA",6,21,3,30,"2024","001"
"42424","ABBIATEGRASSO",86,1568,0,1654,"2024","002"
"42425","ACCEGLIO",238,2,0,240,"2024","001"
"42426","ACQUAFREDDA",925,108,0,1033,"2024","001"
"42427","ACQUANEGRA CREMONESE",1,969,0,970,"2024","001"
"42428","ACQUANEGRA SUL CHIESE",1866,773,140,2779,"2024","001"
"42429","ACQUI TERME",192,0,0,192,"2024","001"
"42430","ADRARA SAN MARTINO",56,21,0,77,"2024","001"
"42431","ADRARA SAN ROCCO",18,0,0,18,"2024","002"
"42432","ADRIA",2045,119,0,2164,"2024","001"
"42433","ADRO",454,20,0,474,"2024","002"
"42434","AGAZZANO",135,376,0,511,"2024","001"
"42435","AGLIANO TERME",37,0,0,37,"2024","001"
"42436","AGLIE'",540,56,21,617,"2024","001"
"42437","AGNA",275,0,0,275,"2024","002"
"42438","AGNADELLO",827,2269,5,3101,"2024","002"
"42439","AGNOSINE",8,25,3,36,"2024","003"
"42440","AGORDO",3,7,0,10,"2024","001"
"42441","AGRATE CONTURBIA",6,0,0,6,"2024","001"
"42442","AGUGLIARO",429,0,0,429,"2024","001"
"42443","AICURZIO",5,0,37,42,"2024",NA
"42444","AILOCHE",0,3,0,3,"2024","001"
"42445","AIRASCA",726,722,0,1448,"2024","002"
"42446","AIRUNO",14,0,0,14,"2024","002"
"42447","AISONE",68,0,0,68,"2024","002"
"42448","ALA DI STURA",41,0,0,41,"2024","003"
"42449","ALAGNA VALSESIA",78,34,25,137,"2024","002"
"42450","ALBA",705,0,0,705,"2024","003"
"42451","ALBAIRATE",61,533,0,594,"2024","005"
"42452","ALBAREDO D'ADIGE",11155,176,0,11331,"2024","002"
"42453","ALBAREDO PER SAN MARCO",2,14,0,16,"2024","001"
"42454","ALBARETO",216,65,0,281,"2024","001"
"42455","ALBARETTO DELLA TORRE",42,0,0,42,"2024","004"
"42456","ALBAVILLA",4,0,0,4,"2024","003"
"42457","ALBERA LIGURE",56,0,0,56,"2024","002"
"42458","ALBESE CON CASSANO",0,0,3,3,"2024","004"
"42459","ALBETTONE",2135,569,47,2751,"2024","002"
"42460","ALBIANO D'IVREA",244,20,0,264,"2024","004"
"42461","ALBIATE",221,0,0,221,"2024",NA
"42462","ALBIGNASEGO",30,206,0,236,"2024","003"
"42463","ALBINEA",31,1081,0,1112,"2024","001"
"42464","ALBINO",108,55,0,163,"2024","004"
"42465","ALBIOLO",3,0,0,3,"2024","005"
"42466","ALBIZZATE",9,0,0,9,"2024","002"
"42467","ALBOSAGGIA",87,59,40,186,"2024","002"
"42468","ALBUGNANO",84,0,0,84,"2024","002"
"42469","ALBUZZANO",73,0,0,73,"2024","004"
"42470","ALESSANDRIA",7798,1864,0,9662,"2024","003"
"42471","ALFIANELLO",312,395,5,712,"2024","004"
"42472","ALFIANO NATTA",9,0,0,9,"2024","004"
"42473","ALFONSINE",42,0,0,42,"2024","001"
"42474","ALGUA",22,7,0,29,"2024","248"
"42475","ALICE BEL COLLE",2,0,0,2,"2024","005"
"42476","ALICE CASTELLO",1037,31,0,1068,"2024","004"
"42477","ALLEGHE",3,0,0,3,"2024","003"
"42478","ALLUVIONI PIOVERA",434,81,0,515,"2024",NA
"42479","ALME'",11,0,0,11,"2024","005"
"42480","ALMENNO SAN BARTOLOMEO",59,0,0,59,"2024","006"
"42481","ALMENNO SAN SALVATORE",7,0,0,7,"2024","007"
"42482","ALMESE",143,11,0,154,"2024","006"
"42483","ALONTE",754,22,0,776,"2024","003"
"42484","ALPAGO",22,167,0,189,"2024",NA
"42485","ALPIGNANO",431,64,14,509,"2024","008"
"42486","ALSENO",6,870,0,876,"2024","002"
"42487","ALSERIO",7,0,0,7,"2024","006"
"42488","ALTA VAL TIDONE",669,222,0,891,"2024",NA
"42489","ALTA VALLE INTELVI",62,42,0,104,"2024",NA
"42490","ALTAVILLA MONFERRATO",149,0,0,149,"2024","007"
"42491","ALTAVILLA VICENTINA",74,0,0,74,"2024","004"
"42492","ALTISSIMO",11,32,0,43,"2024","005"
"42493","ALTIVOLE",12043,0,13,12056,"2024","001"
"42494","ALTO RENO TERME",79,0,0,79,"2024",NA
"42495","ALTO SERMENZA",6,12,0,18,"2024",NA
"42496","ALZANO LOMBARDO",29,37,0,66,"2024","008"
"42497","ALZANO SCRIVIA",1,0,0,1,"2024","008"
"42498","ALZATE BRIANZA",5,192,0,197,"2024","007"
"42499","AMENO",55,11,13,79,"2024","002"
"42500","ANDALO VALTELLINO",16,0,0,16,"2024",NA
"42501","ANDEZENO",304,0,0,304,"2024","009"
"42502","ANDORNO MICCA",57,0,71,128,"2024","002"
"42503","ANDRATE",92,0,1,93,"2024","010"
"42504","ANFO",0,18,0,18,"2024","005"
"42505","ANGERA",81,136,20,237,"2024","003"
"42506","ANGOLO TERME",3,28,1,32,"2024","006"
"42507","ANGROGNA",213,0,46,259,"2024","011"
"42508","ANGUILLARA VENETA",15,0,0,15,"2024","004"
"42509","ANNICCO",0,738,0,738,"2024","003"
"42510","ANNONE DI BRIANZA",25,3,0,28,"2024","003"
"42511","ANNONE VENETO",11,0,0,11,"2024","001"
"42512","ANTEGNATE",728,1787,0,2515,"2024","010"
"42513","ANTIGNANO",45,0,0,45,"2024","003"
"42514","ANTRONA SCHIERANCO",3,0,0,3,"2024","001"
"42515","ANZANO DEL PARCO",7,66,0,73,"2024","009"
"42516","ANZOLA D'OSSOLA",2,246,0,248,"2024","002"
"42517","ANZOLA DELL'EMILIA",6,451,0,457,"2024","001"
"42518","APPIANO GENTILE",83,285,24,392,"2024","010"
"42519","APRICA",0,3,0,3,"2024","004"
"42520","ARAMENGO",379,0,0,379,"2024","004"
"42521","ARCADE",960,45,0,1005,"2024","002"
"42522","ARCENE",2,462,0,464,"2024","011"
"42523","ARCISATE",91,970,0,1061,"2024","004"
"42524","ARCOLE",1091,58,0,1149,"2024","004"
"42525","ARCONATE",18,61,0,79,"2024","007"
"42526","ARCORE",58,0,6,64,"2024",NA
"42527","ARCUGNANO",64,4,0,68,"2024","006"
"42528","ARDENNO",55,36,26,117,"2024","005"
"42529","ARDESIO",117,124,0,241,"2024","012"
"42530","ARENA PO",47,322,11,380,"2024","005"
"42531","ARESE",0,157,0,157,"2024","009"
"42532","ARGEGNO",8,0,0,8,"2024","011"
"42533","ARGELATO",96,79,0,175,"2024","002"
"42534","ARGENTA",599,7,0,606,"2024","001"
"42535","ARGENTERA",1,0,0,1,"2024",NA
"42536","ARGUELLO",71,0,0,71,"2024","007"
"42537","ARIANO NEL POLESINE",602,122,0,724,"2024","002"
"42538","ARIGNANO",597,0,0,597,"2024","012"
"42539","ARLUNO",37,331,0,368,"2024","010"
"42540","ARMENO",181,74,0,255,"2024","006"
"42541","AROLA",11,0,5,16,"2024","004"
"42542","AROSIO",3,0,0,3,"2024","012"
"42543","ARQUA' PETRARCA",6,0,0,6,"2024","005"
"42544","ARQUA' POLESINE",892,0,0,892,"2024","003"
"42545","ARQUATA SCRIVIA",4,0,0,4,"2024","009"
"42546","ARRE",1,10,0,11,"2024","006"
"42547","ARSAGO SEPRIO",6,0,0,6,"2024","005"
"42548","ARSIE'",8,385,0,393,"2024","004"
"42549","ARSIERO",3,17,1,21,"2024","007"
"42550","ARTOGNE",6,311,30,347,"2024","007"
"42551","ARZAGO D'ADDA",373,1151,0,1524,"2024","013"
"42552","ARZERGRANDE",392,119,0,511,"2024","007"
"42553","ARZIGNANO",106,269,2,377,"2024","008"
"42554","ASIAGO",29,1190,24,1243,"2024","009"
"42555","ASIGLIANO VENETO",145,0,0,145,"2024","010"
"42556","ASIGLIANO VERCELLESE",7,0,0,7,"2024","007"
"42557","ASOLA",9532,2293,229,12054,"2024","002"
"42558","ASOLO",8099,622,52,8773,"2024","003"
"42559","ASSAGO",4,0,0,4,"2024","011"
"42560","ASSO",10,0,17,27,"2024","013"
"42561","ASTI",2872,0,0,2872,"2024","005"
"42562","AURANO",26,0,0,26,"2024","005"
"42563","AURONZO DI CADORE",11,2,0,13,"2024","005"
"42564","AVIATICO",0,15,0,15,"2024","015"
"42565","AVIGLIANA",191,62,8,261,"2024","013"
"42566","AVOLASCA",463,0,0,463,"2024","010"
"42567","AZEGLIO",113,10,42,165,"2024","014"
"42568","AZZANELLO",0,449,0,449,"2024","004"
"42569","AZZANO MELLA",84,909,0,993,"2024","008"
"42570","AZZANO SAN PAOLO",33,219,0,252,"2024","016"
"42571","AZZATE",17,0,0,17,"2024","006"
"42572","AZZIO",9,154,0,163,"2024","007"
"42573","BACENO",10,26,0,36,"2024","006"
"42574","BADIA CALAVENA",1306,247,0,1553,"2024","005"
"42575","BADIA PAVESE",0,0,225,225,"2024","006"
"42576","BADIA POLESINE",266,0,0,266,"2024","004"
"42577","BAGNACAVALLO",44,0,0,44,"2024","002"
"42578","BAGNARIA",118,0,0,118,"2024","007"
"42579","BAGNASCO",234,0,0,234,"2024","008"
"42580","BAGNATICA",0,85,0,85,"2024","018"
"42581","BAGNO DI ROMAGNA",1601,2,0,1603,"2024","001"
"42582","BAGNOLI DI SOPRA",1064,2,0,1066,"2024","008"
"42583","BAGNOLO CREMASCO",4,1778,0,1782,"2024","005"
"42584","BAGNOLO IN PIANO",1,525,0,526,"2024","002"
"42585","BAGNOLO MELLA",763,3258,250,4271,"2024","009"
"42586","BAGNOLO PIEMONTE",1352,0,114,1466,"2024","009"
"42587","BAGNOLO SAN VITO",24,3110,500,3634,"2024","003"
"42588","BAGOLINO",16,240,6,262,"2024","010"
"42589","BAIRO",185,93,4,282,"2024","015"
"42590","BAISO",6,864,0,870,"2024","003"
"42591","BALANGERO",157,0,123,280,"2024","016"
"42592","BALDICHIERI D'ASTI",26,0,0,26,"2024","007"
"42593","BALDISSERO CANAVESE",0,63,0,63,"2024","017"
"42594","BALDISSERO D'ALBA",540,0,0,540,"2024","010"
"42595","BALDISSERO TORINESE",240,0,0,240,"2024","018"
"42596","BALLABIO",22,67,0,89,"2024","004"
"42597","BALME",17,0,0,17,"2024","019"
"42598","BALOCCO",62,0,39,101,"2024","009"
"42599","BANNIO ANZINO",147,0,0,147,"2024","007"
"42600","BAONE",1,0,0,1,"2024","009"
"42601","BARBANIA",95,128,74,297,"2024","021"
"42602","BARBARANO MOSSANO",730,337,0,1067,"2024",NA
"42603","BARBARESCO",2,0,0,2,"2024","011"
"42604","BARBARIGA",994,1586,39,2619,"2024","011"
"42605","BARBATA",0,846,0,846,"2024","019"
"42606","BARBIANELLO",188,4,0,192,"2024","008"
"42607","BARBONA",267,0,0,267,"2024","010"
"42608","BARDELLO CON MALGESSO E BREGANO",101,0,0,101,"2024",NA
"42609","BARDI",89,606,0,695,"2024","002"
"42610","BARDOLINO",34,102,0,136,"2024","006"
"42611","BARDONECCHIA",48,0,0,48,"2024","022"
"42612","BAREGGIO",14,123,0,137,"2024","012"
"42613","BARENGO",0,135,0,135,"2024","012"
"42614","BARGE",6389,1684,420,8493,"2024","012"
"42615","BARGHE",9,10,0,19,"2024","012"
"42616","BARIANO",8,342,0,350,"2024","020"
"42617","BARNI",4,10,0,14,"2024","015"
"42618","BAROLO",16,0,0,16,"2024","013"
"42619","BARONE CANAVESE",3,46,0,49,"2024","023"
"42620","BARZAGO",164,0,0,164,"2024","005"
"42621","BARZANO'",16,0,0,16,"2024","006"
"42622","BARZIO",22,60,39,121,"2024","007"
"42623","BASALUZZO",429,0,0,429,"2024","012"
"42624","BASCAPE'",28,801,0,829,"2024","009"
"42625","BASIGLIO",0,65,0,65,"2024","015"
"42626","BASSANO BRESCIANO",7,146,0,153,"2024","013"
"42627","BASSANO DEL GRAPPA",176,118,0,294,"2024","012"
"42628","BASSIGNANA",3,0,0,3,"2024","013"
"42629","BASTIA MONDOVI'",1196,0,1,1197,"2024","014"
"42630","BASTIGLIA",99,0,0,99,"2024","001"
"42631","BATTAGLIA TERME",4,0,0,4,"2024","011"
"42632","BATTIFOLLO",6,0,0,6,"2024","015"
"42633","BEDERO VALCUVIA",9,0,0,9,"2024","010"
"42634","BEDIZZOLE",4349,1328,55,5732,"2024","014"
"42635","BEDONIA",341,47,0,388,"2024","003"
"42636","BEDULITA",11,0,0,11,"2024","022"
"42637","BEE",7,0,0,7,"2024","009"
"42638","BEINETTE",1289,316,6,1611,"2024","016"
"42639","BELFIORE",2977,0,0,2977,"2024","007"
"42640","BELGIOIOSO",0,123,0,123,"2024","013"
"42641","BELLAGIO",10,68,40,118,"2024","019"
"42642","BELLANO",8,1,5,14,"2024","008"
"42643","BELLARIA-IGEA MARINA",7,0,0,7,"2024","001"
"42644","BELLINO",261,0,0,261,"2024","017"
"42645","BELLINZAGO LOMBARDO",682,1395,92,2169,"2024","016"
"42646","BELLINZAGO NOVARESE",543,639,0,1182,"2024","016"
"42647","BELLUNO",664,266,137,1067,"2024","006"
"42648","BELVEDERE LANGHE",161,0,75,236,"2024","018"
"42649","BEMA",0,3,0,3,"2024","006"
"42650","BENE LARIO",3,0,48,51,"2024","021"
"42651","BENE VAGIENNA",3325,549,0,3874,"2024","019"
"42652","BENEVELLO",86,0,0,86,"2024","020"
"42653","BENNA",12,24,28,64,"2024","003"
"42654","BENTIVOGLIO",9,95,0,104,"2024","005"
"42655","BERBENNO",19,39,0,58,"2024","023"
"42656","BERBENNO DI VALTELLINA",50,167,0,217,"2024","007"
"42657","BERCETO",56,339,0,395,"2024","004"
"42658","BEREGAZZO CON FIGLIARO",5,0,0,5,"2024","022"
"42659","BEREGUARDO",18,450,124,592,"2024","014"
"42660","BERGAMASCO",24,0,0,24,"2024","015"
"42661","BERGAMO",205,81,0,286,"2024","024"
"42662","BERLINGO",2742,230,22,2994,"2024","015"
"42663","BERNAREGGIO",1,15,0,16,"2024",NA
"42664","BERNATE TICINO",46,125,0,171,"2024","019"
"42665","BERNEZZO",667,28,0,695,"2024","022"
"42666","BERTINORO",189,7,0,196,"2024","003"
"42667","BERTONICO",0,2285,0,2285,"2024","002"
"42668","BERZANO DI SAN PIETRO",18,0,0,18,"2024","009"
"42669","BERZO DEMO",5,42,3,50,"2024","016"
"42670","BERZO INFERIORE",16,124,0,140,"2024","017"
"42671","BERZO SAN FERMO",760,81,0,841,"2024","025"
"42672","BESANA IN BRIANZA",743,49,4,796,"2024",NA
"42673","BESANO",13,31,0,44,"2024","011"
"42674","BESATE",111,0,0,111,"2024","022"
"42675","BESENZONE",138,1959,0,2097,"2024","003"
"42676","BESNATE",26,139,0,165,"2024","012"
"42677","BESOZZO",17,59,0,76,"2024","013"
"42678","BETTOLA",590,33,0,623,"2024","004"
"42679","BEURA-CARDEZZA",57,1,8,66,"2024","011"
"42680","BEVILACQUA",71,28,0,99,"2024","008"
"42681","BIANDRONNO",36,0,0,36,"2024","014"
"42682","BIANZANO",9,0,0,9,"2024","026"
"42683","BIANZE'",141,421,0,562,"2024","011"
"42684","BIANZONE",2,1,0,3,"2024","008"
"42685","BIASSONO",18,0,0,18,"2024",NA
"42686","BIBBIANO",49,2259,0,2308,"2024","004"
"42687","BIBIANA",621,0,14,635,"2024","025"
"42688","BIELLA",269,68,134,471,"2024","004"
"42689","BIENNO",22,126,7,155,"2024","018"
"42690","BINAGO",54,168,0,222,"2024","023"
"42691","BIOGLIO",15,0,1,16,"2024","005"
"42692","BIONE",7,14,3,24,"2024","019"
"42693","BISTAGNO",34,0,0,34,"2024","017"
"42694","BIZZARONE",0,15,7,22,"2024","024"
"42695","BLELLO",0,58,0,58,"2024","027"
"42696","BLESSAGNO",0,0,2,2,"2024","025"
"42697","BOBBIO",317,27,0,344,"2024","005"
"42698","BOBBIO PELLICE",147,22,105,274,"2024","026"
"42699","BOCCIOLETO",6,11,0,17,"2024","014"
"42700","BOFFALORA D'ADDA",0,217,0,217,"2024","003"
"42701","BOFFALORA SOPRA TICINO",118,85,0,203,"2024","026"
"42702","BOGOGNO",3,0,0,3,"2024",NA
"42703","BOLGARE",90,144,0,234,"2024","028"
"42704","BOLLATE",22,238,0,260,"2024","027"
"42705","BOLLENGO",65,16,98,179,"2024","027"
"42706","BOLOGNA",6,0,0,6,"2024","006"
"42707","BOLTIERE",21,13,0,34,"2024","029"
"42708","BOLZANO NOVARESE",0,4,0,4,"2024","022"
"42709","BOLZANO VICENTINO",141,1180,0,1321,"2024","013"
"42710","BOMPORTO",541,113,0,654,"2024","002"
"42711","BONATE SOPRA",217,0,0,217,"2024","030"
"42712","BONATE SOTTO",70,0,0,70,"2024","031"
"42713","BONAVIGO",3207,33,23,3263,"2024","009"
"42714","BONDENO",110,299,0,409,"2024","003"
"42715","BONEMERSE",22,197,0,219,"2024","006"
"42716","BONVICINO",1,0,0,1,"2024",NA
"42717","BORDOLANO",35,687,0,722,"2024","007"
"42718","BORE",109,0,0,109,"2024","005"
"42719","BORETTO",0,167,0,167,"2024","005"
"42720","BORGARO TORINESE",211,44,0,255,"2024","028"
"42721","BORGHETTO DI BORBERA",114,0,0,114,"2024","018"
"42722","BORGHETTO LODIGIANO",54,1650,232,1936,"2024","004"
"42723","BORGHI",526,0,0,526,"2024","004"
"42724","BORGIALLO",30,37,0,67,"2024","029"
"42725","BORGO D'ALE",527,0,0,527,"2024","015"
"42726","BORGO DI TERZO",2,0,0,2,"2024","032"
"42727","BORGO MANTOVANO",13,1130,3,1146,"2024",NA
"42728","BORGO PRIOLO",19,0,0,19,"2024","016"
"42729","BORGO SAN DALMAZZO",590,0,74,664,"2024","025"
"42730","BORGO SAN GIACOMO",512,3166,0,3678,"2024","020"
"42731","BORGO SAN GIOVANNI",20,1174,0,1194,"2024","005"
"42732","BORGO SAN SIRO",1,964,0,965,"2024","018"
"42733","BORGO TICINO",62,0,0,62,"2024","025"
"42734","BORGO TOSSIGNANO",16,0,0,16,"2024","007"
"42735","BORGO VAL DI TARO",132,174,0,306,"2024","006"
"42736","BORGO VALBELLUNA",147,723,27,897,"2024",NA
"42737","BORGO VENETO",1805,37,0,1842,"2024",NA
"42738","BORGO VERCELLI",6,0,0,6,"2024","017"
"42739","BORGO VIRGILIO",130,5297,949,6376,"2024",NA
"42740","BORGOCARBONARA",0,667,4,671,"2024",NA
"42741","BORGOFRANCO D'IVREA",217,0,35,252,"2024","030"
"42742","BORGOMALE",14,0,0,14,"2024","024"
"42743","BORGOMANERO",185,11,0,196,"2024","024"
"42744","BORGOMASINO",86,0,39,125,"2024","031"
"42745","BORGOMEZZAVALLE",8,0,0,8,"2024",NA
"42746","BORGONE SUSA",43,51,9,103,"2024","032"
"42747","BORGONOVO VAL TIDONE",742,2021,0,2763,"2024","006"
"42748","BORGORATTO ALESSANDRINO",82,0,0,82,"2024","019"
"42749","BORGORATTO MORMOROLO",4,0,0,4,"2024","017"
"42750","BORGORICCO",48,0,4,52,"2024","013"
"42751","BORGOSATOLLO",297,425,37,759,"2024","021"
"42752","BORGOSESIA",58,72,0,130,"2024","016"
"42753","BORMIO",34,335,0,369,"2024","009"
"42754","BORNASCO",50,519,0,569,"2024","019"
"42755","BORNO",3,131,31,165,"2024","022"
"42756","BORRIANA",257,26,0,283,"2024","006"
"42757","BORSO DEL GRAPPA",96,216,17,329,"2024","004"
"42758","BOSCHI SANT'ANNA",67,0,0,67,"2024","010"
"42759","BOSCO CHIESANUOVA",71,1243,5,1319,"2024","011"
"42760","BOSCO MARENGO",152,39,0,191,"2024","021"
"42761","BOSCONERO",101,24,0,125,"2024","033"
"42762","BOSIA",392,0,0,392,"2024","026"
"42763","BOSIO",14,0,8,22,"2024","022"
"42764","BOSISIO PARINI",0,118,0,118,"2024","009"
"42765","BOSSICO",42,60,0,102,"2024","033"
"42766","BOSSOLASCO",60,57,0,117,"2024","027"
"42767","BOTTANUCO",67,907,0,974,"2024","034"
"42768","BOTTICINO",31,0,0,31,"2024","023"
"42769","BOVEGNO",69,84,8,161,"2024","024"
"42770","BOVES",1398,731,111,2240,"2024","028"
"42771","BOVOLENTA",4694,190,0,4884,"2024","014"
"42772","BOVOLONE",3749,404,0,4153,"2024","012"
"42773","BOZZOLO",44,1249,31,1324,"2024","007"
"42774","BRA",4267,1894,82,6243,"2024","029"
"42775","BRACCA",2,0,0,2,"2024","035"
"42776","BRALLO DI PREGOLA",25,0,0,25,"2024","021"
"42777","BRANDICO",3,857,0,860,"2024","026"
"42778","BRANDIZZO",0,0,76,76,"2024","034"
"42779","BRANZI",4,47,0,51,"2024","036"
"42780","BRAONE",0,24,1,25,"2024","027"
"42781","BREBBIA",3,36,0,39,"2024","017"
"42782","BREDA DI PIAVE",68,357,3,428,"2024","005"
"42783","BREGANZE",434,631,26,1091,"2024","014"
"42784","BREGNANO",16,80,0,96,"2024","028"
"42785","BREMBATE",9,178,0,187,"2024","037"
"42786","BREMBATE DI SOPRA",0,260,0,260,"2024","038"
"42787","BREMBIO",63,2407,0,2470,"2024","006"
"42788","BREME",53,0,0,53,"2024","022"
"42789","BRENDOLA",336,106,0,442,"2024","015"
"42790","BRENNA",5,0,0,5,"2024","029"
"42791","BRENO",11,233,9,253,"2024","028"
"42792","BRENTA",1,0,0,1,"2024","019"
"42793","BRENZONE",5,0,2,7,"2024","014"
"42794","BRESCELLO",1,9,0,10,"2024","006"
"42795","BRESCIA",23,525,0,548,"2024","029"
"42796","BRESSANA BOTTARONE",223,0,0,223,"2024","023"
"42797","BRESSANVIDO",13,1722,31,1766,"2024","016"
"42798","BRESSO",15,0,0,15,"2024",NA
"42799","BREZZO DI BEDERO",2,3,0,5,"2024","020"
"42800","BRIAGLIA",77,0,0,77,"2024","030"
"42801","BRICHERASIO",760,71,7,838,"2024","035"
"42802","BRIGA NOVARESE",0,78,0,78,"2024","026"
"42803","BRIGNANO GERA D'ADDA",222,1908,0,2130,"2024","040"
"42804","BRINZIO",9,0,0,9,"2024","021"
"42805","BRIONA",22,704,0,726,"2024","027"
"42806","BRIONE",10,0,0,10,"2024","030"
"42807","BRIOSCO",15,0,0,15,"2024",NA
"42808","BRISIGHELLA",504,63,0,567,"2024","004"
"42809","BRISSAGO-VALTRAVAGLIA",9,0,0,9,"2024","022"
"42810","BRIVIO",41,0,0,41,"2024","010"
"42811","BROGLIANO",21,19,36,76,"2024","017"
"42812","BRONDELLO",10,0,0,10,"2024","032"
"42813","BRONI",40,0,0,40,"2024","024"
"42814","BROSSASCO",113,0,0,113,"2024","033"
"42815","BROSSO",90,13,9,112,"2024","036"
"42816","BROVELLO-CARPUGNINO",26,0,2,28,"2024","013"
"42817","BROZOLO",281,0,0,281,"2024","037"
"42818","BRUGHERIO",3,159,11,173,"2024",NA
"42819","BRUGINE",3127,76,0,3203,"2024","015"
"42820","BRUINO",223,0,0,223,"2024","038"
"42821","BRUMANO",16,16,0,32,"2024","041"
"42822","BRUNELLO",5,0,0,5,"2024","023"
"42823","BRUNO",14,0,0,14,"2024","010"
"42824","BRUSAPORTO",78,17,0,95,"2024","042"
"42825","BRUSASCO",219,0,0,219,"2024","039"
"42826","BRUSNENGO",19,0,0,19,"2024","007"
"42827","BRUZOLO",83,41,18,142,"2024","040"
"42828","BUBBIANO",0,19,0,19,"2024","035"
"42829","BUBBIO",77,0,0,77,"2024","011"
"42830","BUCCINASCO",29,451,0,480,"2024","036"
"42831","BUDRIO",113,223,0,336,"2024","008"
"42832","BUGLIO IN MONTE",30,168,0,198,"2024","010"
"42833","BULCIAGO",1,106,7,114,"2024","011"
"42834","BULGAROGRASSO",37,251,0,288,"2024","034"
"42835","BURIASCO",2046,617,205,2868,"2024","041"
"42836","BUROLO",36,0,0,36,"2024","042"
"42837","BURONZO",17,10,0,27,"2024","021"
"42838","BUSANO",166,27,0,193,"2024","043"
"42839","BUSCA",6485,1616,398,8499,"2024","034"
"42840","BUSCATE",45,0,0,45,"2024","038"
"42841","BUSNAGO",27,6,0,33,"2024",NA
"42842","BUSSERO",0,378,0,378,"2024","040"
"42843","BUSSETO",34,3717,0,3751,"2024","007"
"42844","BUSSOLENGO",540,43,121,704,"2024","015"
"42845","BUSSOLENO",77,146,43,266,"2024","044"
"42846","BUSTO ARSIZIO",14,128,88,230,"2024","026"
"42847","BUSTO GAROLFO",71,211,0,282,"2024","041"
"42848","BUTTAPIETRA",193,64,0,257,"2024","016"
"42849","BUTTIGLIERA ALTA",167,27,0,194,"2024","045"
"42850","BUTTIGLIERA D'ASTI",2432,83,64,2579,"2024","012"
"42851","CABELLA LIGURE",183,0,0,183,"2024","025"
"42852","CADEGLIANO-VICONAGO",6,0,0,6,"2024","027"
"42853","CADELBOSCO DI SOPRA",80,1395,0,1475,"2024","008"
"42854","CADEO",64,2428,0,2492,"2024","007"
"42855","CADONEGHE",6,0,0,6,"2024","016"
"42856","CADORAGO",2,50,0,52,"2024","036"
"42857","CADREZZATE CON OSMATE",67,0,0,67,"2024",NA
"42858","CAERANO DI SAN MARCO",125,28,0,153,"2024","006"
"42859","CAFASSE",254,91,3,348,"2024","046"
"42860","CAGLIO",47,0,32,79,"2024","037"
"42861","CAINO",12,0,0,12,"2024","031"
"42862","CAIOLO",8,103,0,111,"2024","011"
"42863","CALAMANDRANA",76,0,0,76,"2024","013"
"42864","CALASCA-CASTIGLIONE",44,0,0,44,"2024","014"
"42865","CALCINATE",320,229,0,549,"2024","043"
"42866","CALCINATO",3975,2281,374,6630,"2024","032"
"42867","CALCIO",261,1473,0,1734,"2024","044"
"42868","CALCO",14,210,0,224,"2024","012"
"42869","CALDERARA DI RENO",19,37,0,56,"2024","009"
"42870","CALDOGNO",52,277,93,422,"2024","018"
"42871","CALENDASCO",208,382,0,590,"2024","008"
"42872","CALESTANO",76,283,0,359,"2024","008"
"42873","CALLABIANA",48,0,0,48,"2024","008"
"42874","CALLIANO MONFERRATO",219,0,0,219,"2024",NA
"42875","CALOLZIOCORTE",4,0,10,14,"2024","013"
"42876","CALOSSO",3,0,0,3,"2024","015"
"42877","CALTIGNAGA",932,182,0,1114,"2024","030"
"42878","CALTO",25,0,0,25,"2024","008"
"42879","CALTRANO",1576,4,0,1580,"2024","019"
"42880","CALUSCO D'ADDA",17,0,0,17,"2024","046"
"42881","CALUSO",1780,172,0,1952,"2024","047"
"42882","CALVAGESE DELLA RIVIERA",1,195,3,199,"2024","033"
"42883","CALVATONE",0,123,0,123,"2024","009"
"42884","CALVENE",8,45,0,53,"2024","020"
"42885","CALVENZANO",10,518,0,528,"2024","047"
"42886","CALVIGNASCO",0,85,0,85,"2024","042"
"42887","CALVISANO",12560,4735,211,17506,"2024","034"
"42888","CAMAGNA MONFERRATO",41,0,0,41,"2024","026"
"42889","CAMANDONA",33,0,0,33,"2024","009"
"42890","CAMBIAGO",40,92,0,132,"2024","044"
"42891","CAMBIANO",306,0,0,306,"2024","048"
"42892","CAMBIASCA",14,0,0,14,"2024","015"
"42893","CAMBURZANO",214,0,25,239,"2024","010"
"42894","CAMERANA",363,0,0,363,"2024","035"
"42895","CAMERANO CASASCO",19,0,0,19,"2024","016"
"42896","CAMERATA CORNELLO",13,79,0,92,"2024","048"
"42897","CAMERI",55,714,0,769,"2024","032"
"42898","CAMISANO",274,2651,0,2925,"2024","010"
"42899","CAMISANO VICENTINO",91,1294,308,1693,"2024","021"
"42900","CAMPAGNA LUPIA",44,90,0,134,"2024","002"
"42901","CAMPAGNOLA CREMASCA",41,316,434,791,"2024","011"
"42902","CAMPAGNOLA EMILIA",1,539,0,540,"2024","009"
"42903","CAMPEGINE",0,1231,0,1231,"2024","010"
"42904","CAMPERTOGNO",0,47,0,47,"2024","025"
"42905","CAMPIGLIA CERVO",8,2,0,10,"2024","011"
"42906","CAMPIGLIA DEI BERICI",575,113,0,688,"2024","022"
"42907","CAMPIGLIONE-FENILE",867,0,61,928,"2024","049"
"42908","CAMPO SAN MARTINO",326,90,0,416,"2024","020"
"42909","CAMPODARSEGO",920,43,0,963,"2024","017"
"42910","CAMPODORO",77,101,0,178,"2024","018"
"42911","CAMPOGALLIANO",1,248,0,249,"2024","003"
"42912","CAMPOLONGO MAGGIORE",28,1,0,29,"2024","003"
"42913","CAMPONOGARA",185,29,0,214,"2024","004"
"42914","CAMPOSAMPIERO",371,59,0,430,"2024","019"
"42915","CAMPOSANTO",2,0,0,2,"2024",NA
"42916","CAMUGNANO",469,62,11,542,"2024","010"
"42917","CANALE",698,0,0,698,"2024","037"
"42918","CANALE D'AGORDO",2,0,0,2,"2024",NA
"42919","CANARO",403,0,0,403,"2024","009"
"42920","CANDELO",342,44,108,494,"2024","012"
"42921","CANDIA CANAVESE",54,0,0,54,"2024","050"
"42922","CANDIANA",11704,200,0,11904,"2024","021"
"42923","CANDIOLO",124,657,43,824,"2024","051"
"42924","CANELLI",10,0,0,10,"2024","017"
"42925","CANISCHIO",86,0,0,86,"2024","052"
"42926","CANNETO SULL'OGLIO",1475,2205,1043,4723,"2024","008"
"42927","CANNOBIO",1,0,0,1,"2024","017"
"42928","CANONICA D'ADDA",25,503,0,528,"2024","049"
"42929","CANOSIO",29,0,0,29,"2024","038"
"42930","CANOSSA",80,219,0,299,"2024","018"
"42931","CANTALUPA",50,0,0,50,"2024","053"
"42932","CANTARANA",75,0,0,75,"2024","018"
"42933","CANTELLO",129,121,0,250,"2024","030"
"42934","CANTOIRA",174,20,21,215,"2024","054"
"42935","CANTU'",246,242,1,489,"2024","041"
"42936","CANZO",0,0,27,27,"2024","042"
"42937","CAORLE",757,4,0,761,"2024","005"
"42938","CAORSO",3,406,0,409,"2024","010"
"42939","CAPERGNANICA",292,904,0,1196,"2024","012"
"42940","CAPIAGO INTIMIANO",0,11,4,15,"2024","043"
"42941","CAPIZZONE",31,15,0,46,"2024","050"
"42942","CAPO DI PONTE",59,160,8,227,"2024","035"
"42943","CAPONAGO",45,0,0,45,"2024",NA
"42944","CAPOVALLE",6,26,0,32,"2024","036"
"42945","CAPPELLA CANTONE",0,336,112,448,"2024","013"
"42946","CAPPELLA DE' PICENARDI",5,404,0,409,"2024","014"
"42947","CAPPELLA MAGGIORE",9,13,0,22,"2024","007"
"42948","CAPRALBA",1,1313,0,1314,"2024","015"
"42949","CAPRIANO DEL COLLE",2,407,0,409,"2024","037"
"42950","CAPRIATA D'ORBA",15,0,0,15,"2024","029"
"42951","CAPRIE",38,0,0,38,"2024","055"
"42952","CAPRIGLIO",3,0,0,3,"2024","019"
"42953","CAPRILE",89,0,0,89,"2024","013"
"42954","CAPRINO BERGAMASCO",14,0,0,14,"2024","052"
"42955","CAPRINO VERONESE",92,499,36,627,"2024","018"
"42956","CAPRIOLO",265,0,39,304,"2024","038"
"42957","CARAGLIO",4035,580,577,5192,"2024","040"
"42958","CARAMAGNA PIEMONTE",2193,645,0,2838,"2024","041"
"42959","CARAVAGGIO",84,2554,0,2638,"2024","053"
"42960","CARAVATE",0,110,0,110,"2024","031"
"42961","CARBONARA AL TICINO",0,394,0,394,"2024","030"
"42962","CARBONARA SCRIVIA",40,0,0,40,"2024","030"
"42963","CARBONATE",78,42,12,132,"2024","045"
"42964","CARBONERA",180,222,1,403,"2024","008"
"42965","CARCOFORO",0,0,8,8,"2024","029"
"42966","CARDE'",2810,1959,6,4775,"2024","042"
"42967","CAREMA",145,0,2,147,"2024","057"
"42968","CARENNO",14,0,6,20,"2024","014"
"42969","CARENTINO",49,631,0,680,"2024","031"
"42970","CARESANA",3,0,0,3,"2024","030"
"42971","CAREZZANO",5,0,0,5,"2024","032"
"42972","CARIGNANO",2836,1536,298,4670,"2024","058"
"42973","CARISIO",9,0,0,9,"2024","032"
"42974","CARLAZZO",50,32,6,88,"2024","047"
"42975","CARMAGNOLA",7141,3067,334,10542,"2024","059"
"42976","CARMIGNANO DI BRENTA",65,1433,0,1498,"2024","023"
"42977","CARNAGO",13,68,0,81,"2024","033"
"42978","CAROBBIO DEGLI ANGELI",90,29,0,119,"2024","055"
"42979","CARONNO PERTUSELLA",7,0,0,7,"2024","034"
"42980","CARONNO VARESINO",37,0,0,37,"2024","035"
"42981","CARPANETO PIACENTINO",20,4460,0,4480,"2024","011"
"42982","CARPENEDOLO",1093,3938,438,5469,"2024","039"
"42983","CARPENETO",122,0,0,122,"2024","033"
"42984","CARPI",9,1892,0,1901,"2024","005"
"42985","CARPIANO",2,1242,0,1244,"2024","050"
"42986","CARPIGNANO SESIA",122,0,7,129,"2024","036"
"42987","CARPINETI",84,1157,0,1241,"2024","011"
"42988","CARRE'",295,94,0,389,"2024","024"
"42989","CARREGA LIGURE",99,0,0,99,"2024","034"
"42990","CARRU'",1232,55,99,1386,"2024","043"
"42991","CARTIGLIANO",18,7,0,25,"2024","025"
"42992","CARTIGNANO",512,83,0,595,"2024","044"
"42993","CARTOSIO",96,0,0,96,"2024","036"
"42994","CARTURA",371,0,0,371,"2024","026"
"42995","CARUGATE",22,98,0,120,"2024","051"
"42996","CARUGO",3,0,0,3,"2024","048"
"42997","CARVICO",3,0,0,3,"2024","057"
"42998","CASAL CERMELLI",3,0,0,3,"2024","037"
"42999","CASALBELTRAME",1,0,118,119,"2024","037"
"43000","CASALBORGONE",91,0,0,91,"2024","060"
"43001","CASALBUTTANO ED UNITI",0,1762,0,1762,"2024","016"
"43002","CASALE CORTE CERRO",28,0,4,32,"2024","019"
"43003","CASALE CREMASCO-VIDOLASCO",0,1852,0,1852,"2024","017"
"43004","CASALE DI SCODOSIA",484,0,0,484,"2024","027"
"43005","CASALE LITTA",80,132,0,212,"2024","036"
"43006","CASALE MONFERRATO",132,194,14,340,"2024","039"
"43007","CASALE SUL SILE",675,30,21,726,"2024","009"
"43008","CASALEGGIO BOIRO",16,0,0,16,"2024","038"
"43009","CASALEONE",7,0,0,7,"2024","019"
"43010","CASALETTO CEREDANO",18,12,0,30,"2024","018"
"43011","CASALETTO DI SOPRA",13,347,0,360,"2024","019"
"43012","CASALETTO LODIGIANO",25,688,0,713,"2024","008"
"43013","CASALETTO VAPRIO",127,787,26,940,"2024","020"
"43014","CASALFIUMANESE",601,81,0,682,"2024","012"
"43015","CASALGRANDE",32,1122,0,1154,"2024","012"
"43016","CASALGRASSO",500,249,150,899,"2024","045"
"43017","CASALINO",2,133,0,135,"2024","040"
"43018","CASALMAGGIORE",2,688,2,692,"2024","021"
"43019","CASALMAIOCCO",24,511,0,535,"2024","009"
"43020","CASALMORANO",93,2614,0,2707,"2024","022"
"43021","CASALMORO",181,171,238,590,"2024","010"
"43022","CASALNOCETO",19,0,0,19,"2024","040"
"43023","CASALOLDO",811,1714,249,2774,"2024","011"
"43024","CASALPUSTERLENGO",4085,920,0,5005,"2024","010"
"43025","CASALROMANO",311,268,168,747,"2024","012"
"43026","CASALSERUGO",45,0,0,45,"2024","028"
"43027","CASALVOLONE",3,38,0,41,"2024","041"
"43028","CASALZUIGNO",2,98,8,108,"2024","037"
"43029","CASARGO",11,17,1,29,"2024","015"
"43030","CASARILE",113,0,0,113,"2024","055"
"43031","CASATENOVO",429,0,1,430,"2024","016"
"43032","CASAZZA",9,0,3,12,"2024","058"
"43033","CASCIAGO",14,25,0,39,"2024","038"
"43034","CASEI GEROLA",556,0,0,556,"2024","033"
"43035","CASELETTE",143,270,59,472,"2024","062"
"43036","CASELLE LANDI",349,325,0,674,"2024","011"
"43037","CASELLE LURANI",74,463,0,537,"2024","012"
"43038","CASELLE TORINESE",365,1097,133,1595,"2024","063"
"43039","CASIER",12,45,0,57,"2024","010"
"43040","CASINA",38,823,0,861,"2024","013"
"43041","CASIRATE D'ADDA",102,278,0,380,"2024","059"
"43042","CASLINO D'ERBA",10,0,0,10,"2024","052"
"43043","CASNIGO",37,117,0,154,"2024","060"
"43044","CASOLA VALSENIO",267,23,0,290,"2024","005"
"43045","CASORATE PRIMO",36,122,0,158,"2024","034"
"43046","CASOREZZO",0,193,0,193,"2024","058"
"43047","CASORZO MONFERRATO",11,0,0,11,"2024",NA
"43048","CASPOGGIO",1,42,0,43,"2024","013"
"43049","CASSAGO BRIANZA",0,61,2,63,"2024","017"
"43050","CASSANO D'ADDA",246,267,29,542,"2024","059"
"43051","CASSANO MAGNAGO",58,87,0,145,"2024","040"
"43052","CASSANO SPINOLA",434,0,0,434,"2024","042"
"43053","CASSANO VALCUVIA",4,0,0,4,"2024","041"
"43054","CASSINA DE' PECCHI",0,276,0,276,"2024","060"
"43055","CASSINA VALSASSINA",13,19,0,32,"2024","018"
"43056","CASSINASCO",20,0,16,36,"2024","021"
"43057","CASSINE",406,0,0,406,"2024","043"
"43058","CASSINELLE",2,0,0,2,"2024","044"
"43059","CASSINETTA DI LUGAGNANO",0,192,0,192,"2024","061"
"43060","CASSOLA",403,24,0,427,"2024","026"
"43061","CASSOLNOVO",92,0,0,92,"2024","035"
"43062","CASTAGNARO",251,0,0,251,"2024","020"
"43063","CASTAGNETO PO",53,0,0,53,"2024","064"
"43064","CASTAGNITO",98,0,0,98,"2024","046"
"43065","CASTAGNOLE DELLE LANZE",260,0,0,260,"2024","022"
"43066","CASTAGNOLE MONFERRATO",80,0,0,80,"2024","023"
"43067","CASTAGNOLE PIEMONTE",1479,745,66,2290,"2024","065"
"43068","CASTANA",2,0,0,2,"2024","036"
"43069","CASTANO PRIMO",126,0,0,126,"2024","062"
"43070","CASTEGGIO",954,0,0,954,"2024","037"
"43071","CASTEGNATO",89,1152,0,1241,"2024","040"
"43072","CASTEGNERO",23,36,0,59,"2024","027"
"43073","CASTEL BOGLIONE",5,0,0,5,"2024","024"
"43074","CASTEL BOLOGNESE",32,0,0,32,"2024","006"
"43075","CASTEL D'AIANO",95,734,0,829,"2024","013"
"43076","CASTEL D'ARIO",252,3,190,445,"2024","014"
"43077","CASTEL D'AZZANO",1527,112,0,1639,"2024","021"
"43078","CASTEL DEL RIO",57,0,0,57,"2024","014"
"43079","CASTEL DI CASIO",81,12,0,93,"2024","015"
"43080","CASTEL GABBIANO",0,1654,0,1654,"2024","024"
"43081","CASTEL GOFFREDO",1944,385,501,2830,"2024","015"
"43082","CASTEL GUELFO DI BOLOGNA",132,251,0,383,"2024","016"
"43083","CASTEL MELLA",6,327,0,333,"2024","042"
"43084","CASTEL ROZZONE",0,23,0,23,"2024","063"
"43085","CASTEL SAN GIOVANNI",44,691,0,735,"2024","013"
"43086","CASTEL SAN PIETRO TERME",872,306,0,1178,"2024","020"
"43087","CASTELBELFORTE",1498,0,0,1498,"2024","013"
"43088","CASTELCOVATI",4,325,0,329,"2024","041"
"43089","CASTELCUCCO",56,173,54,283,"2024","011"
"43090","CASTELDELCI",410,0,0,410,"2024","021"
"43091","CASTELDELFINO",160,0,0,160,"2024","047"
"43092","CASTELDIDONE",89,0,0,89,"2024","023"
"43093","CASTELFRANCO EMILIA",1643,2838,0,4481,"2024","006"
"43094","CASTELFRANCO VENETO",5393,142,0,5535,"2024","012"
"43095","CASTELGERUNDO",75,1636,0,1711,"2024",NA
"43096","CASTELGOMBERTO",133,403,9,545,"2024","028"
"43097","CASTELGUGLIELMO",584,0,0,584,"2024","011"
"43098","CASTELL'ALFERO",501,0,0,501,"2024","025"
"43099","CASTELL'ARQUATO",155,944,0,1099,"2024","012"
"43100","CASTELLAMONTE",598,183,87,868,"2024","066"
"43101","CASTELLARANO",45,228,0,273,"2024","014"
"43102","CASTELLAZZO BORMIDA",202,201,0,403,"2024","047"
"43103","CASTELLEONE",785,4659,0,5444,"2024","025"
"43104","CASTELLERO",1,0,0,1,"2024","026"
"43105","CASTELLETTO CERVO",74,30,0,104,"2024","015"
"43106","CASTELLETTO D'ORBA",10,0,0,10,"2024","049"
"43107","CASTELLETTO MERLI",46,0,0,46,"2024","050"
"43108","CASTELLETTO MONFERRATO",163,0,0,163,"2024","051"
"43109","CASTELLETTO SOPRA TICINO",107,29,27,163,"2024","043"
"43110","CASTELLETTO STURA",2420,49,71,2540,"2024","049"
"43111","CASTELLETTO UZZONE",37,0,0,37,"2024","050"
"43112","CASTELLI CALEPIO",5,127,0,132,"2024","062"
"43113","CASTELLINALDO D'ALBA",957,0,0,957,"2024",NA
"43114","CASTELLINO TANARO",271,0,0,271,"2024","052"
"43115","CASTELLO CABIAGLIO",7,8,0,15,"2024","043"
"43116","CASTELLO D'AGOGNA",36,0,0,36,"2024",NA
"43117","CASTELLO D'ARGILE",73,0,0,73,"2024","017"
"43118","CASTELLO DELL'ACQUA",19,15,0,34,"2024","014"
"43119","CASTELLO DI ANNONE",179,0,0,179,"2024","028"
"43120","CASTELLO DI BRIANZA",8,0,22,30,"2024","019"
"43121","CASTELLO DI GODEGO",5543,137,0,5680,"2024","013"
"43122","CASTELLUCCHIO",1470,2497,202,4169,"2024","016"
"43123","CASTELMAGNO",30,8,0,38,"2024","053"
"43124","CASTELMARTE",21,0,0,21,"2024","058"
"43125","CASTELMASSA",531,107,0,638,"2024","012"
"43126","CASTELNOVO BARIANO",1625,0,0,1625,"2024","013"
"43127","CASTELNOVO DI SOTTO",2,1067,0,1069,"2024","015"
"43128","CASTELNOVO NE' MONTI",33,1561,0,1594,"2024","016"
"43129","CASTELNUOVO BELBO",6,0,0,6,"2024","029"
"43130","CASTELNUOVO BOCCA D'ADDA",1744,327,0,2071,"2024","013"
"43131","CASTELNUOVO BORMIDA",23,0,0,23,"2024","052"
"43132","CASTELNUOVO BOZZENTE",4,0,3,7,"2024","059"
"43133","CASTELNUOVO CALCEA",5,0,0,5,"2024","030"
"43134","CASTELNUOVO DEL GARDA",3602,195,12,3809,"2024","022"
"43135","CASTELNUOVO DON BOSCO",248,0,0,248,"2024","031"
"43136","CASTELNUOVO NIGRA",126,0,0,126,"2024","067"
"43137","CASTELNUOVO RANGONE",0,969,0,969,"2024","007"
"43138","CASTELNUOVO SCRIVIA",70,0,0,70,"2024","053"
"43139","CASTELSEPRIO",4,0,1,5,"2024","044"
"43140","CASTELSPINA",30,0,0,30,"2024","054"
"43141","CASTELVECCANA",6,0,0,6,"2024","045"
"43142","CASTELVERDE",94,3146,0,3240,"2024","026"
"43143","CASTELVETRO DI MODENA",39,849,0,888,"2024","008"
"43144","CASTELVETRO PIACENTINO",557,1156,0,1713,"2024","014"
"43145","CASTELVISCONTI",5,1390,313,1708,"2024","027"
"43146","CASTENASO",72,99,0,171,"2024","021"
"43147","CASTENEDOLO",741,1088,0,1829,"2024","043"
"43148","CASTIGLIONE D'ADDA",0,254,0,254,"2024","014"
"43149","CASTIGLIONE DEI PEPOLI",158,29,0,187,"2024","022"
"43150","CASTIGLIONE DELLE STIVIERE",3690,2821,154,6665,"2024","017"
"43151","CASTIGLIONE FALLETTO",31,0,0,31,"2024","055"
"43152","CASTIGLIONE OLONA",10,0,7,17,"2024","046"
"43153","CASTIGLIONE TINELLA",77,0,0,77,"2024","056"
"43154","CASTIGLIONE TORINESE",24,0,0,24,"2024","068"
"43155","CASTINO",114,0,0,114,"2024","057"
"43156","CASTIONE ANDEVENNO",16,47,0,63,"2024","015"
"43157","CASTIONE DELLA PRESOLANA",16,3,0,19,"2024","064"
"43158","CASTIRAGA VIDARDO",12,391,0,403,"2024","015"
"43159","CASTO",29,41,6,76,"2024","044"
"43160","CASTREZZATO",396,984,110,1490,"2024","045"
"43161","CASTROCARO TERME E TERRA DEL SOLE",39,8,0,47,"2024","005"
"43162","CASTRONNO",1,0,0,1,"2024","047"
"43163","CAVAGLIA'",1393,90,0,1483,"2024","016"
"43164","CAVAGLIETTO",18,198,0,216,"2024","044"
"43165","CAVAGNOLO",49,0,1,50,"2024","069"
"43166","CAVAION VERONESE",4,0,0,4,"2024","023"
"43167","CAVALLERLEONE",459,1254,63,1776,"2024","058"
"43168","CAVALLERMAGGIORE",2855,2592,42,5489,"2024","059"
"43169","CAVALLINO-TREPORTI",3,0,0,3,"2024","044"
"43170","CAVALLIRIO",6,0,0,6,"2024","047"
"43171","CAVARGNA",7,0,0,7,"2024","062"
"43172","CAVARIA CON PREMEZZO",22,0,0,22,"2024","048"
"43173","CAVARZERE",2257,0,0,2257,"2024","006"
"43174","CAVASO DEL TOMBA",49,55,2,106,"2024","014"
"43175","CAVATORE",11,0,0,11,"2024","055"
"43176","CAVENAGO D'ADDA",8,704,0,712,"2024","017"
"43177","CAVEZZO",0,309,0,309,"2024","009"
"43178","CAVOUR",6037,749,689,7475,"2024","070"
"43179","CAVRIAGO",8,618,0,626,"2024","017"
"43180","CAVRIANA",1052,1814,166,3032,"2024","018"
"43181","CAZZAGO SAN MARTINO",2925,142,58,3125,"2024","046"
"43182","CAZZANO DI TRAMIGNA",8,117,0,125,"2024","024"
"43183","CAZZANO SANT'ANDREA",287,9,0,296,"2024","067"
"43184","CECIMA",28,0,0,28,"2024","042"
"43185","CEDEGOLO",1,7,2,10,"2024","047"
"43186","CEDRASCO",0,66,0,66,"2024","016"
"43187","CEGGIA",11,0,0,11,"2024","007"
"43188","CELLA DATI",3717,67,126,3910,"2024","028"
"43189","CELLA MONTE",65,0,0,65,"2024","056"
"43190","CELLARENGO",260,99,160,519,"2024","033"
"43191","CELLATICA",0,64,0,64,"2024","048"
"43192","CELLE DI MACRA",106,0,14,120,"2024","060"
"43193","CELLE ENOMONDO",199,0,0,199,"2024","034"
"43194","CELLIO CON BREIA",4,0,0,4,"2024",NA
"43195","CENATE SOPRA",16,2,0,18,"2024","068"
"43196","CENATE SOTTO",9,0,0,9,"2024","069"
"43197","CENCENIGHE AGORDINO",1,0,0,1,"2024","010"
"43198","CENE",22,56,0,78,"2024","070"
"43199","CENESELLI",0,195,21,216,"2024","014"
"43200","CENTALLO",5650,827,263,6740,"2024","061"
"43201","CENTO",16,0,0,16,"2024","004"
"43202","CENTRO VALLE INTELVI",96,21,4,121,"2024",NA
"43203","CEPPO MORELLI",33,0,0,33,"2024","021"
"43204","CERANO",6,0,0,6,"2024","049"
"43205","CERANO D'INTELVI",8,0,36,44,"2024","063"
"43206","CERANOVA",0,597,0,597,"2024","043"
"43207","CERCENASCO",163,284,0,447,"2024","071"
"43208","CERCINO",61,6,16,83,"2024","017"
"43209","CEREA",977,177,0,1154,"2024","025"
"43210","CEREGNANO",1,0,0,1,"2024","015"
"43211","CERES",20,0,0,20,"2024","072"
"43212","CERESARA",900,337,40,1277,"2024","019"
"43213","CERESETO",67,0,0,67,"2024","057"
"43214","CERESOLE ALBA",3487,788,0,4275,"2024","062"
"43215","CERESOLE REALE",0,1,1,2,"2024","073"
"43216","CERETE",17,144,0,161,"2024","071"
"43217","CERETTO LOMELLINA",2,0,0,2,"2024","044"
"43218","CERIANO LAGHETTO",0,36,0,36,"2024",NA
"43219","CERIGNALE",14,0,0,14,"2024","015"
"43220","CERMENATE",17,117,9,143,"2024","064"
"43221","CERNUSCO LOMBARDONE",20,0,0,20,"2024","020"
"43222","CERNUSCO SUL NAVIGLIO",36,85,0,121,"2024","070"
"43223","CERRETO D'ASTI",7,0,0,7,"2024","035"
"43224","CERRETO GRUE",71,0,0,71,"2024","058"
"43225","CERRETTO LANGHE",1,0,0,1,"2024","063"
"43226","CERRINA MONFERRATO",55,17,5,77,"2024","059"
"43227","CERRIONE",240,116,0,356,"2024","018"
"43228","CERRO AL LAMBRO",15,894,0,909,"2024","071"
"43229","CERRO MAGGIORE",7,54,0,61,"2024","072"
"43230","CERRO VERONESE",27,157,0,184,"2024","026"
"43231","CERTOSA DI PAVIA",10,0,0,10,"2024","046"
"43232","CERVARESE SANTA CROCE",8,151,0,159,"2024","030"
"43233","CERVASCA",1741,16,292,2049,"2024","064"
"43234","CERVENO",43,0,1,44,"2024","049"
"43235","CERVERE",3309,133,0,3442,"2024","065"
"43236","CERVIA",6,0,0,6,"2024","007"
"43237","CERVIGNANO D'ADDA",0,917,0,917,"2024","018"
"43238","CESANA BRIANZA",3,6,2,11,"2024","021"
"43239","CESANA TORINESE",83,13,33,129,"2024","074"
"43240","CESANO BOSCONE",0,57,0,57,"2024","074"
"43241","CESARA",2,0,0,2,"2024","022"
"43242","CESATE",2,0,0,2,"2024","076"
"43243","CESENA",47,25,0,72,"2024","007"
"43244","CESIOMAGGIORE",124,115,15,254,"2024","011"
"43245","CESSALTO",46,97,0,143,"2024","015"
"43246","CESSOLE",179,0,0,179,"2024","037"
"43247","CETO",9,42,3,54,"2024","050"
"43248","CEVA",1852,0,0,1852,"2024","066"
"43249","CEVO",0,51,6,57,"2024","051"
"43250","CHERASCO",6243,922,120,7285,"2024","067"
"43251","CHIALAMBERTO",33,0,11,44,"2024","075"
"43252","CHIAMPO",19,55,3,77,"2024","029"
"43253","CHIANOCCO",47,0,16,63,"2024","076"
"43254","CHIARANO",8,490,0,498,"2024","016"
"43255","CHIARI",1012,5615,62,6689,"2024","052"
"43256","CHIAVENNA",8,7,6,21,"2024","018"
"43257","CHIAVERANO",60,0,0,60,"2024","077"
"43258","CHIERI",3159,443,64,3666,"2024","078"
"43259","CHIES D'ALPAGO",21,6,0,27,"2024","012"
"43260","CHIESA IN VALMALENCO",40,39,0,79,"2024","019"
"43261","CHIESANUOVA",7,0,0,7,"2024","079"
"43262","CHIEVE",0,1138,23,1161,"2024","029"
"43263","CHIGNOLO D'ISOLA",33,304,0,337,"2024","072"
"43264","CHIGNOLO PO",3,82,0,85,"2024","048"
"43265","CHIOGGIA",3183,0,0,3183,"2024","008"
"43266","CHIOMONTE",0,28,0,28,"2024","080"
"43267","CHIUDUNO",15,0,0,15,"2024","073"
"43268","CHIUPPANO",2,3,0,5,"2024","030"
"43269","CHIURO",5,1,0,6,"2024","020"
"43270","CHIUSA DI PESIO",2538,145,170,2853,"2024","068"
"43271","CHIUSA DI SAN MICHELE",0,0,65,65,"2024","081"
"43272","CHIVASSO",1411,228,0,1639,"2024","082"
"43273","CICOGNOLO",0,1156,0,1156,"2024","030"
"43274","CICONIO",192,87,0,279,"2024","083"
"43275","CIGLIANO",452,106,0,558,"2024","042"
"43276","CIGLIE'",542,0,0,542,"2024","069"
"43277","CIGOGNOLA",1,0,0,1,"2024","049"
"43278","CIGOLE",2057,1308,0,3365,"2024","053"
"43279","CILAVEGNA",3,0,0,3,"2024","050"
"43280","CIMADOLMO",295,83,0,378,"2024","017"
"43281","CIMBERGO",7,0,2,9,"2024","054"
"43282","CINAGLIO",825,23,0,848,"2024","039"
"43283","CINGIA DE' BOTTI",1,1048,27,1076,"2024","031"
"43284","CINISELLO BALSAMO",1,0,0,1,"2024",NA
"43285","CINO",28,10,0,38,"2024","021"
"43286","CINTANO",74,0,0,74,"2024","084"
"43287","CINTO CAOMAGGIORE",445,0,11,456,"2024","009"
"43288","CINTO EUGANEO",9,30,0,39,"2024","031"
"43289","CINZANO",19,0,0,19,"2024","085"
"43290","CIRIE'",386,180,167,733,"2024","086"
"43291","CIRIMIDO",1,0,0,1,"2024","068"
"43292","CISANO BERGAMASCO",37,0,0,37,"2024","074"
"43293","CISERANO",13,51,0,64,"2024","075"
"43294","CISLAGO",13,0,0,13,"2024","050"
"43295","CISLIANO",51,468,0,519,"2024","078"
"43296","CISON DI VALMARINO",88,0,0,88,"2024","018"
"43297","CISTERNA D'ASTI",59,0,0,59,"2024","040"
"43298","CITTADELLA",1941,932,110,2983,"2024","032"
"43299","CITTIGLIO",14,15,0,29,"2024","051"
"43300","CIVATE",1,0,3,4,"2024","022"
"43301","CIVIASCO",0,4,0,4,"2024","043"
"43302","CIVIDATE AL PIANO",914,723,0,1637,"2024","076"
"43303","CIVIDATE CAMUNO",5,0,0,5,"2024","055"
"43304","CIVITELLA DI ROMAGNA",565,15,29,609,"2024","009"
"43305","CIVO",8,21,0,29,"2024","022"
"43306","CLAINO CON OSTENO",1,0,12,13,"2024","071"
"43307","CLAVESANA",472,0,0,472,"2024","071"
"43308","CLIVIO",27,86,0,113,"2024","052"
"43309","CLUSONE",137,203,0,340,"2024","077"
"43310","COASSOLO TORINESE",126,0,1,127,"2024","088"
"43311","COAZZE",6,0,9,15,"2024","089"
"43312","COAZZOLO",44,0,0,44,"2024","041"
"43313","COCCAGLIO",74,1134,3,1211,"2024","056"
"43314","COCCONATO",61,2,0,63,"2024","042"
"43315","COCQUIO-TREVISAGO",16,0,0,16,"2024","053"
"43316","CODEVIGO",333,111,0,444,"2024","033"
"43317","CODIGORO",3036,133,0,3169,"2024","005"
"43318","CODOGNE'",56,111,5,172,"2024","019"
"43319","CODOGNO",13,1110,0,1123,"2024","019"
"43320","COGGIOLA",14,4,0,18,"2024","019"
"43321","COGLIATE",0,0,62,62,"2024",NA
"43322","COGOLLO DEL CENGIO",384,95,0,479,"2024","032"
"43323","COLCERESA",46,339,12,397,"2024",NA
"43324","COLERE",3,0,0,3,"2024","078"
"43325","COLI",81,0,0,81,"2024","016"
"43326","COLICO",142,99,33,274,"2024","023"
"43327","COLLE SANTA LUCIA",3,15,0,18,"2024","014"
"43328","COLLE UMBERTO",21,108,1,130,"2024","020"
"43329","COLLECCHIO",0,2515,0,2515,"2024","009"
"43330","COLLEGNO",545,153,9,707,"2024","090"
"43331","COLLERETTO CASTELNUOVO",1,16,0,17,"2024","091"
"43332","COLLERETTO GIACOSA",43,0,0,43,"2024","092"
"43333","COLLI VERDI",172,0,0,172,"2024",NA
"43334","COLLIO",70,66,15,151,"2024","058"
"43335","COLOGNA VENETA",9647,241,0,9888,"2024","027"
"43336","COLOGNE",463,646,0,1109,"2024","059"
"43337","COLOGNO AL SERIO",76,906,0,982,"2024","079"
"43338","COLORINA",36,406,0,442,"2024","023"
"43339","COLORNO",0,788,0,788,"2024","010"
"43340","COLTURANO",0,5,0,5,"2024","082"
"43341","COLVERDE",4,89,26,119,"2024",NA
"43342","COLZATE",55,86,0,141,"2024","080"
"43343","COMABBIO",1,0,0,1,"2024",NA
"43344","COMACCHIO",401,255,0,656,"2024","006"
"43345","COMAZZO",52,751,24,827,"2024","020"
"43346","COMELICO SUPERIORE",32,128,0,160,"2024","015"
"43347","COMERIO",7,0,0,7,"2024","055"
"43348","COMEZZANO-CIZZAGO",165,1705,0,1870,"2024","060"
"43349","COMMESSAGGIO",11,10,6,27,"2024","020"
"43350","COMO",6,39,2,47,"2024","075"
"43351","COMPIANO",35,2,0,37,"2024","011"
"43352","COMUN NUOVO",42,0,0,42,"2024","081"
"43353","CONA",14723,0,31,14754,"2024","010"
"43354","CONCAMARISE",0,288,0,288,"2024","029"
"43355","CONCESIO",25,0,0,25,"2024","061"
"43356","CONCORDIA SAGITTARIA",1141,0,0,1141,"2024","011"
"43357","CONCORDIA SULLA SECCHIA",38,282,0,320,"2024","010"
"43358","CONCOREZZO",1,27,0,28,"2024",NA
"43359","CONDOVE",259,31,52,342,"2024","093"
"43360","CONEGLIANO",12,23,0,35,"2024","021"
"43361","CONFIENZA",46,17,0,63,"2024","052"
"43362","CONIOLO",122,0,0,122,"2024","060"
"43363","CONSELICE",305,175,0,480,"2024","008"
"43364","CONSELVE",1311,25,0,1336,"2024","034"
"43365","CONZANO",108,0,0,108,"2024","061"
"43366","COPPARO",122,0,0,122,"2024","007"
"43367","CORBETTA",58,46,0,104,"2024","085"
"43368","CORBOLA",23,186,0,209,"2024","017"
"43369","CORDIGNANO",60,102,0,162,"2024","022"
"43370","CORIANO",41,24,0,65,"2024","003"
"43371","CORIO",218,1,73,292,"2024","094"
"43372","CORNA IMAGNA",50,45,0,95,"2024","082"
"43373","CORNALBA",4,14,0,18,"2024","249"
"43374","CORNAREDO",8,250,10,268,"2024","087"
"43375","CORNATE D'ADDA",26,95,0,121,"2024",NA
"43376","CORNEDO VICENTINO",3,100,0,103,"2024","034"
"43377","CORNEGLIANO LAUDENSE",0,183,0,183,"2024","021"
"43378","CORNELIANO D'ALBA",138,0,0,138,"2024","072"
"43379","CORNIGLIO",8,382,0,390,"2024","012"
"43380","CORNO GIOVINE",196,60,0,256,"2024","022"
"43381","CORNOVECCHIO",115,0,0,115,"2024","023"
"43382","CORNUDA",646,360,19,1025,"2024","023"
"43383","CORREGGIO",0,2065,0,2065,"2024","020"
"43384","CORREZZANA",5,0,0,5,"2024",NA
"43385","CORREZZOLA",4113,20,0,4133,"2024","035"
"43386","CORRIDO",77,17,4,98,"2024","077"
"43387","CORSIONE",8,0,0,8,"2024","044"
"43388","CORTANDONE",9,0,0,9,"2024",NA
"43389","CORTANZE",169,0,0,169,"2024","046"
"43390","CORTAZZONE",34,0,0,34,"2024","047"
"43391","CORTE BRUGNATELLA",144,11,0,155,"2024","017"
"43392","CORTE DE' CORTESI CON CIGNONE",0,9,180,189,"2024","032"
"43393","CORTE DE' FRATI",29,947,146,1122,"2024","033"
"43394","CORTE FRANCA",100,34,5,139,"2024","062"
"43395","CORTE PALASIO",50,1905,0,1955,"2024","024"
"43396","CORTEMAGGIORE",194,1924,0,2118,"2024","018"
"43397","CORTEMILIA",198,0,0,198,"2024","073"
"43398","CORTENO GOLGI",15,112,24,151,"2024","063"
"43399","CORTENOVA",0,29,0,29,"2024","025"
"43400","CORTENUOVA",121,909,0,1030,"2024","083"
"43401","CORTEOLONA E GENZONE",86,0,0,86,"2024",NA
"43402","CORTINA D'AMPEZZO",1,22,0,23,"2024","016"
"43403","CORZANO",130,249,0,379,"2024","064"
"43404","COSIO VALTELLINO",17,675,0,692,"2024","024"
"43405","COSSANO BELBO",318,0,0,318,"2024","074"
"43406","COSSATO",446,191,0,637,"2024","020"
"43407","COSSOGNO",3,0,0,3,"2024","023"
"43408","COSTA DE' NOBILI",101,0,0,101,"2024","058"
"43409","COSTA DI MEZZATE",34,0,0,34,"2024","084"
"43410","COSTA DI ROVIGO",0,179,0,179,"2024","018"
"43411","COSTA MASNAGA",9,0,0,9,"2024","026"
"43412","COSTA SERINA",23,4,0,27,"2024","247"
"43413","COSTA VALLE IMAGNA",3,11,0,14,"2024","085"
"43414","COSTA VESCOVATO",24,0,0,24,"2024","062"
"43415","COSTA VOLPINO",47,52,11,110,"2024","086"
"43416","COSTABISSARA",38,18,3,59,"2024","035"
"43417","COSTERMANO",23,29,0,52,"2024","030"
"43418","COSTIGLIOLE D'ASTI",587,0,0,587,"2024","050"
"43419","COSTIGLIOLE SALUZZO",882,0,13,895,"2024","075"
"43420","COTIGNOLA",52,0,0,52,"2024","009"
"43421","COVO",91,1526,0,1617,"2024","087"
"43422","CRANDOLA VALSASSINA",0,2,1,3,"2024","027"
"43423","CRAVAGLIANA",0,32,0,32,"2024","048"
"43424","CRAVANZANA",3,0,0,3,"2024","076"
"43425","CRAVEGGIA",40,0,0,40,"2024","024"
"43426","CREAZZO",16,19,0,35,"2024","036"
"43427","CREDARO",1,271,16,288,"2024","088"
"43428","CREDERA RUBBIANO",24,1110,3,1137,"2024","034"
"43429","CREMA",234,2484,206,2924,"2024","035"
"43430","CREMELLA",6,0,0,6,"2024","028"
"43431","CREMENO",3,23,12,38,"2024","029"
"43432","CREMIA",3,0,9,12,"2024","083"
"43433","CREMOLINO",86,0,0,86,"2024","063"
"43434","CREMONA",339,1349,15,1703,"2024","036"
"43435","CREMOSANO",17,355,0,372,"2024","037"
"43436","CRESCENTINO",252,0,32,284,"2024","049"
"43437","CRESPADORO",34,50,26,110,"2024","037"
"43438","CRESPIATICA",6,245,0,251,"2024","025"
"43439","CRESPINO",2115,0,0,2115,"2024","019"
"43440","CRESSA",47,274,0,321,"2024","055"
"43441","CREVACUORE",18,0,0,18,"2024","021"
"43442","CREVALCORE",62,54,0,116,"2024","024"
"43443","CREVOLADOSSOLA",206,17,0,223,"2024","025"
"43444","CROCETTA DEL MONTELLO",19,28,0,47,"2024","025"
"43445","CRODO",126,82,26,234,"2024","026"
"43446","CROTTA D'ADDA",2,373,0,375,"2024","038"
"43447","CUASSO AL MONTE",19,0,0,19,"2024","058"
"43448","CUCEGLIO",81,0,0,81,"2024","096"
"43449","CUGGIONO",556,38,0,594,"2024","096"
"43450","CUMIANA",1496,558,0,2054,"2024","097"
"43451","CUMIGNANO SUL NAVIGLIO",0,1275,0,1275,"2024","039"
"43452","CUNARDO",2,0,0,2,"2024","060"
"43453","CUNEO",11616,591,813,13020,"2024","078"
"43454","CUNICO",1678,0,0,1678,"2024","051"
"43455","CUORGNE'",216,39,0,255,"2024","098"
"43456","CURA CARPIGNANO",21,140,1,162,"2024","060"
"43457","CUREGGIO",15,0,24,39,"2024","058"
"43458","CURIGLIA CON MONTEVIASCO",6,0,0,6,"2024","061"
"43459","CURINO",2,0,0,2,"2024","023"
"43460","CURNO",3,32,0,35,"2024","089"
"43461","CURTAROLO",60,195,0,255,"2024","036"
"43462","CURTATONE",3298,1959,459,5716,"2024","021"
"43463","CUSAGO",0,829,0,829,"2024","097"
"43464","CUSINO",44,0,0,44,"2024","085"
"43465","CUVEGLIO",4,8,0,12,"2024","062"
"43466","CUVIO",8,82,0,90,"2024","063"
"43467","DAIRAGO",0,57,0,57,"2024","099"
"43468","DALMINE",104,96,0,200,"2024","091"
"43469","DANTA DI CADORE",0,1,0,1,"2024",NA
"43470","DARFO BOARIO TERME",8,316,12,336,"2024","065"
"43471","DAVERIO",4,0,0,4,"2024","064"
"43472","DAZIO",0,9,0,9,"2024","025"
"43473","DELEBIO",31,182,2,215,"2024","026"
"43474","DELLO",709,2035,0,2744,"2024","066"
"43475","DEMONTE",1868,91,9,1968,"2024","079"
"43476","DENICE",5,0,6,11,"2024","065"
"43477","DERNICE",14,0,0,14,"2024","066"
"43478","DEROVERE",1,151,0,152,"2024","040"
"43479","DERVIO",2,0,0,2,"2024","030"
"43480","DESANA",19,0,0,19,"2024","054"
"43481","DESENZANO DEL GARDA",327,1465,518,2310,"2024","067"
"43482","DESIO",19,0,0,19,"2024",NA
"43483","DIANO D'ALBA",42,0,0,42,"2024","080"
"43484","DIVIGNANO",66,0,0,66,"2024","060"
"43485","DIZZASCO",0,0,6,6,"2024","087"
"43486","DOGLIANI",1988,0,8,1996,"2024","081"
"43487","DOLO",512,279,0,791,"2024","012"
"43488","DOMASO",0,3,2,5,"2024","089"
"43489","DOMODOSSOLA",12,40,10,62,"2024","028"
"43490","DONATO",193,0,53,246,"2024","024"
"43491","DONGO",3,6,6,15,"2024","090"
"43492","DORMELLETTO",6,0,0,6,"2024","062"
"43493","DORNO",0,39,0,39,"2024","061"
"43494","DORZANO",2,0,0,2,"2024","025"
"43495","DOSOLO",0,324,71,395,"2024","022"
"43496","DOSSENA",47,98,0,145,"2024","092"
"43497","DOSSO DEL LIRO",2,0,14,16,"2024","092"
"43498","DOVADOLA",254,0,0,254,"2024","011"
"43499","DOVERA",10,1067,0,1077,"2024","041"
"43500","DOZZA",20,0,0,20,"2024","025"
"43501","DRONERO",2694,90,14,2798,"2024","082"
"43502","DRUENTO",854,45,37,936,"2024","099"
"43503","DRUOGNO",23,1,3,27,"2024","029"
"43504","DUBINO",276,477,14,767,"2024","027"
"43505","DUE CARRARE",176,0,0,176,"2024","106"
"43506","DUEVILLE",323,732,0,1055,"2024","038"
"43507","DUMENZA",6,0,5,11,"2024","065"
"43508","DUNO",1,0,0,1,"2024",NA
"43509","DUSINO SAN MICHELE",390,51,0,441,"2024","052"
"43510","EDOLO",39,61,18,118,"2024","068"
"43511","ELLO",1,0,0,1,"2024","033"
"43512","ELVA",70,0,41,111,"2024","083"
"43513","ENDINE GAIANO",141,100,0,241,"2024","093"
"43514","ENEGO",7,158,1,166,"2024","039"
"43515","ENTRACQUE",271,0,0,271,"2024","084"
"43516","ENTRATICO",50,1,0,51,"2024","094"
"43517","ENVIE",2313,352,133,2798,"2024","085"
"43518","ERACLEA",4075,210,0,4285,"2024","013"
"43519","ERBA",38,363,1,402,"2024","095"
"43520","ERBE'",279,11,0,290,"2024","032"
"43521","ERBEZZO",41,575,0,616,"2024","033"
"43522","ERBUSCO",166,0,2,168,"2024","069"
"43523","ESINE",9,140,33,182,"2024","070"
"43524","ESINO LARIO",4,0,21,25,"2024","035"
"43525","ESTE",491,48,0,539,"2024","037"
"43526","EUPILIO",42,0,47,89,"2024","097"
"43527","EXILLES",1,0,0,1,"2024",NA
"43528","FABBRICA CURONE",3,16,0,19,"2024","067"
"43529","FABBRICO",0,192,0,192,"2024","021"
"43530","FAEDO VALTELLINO",1,25,0,26,"2024","028"
"43531","FAENZA",207,56,0,263,"2024","010"
"43532","FAGGETO LARIO",3,0,4,7,"2024","098"
"43533","FAGNANO OLONA",3,0,0,3,"2024","067"
"43534","FALCADE",9,17,2,28,"2024","019"
"43535","FALOPPIO",2,0,0,2,"2024","099"
"43536","FANANO",29,502,0,531,"2024","011"
"43537","FARA GERA D'ADDA",33,771,0,804,"2024","096"
"43538","FARA NOVARESE",5,0,0,5,"2024","065"
"43539","FARA OLIVANA CON SOLA",0,205,0,205,"2024","097"
"43540","FARA VICENTINO",519,405,106,1030,"2024","040"
"43541","FARIGLIANO",841,0,0,841,"2024","086"
"43542","FARINI",112,89,0,201,"2024","019"
"43543","FARRA DI SOLIGO",24,34,6,64,"2024","026"
"43544","FAULE",18,0,121,139,"2024","087"
"43545","FAVRIA",617,619,81,1317,"2024","101"
"43546","FEISOGLIO",69,0,0,69,"2024","088"
"43547","FELETTO",30,2,0,32,"2024","102"
"43548","FELINO",12,1023,0,1035,"2024","013"
"43549","FELIZZANO",54,0,0,54,"2024","068"
"43550","FELTRE",90,1105,30,1225,"2024","021"
"43551","FENEGRO'",27,0,43,70,"2024","100"
"43552","FENESTRELLE",53,0,16,69,"2024","103"
"43553","FERRARA",242,109,0,351,"2024","008"
"43554","FERRARA DI MONTE BALDO",50,9,0,59,"2024","034"
"43555","FERRERA DI VARESE",25,0,0,25,"2024","069"
"43556","FERRERA ERBOGNONE",20,0,0,20,"2024","062"
"43557","FERRERE",867,0,0,867,"2024","053"
"43558","FERRIERE",212,1,0,213,"2024","020"
"43559","FIANO",40,0,0,40,"2024","104"
"43560","FICAROLO",8,0,0,8,"2024","021"
"43561","FIDENZA",39,3648,0,3687,"2024","014"
"43562","FIESCO",3,603,0,606,"2024","043"
"43563","FIESSE",863,367,102,1332,"2024","071"
"43564","FIESSO D'ARTICO",5,0,0,5,"2024","014"
"43565","FIESSO UMBERTIANO",3,0,0,3,"2024","022"
"43566","FIGINO SERENZA",84,60,1,145,"2024","101"
"43567","FILAGO",187,0,0,187,"2024","098"
"43568","FILIGHERA",0,81,0,81,"2024","063"
"43569","FINALE EMILIA",0,69,0,69,"2024","012"
"43570","FINO DEL MONTE",4,43,0,47,"2024","099"
"43571","FINO MORNASCO",21,0,0,21,"2024","102"
"43572","FIORANO AL SERIO",5,13,0,18,"2024","100"
"43573","FIORANO MODENESE",3,57,0,60,"2024","013"
"43574","FIORENZUOLA D'ARDA",25,1701,0,1726,"2024","021"
"43575","FISCAGLIA",1359,132,0,1491,"2024",NA
"43576","FIUMALBO",143,82,0,225,"2024","014"
"43577","FLERO",437,180,8,625,"2024","072"
"43578","FOBELLO",38,0,1,39,"2024","057"
"43579","FOGLIZZO",237,0,0,237,"2024","106"
"43580","FOLLINA",364,68,4,436,"2024","027"
"43581","FOMBIO",0,477,0,477,"2024","026"
"43582","FONTANELICE",391,41,0,432,"2024","026"
"43583","FONTANELLA",2009,1894,0,3903,"2024","101"
"43584","FONTANELLATO",17,2545,0,2562,"2024","015"
"43585","FONTANELLE",51,447,2,500,"2024","028"
"43586","FONTANETO D'AGOGNA",15,134,0,149,"2024","066"
"43587","FONTANILE",3,0,0,3,"2024","054"
"43588","FONTANIVA",201,271,0,472,"2024","038"
"43589","FONTE",961,544,16,1521,"2024","029"
"43590","FONTENO",15,0,0,15,"2024","102"
"43591","FONTEVIVO",0,1660,0,1660,"2024","016"
"43592","FONZASO",8,28,16,52,"2024","022"
"43593","FOPPOLO",0,4,0,4,"2024","103"
"43594","FORCOLA",29,118,0,147,"2024","029"
"43595","FORESTO SPARSO",29,78,0,107,"2024","104"
"43596","FORLI'",581,56,0,637,"2024","012"
"43597","FORLIMPOPOLI",4,0,0,4,"2024","013"
"43598","FORMAZZA",6,19,3,28,"2024","031"
"43599","FORMIGARA",5,1341,0,1346,"2024","044"
"43600","FORMIGINE",0,2357,0,2357,"2024","015"
"43601","FORMIGLIANA",27,0,0,27,"2024","059"
"43602","FORNO CANAVESE",55,0,8,63,"2024","107"
"43603","FORNOVO DI TARO",6,625,0,631,"2024","017"
"43604","FORNOVO SAN GIOVANNI",47,643,0,690,"2024","105"
"43605","FORTUNAGO",61,0,0,61,"2024","064"
"43606","FOSSALTA DI PIAVE",1,0,0,1,"2024","015"
"43607","FOSSALTA DI PORTOGRUARO",0,708,0,708,"2024","016"
"43608","FOSSANO",19830,4634,664,25128,"2024","089"
"43609","FOSSO'",76,12,0,88,"2024","017"
"43610","FOZA",35,0,42,77,"2024","041"
"43611","FRABOSA SOPRANA",698,0,143,841,"2024","090"
"43612","FRABOSA SOTTANA",125,33,28,186,"2024","091"
"43613","FRACONALTO",58,0,0,58,"2024","069"
"43614","FRASCAROLO",606,62,1,669,"2024","065"
"43615","FRASSINELLE POLESINE",117,0,0,117,"2024","023"
"43616","FRASSINELLO MONFERRATO",84,0,0,84,"2024","072"
"43617","FRASSINETO PO",43,0,0,43,"2024","073"
"43618","FRASSINETTO",228,5,0,233,"2024","108"
"43619","FRASSINO",41,0,0,41,"2024","092"
"43620","FRASSINORO",95,67,0,162,"2024","016"
"43621","FRATTA POLESINE",81,153,0,234,"2024","024"
"43622","FREGONA",24,17,2,43,"2024","030"
"43623","FRESONARA",39,0,0,39,"2024","074"
"43624","FRINCO",369,0,0,369,"2024","055"
"43625","FRONT",84,0,32,116,"2024","109"
"43626","FROSSASCO",1844,0,166,2010,"2024","110"
"43627","FRUGAROLO",18,141,0,159,"2024","075"
"43628","FUBINE MONFERRATO",384,0,0,384,"2024",NA
"43629","FUIPIANO VALLE IMAGNA",17,22,0,39,"2024","106"
"43630","FUMANE",12,25,2,39,"2024","035"
"43631","FUSIGNANO",3,0,0,3,"2024","011"
"43632","FUSINE",10,31,0,41,"2024","030"
"43633","GABBIONETA-BINANUOVA",42,621,2,665,"2024","045"
"43634","GABIANO",36,0,0,36,"2024","077"
"43635","GADESCO-PIEVE DELMONA",271,481,0,752,"2024","046"
"43636","GAGGIANO",28,353,0,381,"2024","103"
"43637","GAGGIO MONTANO",319,328,0,647,"2024","027"
"43638","GAGLIANICO",6,0,0,6,"2024","026"
"43639","GAIARINE",772,0,0,772,"2024","031"
"43640","GAIBA",8,0,0,8,"2024","025"
"43641","GAIOLA",39,0,0,39,"2024","093"
"43642","GALBIATE",32,16,32,80,"2024","036"
"43643","GALEATA",465,0,0,465,"2024","014"
"43644","GALGAGNANO",0,822,0,822,"2024","027"
"43645","GALLARATE",12,0,15,27,"2024","070"
"43646","GALLIATE",8,74,0,82,"2024","068"
"43647","GALLIATE LOMBARDO",12,0,0,12,"2024","071"
"43648","GALLIERA",0,1,0,1,"2024","028"
"43649","GALLIERA VENETA",3220,119,0,3339,"2024","039"
"43650","GALLIO",18,164,43,225,"2024","042"
"43651","GALZIGNANO TERME",7,0,0,7,"2024","040"
"43652","GAMALERO",1,0,0,1,"2024","078"
"43653","GAMBARA",4528,2998,110,7636,"2024","073"
"43654","GAMBASCA",2,0,0,2,"2024","094"
"43655","GAMBOLO'",102,36,0,138,"2024","068"
"43656","GANDELLINO",19,29,0,48,"2024","107"
"43657","GANDINO",115,161,0,276,"2024","108"
"43658","GANDOSSO",4,0,0,4,"2024","109"
"43659","GARBAGNA",108,0,0,108,"2024","079"
"43660","GARBAGNA NOVARESE",3,0,0,3,"2024","069"
"43661","GARBAGNATE MILANESE",6,0,0,6,"2024",NA
"43662","GARBAGNATE MONASTERO",6,0,0,6,"2024","037"
"43663","GARDA",2,0,0,2,"2024","036"
"43664","GARDONE RIVIERA",6,0,3,9,"2024","074"
"43665","GARDONE VAL TROMPIA",36,0,0,36,"2024","075"
"43666","GARESSIO",341,0,7,348,"2024","095"
"43667","GARGNANO",35,1,4,40,"2024","076"
"43668","GARLASCO",17,0,0,17,"2024","069"
"43669","GARZENO",7,2,12,21,"2024","106"
"43670","GARZIGLIANA",355,0,0,355,"2024","111"
"43671","GASSINO TORINESE",47,0,2,49,"2024","112"
"43672","GATTATICO",13,2907,0,2920,"2024","022"
"43673","GATTICO-VERUNO",10,361,56,427,"2024",NA
"43674","GATTINARA",123,0,0,123,"2024","061"
"43675","GAVARDO",87,466,124,677,"2024","077"
"43676","GAVELLO",87,0,0,87,"2024",NA
"43677","GAVERINA TERME",12,40,0,52,"2024","110"
"43678","GAVI",4,0,0,4,"2024","081"
"43679","GAVIRATE",23,0,0,23,"2024","072"
"43680","GAZOLDO DEGLI IPPOLITI",276,80,3,359,"2024","024"
"43681","GAZZADA SCHIANNO",22,0,0,22,"2024","073"
"43682","GAZZANIGA",28,18,0,46,"2024","111"
"43683","GAZZO",39,2740,0,2779,"2024","041"
"43684","GAZZO VERONESE",928,311,0,1239,"2024","037"
"43685","GAZZOLA",257,1529,0,1786,"2024","022"
"43686","GAZZUOLO",49,30,0,79,"2024","025"
"43687","GEMMANO",39,54,0,93,"2024","004"
"43688","GEMONIO",1,0,0,1,"2024","074"
"43689","GENIVOLTA",0,1538,13,1551,"2024","047"
"43690","GENOLA",2237,2368,250,4855,"2024","096"
"43691","GERA LARIO",27,287,14,328,"2024","107"
"43692","GERENZAGO",1,0,0,1,"2024","071"
"43693","GERENZANO",113,92,0,205,"2024","075"
"43694","GERMAGNANO",55,0,0,55,"2024","113"
"43695","GERMAGNO",1,0,0,1,"2024","032"
"43696","GERMIGNAGA",12,80,0,92,"2024","076"
"43697","GERRE DE' CAPRIOLI",0,518,0,518,"2024","048"
"43698","GESSATE",6,343,0,349,"2024","106"
"43699","GHEDI",3313,7250,10,10573,"2024","078"
"43700","GHEMME",83,9,0,92,"2024","073"
"43701","GHIFFA",1,0,7,8,"2024","033"
"43702","GHISALBA",3,782,0,785,"2024","113"
"43703","GHISLARENGO",49,0,0,49,"2024","062"
"43704","GIAGLIONE",80,0,0,80,"2024","114"
"43705","GIANICO",91,106,241,438,"2024","079"
"43706","GIAVENO",240,182,151,573,"2024","115"
"43707","GIAVERA DEL MONTELLO",889,159,0,1048,"2024","032"
"43708","GIGNESE",22,0,0,22,"2024","034"
"43709","GIUSSAGO",21,84,60,165,"2024","072"
"43710","GIUSSANO",2,0,0,2,"2024",NA
"43711","GIVOLETTO",40,0,0,40,"2024","116"
"43712","GODEGA DI SANT'URBANO",29,59,27,115,"2024","033"
"43713","GODIASCO",16,0,2,18,"2024","073"
"43714","GOITO",2790,5931,170,8891,"2024","026"
"43715","GOLASECCA",18,0,0,18,"2024","077"
"43716","GOLFERENZO",0,0,33,33,"2024","074"
"43717","GOMBITO",6,1107,0,1113,"2024","049"
"43718","GONZAGA",21619,4746,371,26736,"2024","027"
"43719","GORDONA",224,105,21,350,"2024","032"
"43720","GORGO AL MONTICANO",71,256,0,327,"2024","034"
"43721","GORGONZOLA",45,241,0,286,"2024","108"
"43722","GORLA MAGGIORE",3,155,0,158,"2024","078"
"43723","GORLA MINORE",56,0,0,56,"2024","079"
"43724","GORLAGO",93,349,0,442,"2024","114"
"43725","GORNATE-OLONA",11,0,2,13,"2024","080"
"43726","GORNO",27,79,0,106,"2024","116"
"43727","GORZEGNO",66,0,0,66,"2024","097"
"43728","GOSALDO",1,0,0,1,"2024",NA
"43729","GOSSOLENGO",4,710,0,714,"2024","023"
"43730","GOTTASECCA",46,0,0,46,"2024","098"
"43731","GOTTOLENGO",13520,1392,19,14931,"2024","080"
"43732","GOVONE",332,0,0,332,"2024","099"
"43733","GRAFFIGNANA",57,234,23,314,"2024","028"
"43734","GRAGLIA",119,20,81,220,"2024","028"
"43735","GRAGNANO TREBBIENSE",69,3986,0,4055,"2024","024"
"43736","GRANA",62,0,0,62,"2024","056"
"43737","GRANAROLO DELL'EMILIA",283,246,0,529,"2024","030"
"43738","GRANDOLA ED UNITI",2,11,50,63,"2024","111"
"43739","GRANOZZO CON MONTICELLO",0,50,0,50,"2024","077"
"43740","GRANTOLA",60,0,0,60,"2024","081"
"43741","GRANTORTO",67,959,2,1028,"2024","042"
"43742","GRANZE",685,0,12,697,"2024","043"
"43743","GRASSOBBIO",11,118,0,129,"2024","117"
"43744","GRAVEDONA ED UNITI",6,12,23,41,"2024","249"
"43745","GRAVELLONA LOMELLINA",0,0,6,6,"2024","075"
"43746","GRAVELLONA TOCE",19,0,0,19,"2024","035"
"43747","GRAVERE",1,0,0,1,"2024","117"
"43748","GRAZZANO BADOGLIO",232,0,0,232,"2024","057"
"43749","GREMIASCO",33,0,0,33,"2024","083"
"43750","GREZZAGO",16,0,0,16,"2024","110"
"43751","GREZZANA",138,468,0,606,"2024","038"
"43752","GRIANTE",6,0,6,12,"2024","113"
"43753","GRIGNASCO",93,0,0,93,"2024","079"
"43754","GRINZANE CAVOUR",5,0,0,5,"2024","100"
"43755","GRISIGNANO DI ZOCCO",29,477,0,506,"2024","046"
"43756","GRIZZANA MORANDI",97,0,0,97,"2024","031"
"43757","GROMO",53,102,0,155,"2024","118"
"43758","GRONDONA",9,0,0,9,"2024","085"
"43759","GRONE",36,25,0,61,"2024","119"
"43760","GRONTARDO",147,1963,6,2116,"2024","050"
"43761","GROPELLO CAIROLI",63,0,0,63,"2024","076"
"43762","GROPPARELLO",139,19,0,158,"2024","025"
"43763","GROSCAVALLO",31,0,0,31,"2024","118"
"43764","GROSIO",14,194,2,210,"2024","033"
"43765","GROSOTTO",2,87,4,93,"2024","034"
"43766","GROSSO",73,0,37,110,"2024","119"
"43767","GRUARO",7,183,0,190,"2024","018"
"43768","GRUGLIASCO",163,0,54,217,"2024","120"
"43769","GRUMELLO CREMONESE ED UNITI",125,1824,0,1949,"2024","051"
"43770","GRUMELLO DEL MONTE",10,97,0,107,"2024","120"
"43771","GRUMOLO DELLE ABBADESSE",25,110,27,162,"2024","047"
"43772","GUALTIERI",971,439,0,1410,"2024","023"
"43773","GUANZATE",6,0,5,11,"2024","114"
"43774","GUARDA VENETA",637,0,0,637,"2024","028"
"43775","GUARDABOSONE",112,7,0,119,"2024","066"
"43776","GUARDAMIGLIO",11,684,0,695,"2024","029"
"43777","GUARENE",242,0,0,242,"2024","101"
"43778","GUASTALLA",7,1252,4,1263,"2024","024"
"43779","GUDO VISCONTI",17,0,0,17,"2024","112"
"43780","GUIDIZZOLO",1212,879,107,2198,"2024","028"
"43781","GUIGLIA",37,341,0,378,"2024","017"
"43782","GUSSAGO",48,1144,103,1295,"2024","081"
"43783","GUSSOLA",0,56,0,56,"2024","052"
"43784","IDRO",9,0,6,15,"2024","082"
"43785","IGLIANO",139,0,15,154,"2024","102"
"43786","ILLASI",0,41,0,41,"2024","039"
"43787","IMBERSAGO",5,0,0,5,"2024","039"
"43788","IMOLA",112,0,0,112,"2024","032"
"43789","INARZO",19,0,0,19,"2024","082"
"43790","INCISA SCAPACCINO",34,0,0,34,"2024","058"
"43791","INCUDINE",1,0,0,1,"2024","083"
"43792","INDUNO OLONA",4,95,0,99,"2024","083"
"43793","INTRAGNA",1,0,0,1,"2024","037"
"43794","INTROBIO",5,15,76,96,"2024","040"
"43795","INVERIGO",134,0,63,197,"2024","118"
"43796","INVERNO E MONTELEONE",61,267,23,351,"2024","077"
"43797","INVERSO PINASCA",106,0,0,106,"2024","122"
"43798","INVERUNO",38,21,0,59,"2024","113"
"43799","INVORIO",224,55,0,279,"2024","082"
"43800","INZAGO",423,414,111,948,"2024","114"
"43801","IRMA",16,0,0,16,"2024","084"
"43802","ISASCA",43,0,0,43,"2024","103"
"43803","ISEO",30,18,0,48,"2024","085"
"43804","ISOLA D'ASTI",608,0,0,608,"2024","059"
"43805","ISOLA DELLA SCALA",7392,385,0,7777,"2024","040"
"43806","ISOLA DI FONDRA",3,16,0,19,"2024","121"
"43807","ISOLA DOVARESE",0,689,0,689,"2024","053"
"43808","ISOLA RIZZA",1809,327,0,2136,"2024","041"
"43809","ISOLA SANT'ANTONIO",3,0,0,3,"2024","087"
"43810","ISOLA VICENTINA",1540,688,44,2272,"2024","048"
"43811","ISOLABELLA",34,465,0,499,"2024","123"
"43812","ISORELLA",10500,252,10,10762,"2024","086"
"43813","ISPRA",119,162,0,281,"2024","084"
"43814","ISSIGLIO",146,26,35,207,"2024","124"
"43815","ISSO",9,918,0,927,"2024","122"
"43816","ISTRANA",1330,276,17,1623,"2024","035"
"43817","IVREA",554,248,0,802,"2024","125"
"43818","IZANO",0,921,0,921,"2024","054"
"43819","JESOLO",0,90,0,90,"2024",NA
"43820","JOLANDA DI SAVOIA",4244,0,0,4244,"2024","010"
"43821","LA CASSA",1,319,0,320,"2024","126"
"43822","LA LOGGIA",355,0,0,355,"2024","127"
"43823","LA MORRA",59,0,0,59,"2024","105"
"43824","LA VALLE AGORDINA",2,24,16,42,"2024","027"
"43825","LA VALLETTA BRIANZA",10,16,0,26,"2024",NA
"43826","LACCHIARELLA",22,0,0,22,"2024","115"
"43827","LAGNASCO",15,0,59,74,"2024","104"
"43828","LAGOSANTO",60,0,0,60,"2024","011"
"43829","LAINATE",25,0,0,25,"2024","116"
"43830","LAINO",9,2,0,11,"2024","120"
"43831","LAMA MOCOGNO",86,389,0,475,"2024","018"
"43832","LAMBRUGO",0,101,0,101,"2024","121"
"43833","LAMON",5,45,0,50,"2024","026"
"43834","LAMPORO",61,0,0,61,"2024","067"
"43835","LANDIONA",0,12,0,12,"2024",NA
"43836","LANDRIANO",1,201,0,202,"2024","078"
"43837","LANGHIRANO",20,876,0,896,"2024","018"
"43838","LANGOSCO",8,0,0,8,"2024","079"
"43839","LANZADA",23,65,6,94,"2024","036"
"43840","LANZO TORINESE",345,0,8,353,"2024","128"
"43841","LARDIRAGO",0,0,18,18,"2024",NA
"43842","LASNIGO",0,28,0,28,"2024","123"
"43843","LASTEBASSE",4,0,0,4,"2024",NA
"43844","LAURIANO",11,0,0,11,"2024","129"
"43845","LAVAGNO",2,0,0,2,"2024",NA
"43846","LAVENA PONTE TRESA",7,0,0,7,"2024","086"
"43847","LAVENO-MOMBELLO",3,0,0,3,"2024","087"
"43848","LAVENONE",34,0,1,35,"2024","087"
"43849","LAZISE",4,0,0,4,"2024","043"
"43850","LAZZATE",2,0,16,18,"2024",NA
"43851","LECCO",33,16,3,52,"2024","042"
"43852","LEFFE",6,95,0,101,"2024","124"
"43853","LEGGIUNO",3,0,0,3,"2024","088"
"43854","LEGNAGO",61,37,108,206,"2024","044"
"43855","LEGNANO",1,72,0,73,"2024","118"
"43856","LEGNARO",217,61,0,278,"2024","044"
"43857","LEINI",1138,611,68,1817,"2024",NA
"43858","LEMIE",11,0,0,11,"2024","131"
"43859","LENDINARA",599,98,0,697,"2024","029"
"43860","LENNA",25,8,0,33,"2024","125"
"43861","LENO",5327,7305,584,13216,"2024","088"
"43862","LENTA",31,0,7,38,"2024","068"
"43863","LENTATE SUL SEVESO",1,193,3,197,"2024",NA
"43864","LEQUIO BERRIA",29,0,0,29,"2024","106"
"43865","LEQUIO TANARO",2644,0,0,2644,"2024","107"
"43866","LERMA",15,0,0,15,"2024","088"
"43867","LESA",5,0,0,5,"2024","084"
"43868","LESEGNO",1541,0,0,1541,"2024","108"
"43869","LESIGNANO DE' BAGNI",38,1406,0,1444,"2024","019"
"43870","LESMO",2,154,52,208,"2024",NA
"43871","LESSOLO",274,0,9,283,"2024","132"
"43872","LESSONA",11,0,0,11,"2024","029"
"43873","LEVICE",64,0,0,64,"2024","109"
"43874","LEZZENO",0,0,2,2,"2024","126"
"43875","LIERNA",4,5,2,11,"2024","043"
"43876","LIMANA",115,89,0,204,"2024","029"
"43877","LIMENA",811,549,49,1409,"2024","045"
"43878","LIMIDO COMASCO",2,21,0,23,"2024","128"
"43879","LIMONE PIEMONTE",45,0,0,45,"2024","110"
"43880","LINAROLO",10,362,0,372,"2024","081"
"43881","LIRIO",79,0,0,79,"2024","082"
"43882","LISCATE",9,0,0,9,"2024","122"
"43883","LISIO",93,0,0,93,"2024","111"
"43884","LISSONE",43,0,97,140,"2024",NA
"43885","LIVIGNO",152,275,9,436,"2024","037"
"43886","LIVINALLONGO DEL COL DI LANA",5,67,0,72,"2024","030"
"43887","LIVO",2,12,3,17,"2024","130"
"43888","LIVORNO FERRARIS",8,52,0,60,"2024","071"
"43889","LIVRAGA",150,1035,1,1186,"2024","030"
"43890","LIZZANO IN BELVEDERE",12,79,14,105,"2024","033"
"43891","LOAZZOLO",2,0,0,2,"2024","060"
"43892","LOCANA",220,49,25,294,"2024","134"
"43893","LOCATE DI TRIULZI",0,1174,0,1174,"2024","125"
"43894","LOCATE VARESINO",5,0,0,5,"2024","131"
"43895","LOCATELLO",54,21,0,75,"2024","127"
"43896","LODI",584,949,0,1533,"2024","031"
"43897","LODI VECCHIO",0,1583,0,1583,"2024","032"
"43898","LODRINO",20,7,0,27,"2024","090"
"43899","LOGRATO",1340,813,8,2161,"2024","091"
"43900","LOIANO",81,153,0,234,"2024","034"
"43901","LOMBARDORE",43,6,23,72,"2024","135"
"43902","LOMBRIASCO",86,99,0,185,"2024","136"
"43903","LOMELLO",72,102,0,174,"2024","083"
"43904","LONATE CEPPINO",1,268,0,269,"2024","089"
"43905","LONATE POZZOLO",0,0,4,4,"2024","090"
"43906","LONATO DEL GARDA",2269,4938,590,7797,"2024",NA
"43907","LONGARE",39,142,0,181,"2024","051"
"43908","LONGARONE",2,0,0,2,"2024","031"
"43909","LONGHENA",0,448,0,448,"2024","093"
"43910","LONGIANO",48,0,0,48,"2024","018"
"43911","LONIGO",5265,449,0,5714,"2024","052"
"43912","LORANZE'",116,0,0,116,"2024","137"
"43913","LOREGGIA",192,407,0,599,"2024","046"
"43914","LOREGLIA",5,0,0,5,"2024","038"
"43915","LORENZAGO DI CADORE",6,0,0,6,"2024","032"
"43916","LOREO",907,37,0,944,"2024","030"
"43917","LORIA",6339,50,16,6405,"2024","036"
"43918","LOSINE",1,4,0,5,"2024","094"
"43919","LOVERE",13,39,0,52,"2024","128"
"43920","LOVERO",2,1,0,3,"2024","038"
"43921","LOZIO",6,0,0,6,"2024","095"
"43922","LOZZA",0,99,0,99,"2024","091"
"43923","LOZZO ATESTINO",1528,0,0,1528,"2024","047"
"43924","LU E CUCCARO MONFERRATO",91,0,0,91,"2024",NA
"43925","LUGAGNANO VAL D'ARDA",79,65,0,144,"2024","026"
"43926","LUGO",83,77,0,160,"2024","012"
"43927","LUGO DI VICENZA",5,47,0,52,"2024","053"
"43928","LUINO",0,3,0,3,"2024","092"
"43929","LUISAGO",3,0,14,17,"2024","135"
"43930","LUMEZZANE",36,0,0,36,"2024","096"
"43931","LURAGO D'ERBA",3,0,5,8,"2024","136"
"43932","LURAGO MARINONE",0,139,0,139,"2024","137"
"43933","LURANO",22,12,0,34,"2024","129"
"43934","LURATE CACCIVIO",52,0,137,189,"2024","138"
"43935","LUSERNA SAN GIOVANNI",557,80,73,710,"2024","139"
"43936","LUSERNETTA",145,0,0,145,"2024","140"
"43937","LUSIA",5,0,0,5,"2024","031"
"43938","LUSIANA CONCO",32,219,6,257,"2024",NA
"43939","LUSIGLIE'",133,0,0,133,"2024","141"
"43940","LUZZANA",23,0,0,23,"2024","130"
"43941","LUZZARA",1388,1380,0,2768,"2024","026"
"43942","MACCAGNO CON PINO E VEDDASCA",0,14,0,14,"2024",NA
"43943","MACCASTORNA",594,0,233,827,"2024","033"
"43944","MACELLO",1826,164,318,2308,"2024","142"
"43945","MACLODIO",34,165,0,199,"2024","097"
"43946","MACRA",8,0,0,8,"2024",NA
"43947","MACUGNAGA",6,11,0,17,"2024","039"
"43948","MADIGNANO",69,733,0,802,"2024","055"
"43949","MADONE",1,0,0,1,"2024","131"
"43950","MADONNA DEL SASSO",48,0,0,48,"2024","040"
"43951","MAGASA",15,11,1,27,"2024","098"
"43952","MAGENTA",50,871,0,921,"2024","130"
"43953","MAGGIORA",114,61,0,175,"2024","088"
"43954","MAGHERNO",3,0,0,3,"2024","085"
"43955","MAGLIANO ALFIERI",462,0,0,462,"2024","113"
"43956","MAGLIANO ALPI",644,147,0,791,"2024","114"
"43957","MAGNACAVALLO",0,671,196,867,"2024","029"
"43958","MAGNAGO",33,0,0,33,"2024","131"
"43959","MAGNANO",50,15,0,65,"2024","030"
"43960","MAIOLO",159,0,0,159,"2024","022"
"43961","MAIRAGO",0,471,0,471,"2024","034"
"43962","MAIRANO",334,456,0,790,"2024","099"
"43963","MALAGNINO",220,656,0,876,"2024","056"
"43964","MALCESINE",15,32,18,65,"2024","045"
"43965","MALEGNO",48,12,2,62,"2024","100"
"43966","MALEO",70,1426,0,1496,"2024","035"
"43967","MALESCO",32,14,2,48,"2024","041"
"43968","MALNATE",18,31,0,49,"2024","096"
"43969","MALO",1708,236,0,1944,"2024","055"
"43970","MALONNO",13,165,49,227,"2024","101"
"43971","MALVICINO",11,0,0,11,"2024","090"
"43972","MANDELLO DEL LARIO",19,2,3,24,"2024","046"
"43973","MANDELLO VITTA",1,0,0,1,"2024","090"
"43974","MANERBA DEL GARDA",0,0,23,23,"2024","102"
"43975","MANERBIO",529,1108,0,1637,"2024","103"
"43976","MANGO",7,0,0,7,"2024","115"
"43977","MANSUE'",52,174,2,228,"2024","037"
"43978","MANTELLO",2,90,5,97,"2024","039"
"43979","MANTOVA",523,824,0,1347,"2024","030"
"43980","MAPELLO",25,0,0,25,"2024","132"
"43981","MARANELLO",54,601,0,655,"2024","019"
"43982","MARANO DI VALPOLICELLA",20,59,6,85,"2024","046"
"43983","MARANO SUL PANARO",26,742,0,768,"2024","020"
"43984","MARANO TICINO",2,228,0,230,"2024","091"
"43985","MARANO VICENTINO",305,274,37,616,"2024","056"
"43986","MARCALLO CON CASONE",0,378,0,378,"2024","134"
"43987","MARCARIA",2400,3348,478,6226,"2024","031"
"43988","MARCHENO",20,29,0,49,"2024","104"
"43989","MARCON",640,4,0,644,"2024","020"
"43990","MARENE",4512,1985,89,6586,"2024","117"
"43991","MARENO DI PIAVE",1109,120,0,1229,"2024","038"
"43992","MARENTINO",173,0,0,173,"2024","144"
"43993","MARETTO",139,0,0,139,"2024","062"
"43994","MARGARITA",1151,0,0,1151,"2024","118"
"43995","MARGNO",4,12,1,17,"2024","047"
"43996","MARIANA MANTOVANA",23,407,41,471,"2024","032"
"43997","MARIANO COMENSE",723,45,12,780,"2024","143"
"43998","MARMENTINO",0,29,3,32,"2024","105"
"43999","MARMIROLO",3430,2992,2312,8734,"2024","033"
"44000","MARMORA",0,0,9,9,"2024","119"
"44001","MARONE",22,0,23,45,"2024","106"
"44002","MAROSTICA",89,523,16,628,"2024","057"
"44003","MARSAGLIA",83,0,0,83,"2024","120"
"44004","MARTELLAGO",26,0,35,61,"2024","021"
"44005","MARTINENGO",234,2470,0,2704,"2024","133"
"44006","MARTINIANA PO",186,0,21,207,"2024","121"
"44007","MARUDO",0,60,0,60,"2024","036"
"44008","MARZABOTTO",10,121,0,131,"2024","036"
"44009","MARZANO",1,205,0,206,"2024","087"
"44010","MARZIO",2,0,6,8,"2024","099"
"44011","MASATE",149,0,0,149,"2024","136"
"44012","MASCIAGO PRIMO",117,0,0,117,"2024","100"
"44013","MASER",4354,18,0,4372,"2024","039"
"44014","MASERA",72,13,1,86,"2024","042"
"44015","MASERA' DI PADOVA",371,105,0,476,"2024","048"
"44016","MASERADA SUL PIAVE",2557,151,11,2719,"2024","040"
"44017","MASI",16,0,0,16,"2024","049"
"44018","MASI TORELLO",5,73,0,78,"2024","012"
"44019","MASIO",254,0,0,254,"2024","091"
"44020","MASSA LOMBARDA",36,0,0,36,"2024","013"
"44021","MASSALENGO",0,107,0,107,"2024","037"
"44022","MASSANZAGO",336,113,0,449,"2024","050"
"44023","MASSAZZA",32,0,0,32,"2024","031"
"44024","MASSELLO",8,0,0,8,"2024","145"
"44025","MASSERANO",110,0,0,110,"2024","032"
"44026","MASSINO VISCONTI",29,1,0,30,"2024","093"
"44027","MASSIOLA",4,0,0,4,"2024","043"
"44028","MATHI",365,0,91,456,"2024","146"
"44029","MATTIE",0,0,11,11,"2024","147"
"44030","MAZZANO",56,575,282,913,"2024","107"
"44031","MAZZE'",1025,0,0,1025,"2024","148"
"44032","MAZZO DI VALTELLINA",13,23,9,45,"2024","040"
"44033","MEANA DI SUSA",2,0,0,2,"2024","149"
"44034","MEDE",63,0,0,63,"2024","088"
"44035","MEDESANO",102,1475,0,1577,"2024","020"
"44036","MEDICINA",10,88,0,98,"2024","037"
"44037","MEDIGLIA",17,1432,0,1449,"2024","139"
"44038","MEDOLAGO",23,0,0,23,"2024","250"
"44039","MEDOLE",404,2355,102,2861,"2024","034"
"44040","MEDOLLA",0,464,0,464,"2024","021"
"44041","MEDUNA DI LIVENZA",15,11,0,26,"2024","041"
"44042","MEGLIADINO SAN VITALE",2333,0,0,2333,"2024","052"
"44043","MELAZZO",115,0,0,115,"2024","092"
"44044","MELDOLA",194,0,0,194,"2024","019"
"44045","MELEGNANO",0,182,0,182,"2024","140"
"44046","MELETI",1234,143,0,1377,"2024","038"
"44047","MELLE",367,13,29,409,"2024","122"
"44048","MELLO",80,32,10,122,"2024","041"
"44049","MELZO",2,130,267,399,"2024","142"
"44050","MENAGGIO",15,0,0,15,"2024","145"
"44051","MENCONICO",21,0,0,21,"2024","089"
"44052","MEOLO",477,129,0,606,"2024","022"
"44053","MERANA",30,0,0,30,"2024","093"
"44054","MERATE",46,268,0,314,"2024","048"
"44055","MERCALLO",1,0,0,1,"2024",NA
"44056","MERCATO SARACENO",327,2,12,341,"2024","020"
"44057","MERCENASCO",689,0,0,689,"2024","150"
"44058","MERGOZZO",25,0,0,25,"2024","044"
"44059","MERLARA",789,0,0,789,"2024","053"
"44060","MERLINO",0,1040,0,1040,"2024","039"
"44061","MERONE",38,9,0,47,"2024","147"
"44062","MESE",40,40,32,112,"2024","043"
"44063","MESENZANA",3,22,0,25,"2024","102"
"44064","MESERO",1,18,7,26,"2024","144"
"44065","MESOLA",800,205,0,1005,"2024","014"
"44066","MESTRINO",80,66,0,146,"2024","054"
"44067","MEZZANA BIGLI",83,0,0,83,"2024","090"
"44068","MEZZANE DI SOTTO",0,17,0,17,"2024","047"
"44069","MEZZENILE",26,0,11,37,"2024","152"
"44070","MEZZOLDO",4,18,0,22,"2024","134"
"44071","MEZZOMERICO",9,0,0,9,"2024","097"
"44072","MIAGLIANO",14,0,0,14,"2024","034"
"44073","MIANE",5,8,2,15,"2024","042"
"44074","MIASINO",0,0,44,44,"2024","098"
"44075","MIAZZINA",3,0,0,3,"2024","045"
"44076","MILANO",279,63,132,474,"2024","146"
"44077","MILZANO",2,954,0,956,"2024","108"
"44078","MINERBE",1948,230,98,2276,"2024","048"
"44079","MINERBIO",48,0,0,48,"2024","038"
"44080","MIRA",2136,161,0,2297,"2024","023"
"44081","MIRABELLO MONFERRATO",73,0,0,73,"2024","094"
"44082","MIRADOLO TERME",12,0,17,29,"2024","093"
"44083","MIRANDOLA",240,1719,0,1959,"2024","022"
"44084","MIRANO",664,647,0,1311,"2024","024"
"44085","MISANO ADRIATICO",14,0,0,14,"2024","005"
"44086","MISANO DI GERA D'ADDA",7,279,0,286,"2024","135"
"44087","MISSAGLIA",14,451,4,469,"2024","049"
"44088","MOASCA",2,0,0,2,"2024",NA
"44089","MODENA",92,2044,0,2136,"2024","023"
"44090","MODIGLIANA",125,1,0,126,"2024","022"
"44091","MOGLIA",6169,1384,8,7561,"2024","035"
"44092","MOGLIANO VENETO",1085,529,0,1614,"2024","043"
"44093","MOIO DE' CALVI",5,7,0,12,"2024","136"
"44094","MOIOLA",0,0,27,27,"2024","123"
"44095","MOLINELLA",2028,414,0,2442,"2024","039"
"44096","MOLLIA",0,5,0,5,"2024","078"
"44097","MOLTENO",14,35,0,49,"2024","051"
"44098","MOMBALDONE",62,0,0,62,"2024","064"
"44099","MOMBARCARO",76,0,0,76,"2024","124"
"44100","MOMBARUZZO",4,0,0,4,"2024","065"
"44101","MOMBASIGLIO",78,0,0,78,"2024","125"
"44102","MOMBELLO DI TORINO",13,0,0,13,"2024","153"
"44103","MOMBELLO MONFERRATO",7,0,0,7,"2024","097"
"44104","MOMBERCELLI",62,0,0,62,"2024","066"
"44105","MOMO",284,438,32,754,"2024","100"
"44106","MOMPERONE",2,0,0,2,"2024","098"
"44107","MONALE",19,0,0,19,"2024","067"
"44108","MONASTERO BORMIDA",375,0,0,375,"2024","068"
"44109","MONASTERO DI LANZO",38,0,0,38,"2024","155"
"44110","MONASTERO DI VASCO",727,0,48,775,"2024","126"
"44111","MONASTEROLO CASOTTO",60,0,0,60,"2024","127"
"44112","MONASTEROLO DEL CASTELLO",15,32,0,47,"2024","137"
"44113","MONASTEROLO DI SAVIGLIANO",1306,318,0,1624,"2024","128"
"44114","MONASTIER DI TREVISO",2068,43,233,2344,"2024","044"
"44115","MONCALIERI",328,284,0,612,"2024","156"
"44116","MONCALVO",161,0,0,161,"2024","069"
"44117","MONCENISIO",4,0,0,4,"2024","157"
"44118","MONCHIERO",111,0,0,111,"2024","129"
"44119","MONCHIO DELLE CORTI",66,142,0,208,"2024","022"
"44120","MONCRIVELLO",160,235,0,395,"2024","079"
"44121","MONCUCCO TORINESE",20,0,0,20,"2024","070"
"44122","MONDOVI'",10308,11,293,10612,"2024","130"
"44123","MONESIGLIO",84,0,0,84,"2024","131"
"44124","MONFORTE D'ALBA",230,0,0,230,"2024","132"
"44125","MONFUMO",34,161,1,196,"2024","045"
"44126","MONGARDINO",36,0,0,36,"2024","071"
"44127","MONGHIDORO",39,90,0,129,"2024","040"
"44128","MONGIARDINO LIGURE",12,0,1,13,"2024","100"
"44129","MONGRANDO",225,128,0,353,"2024","035"
"44130","MONGUZZO",40,0,0,40,"2024","153"
"44131","MONNO",2,64,10,76,"2024","110"
"44132","MONSELICE",218,36,0,254,"2024","055"
"44133","MONTA'",413,0,0,413,"2024","133"
"44134","MONTABONE",18,0,0,18,"2024","072"
"44135","MONTAFIA",22,0,0,22,"2024","073"
"44136","MONTAGNA IN VALTELLINA",7,58,0,65,"2024","044"
"44137","MONTAGNANA",1371,0,0,1371,"2024","056"
"44138","MONTALDO DI MONDOVI'",206,0,54,260,"2024","134"
"44139","MONTALDO SCARAMPI",40,0,0,40,"2024","074"
"44140","MONTALDO TORINESE",607,0,0,607,"2024","158"
"44141","MONTALTO DORA",58,0,0,58,"2024","160"
"44142","MONTALTO PAVESE",85,0,0,85,"2024","094"
"44143","MONTANARO",279,58,84,421,"2024","161"
"44144","MONTANASO LOMBARDO",63,1627,0,1690,"2024","040"
"44145","MONTANERA",2200,806,92,3098,"2024","136"
"44146","MONTANO LUCINO",9,0,1,10,"2024","154"
"44147","MONTE CREMASCO",189,115,0,304,"2024","058"
"44148","MONTE DI MALO",8,97,0,105,"2024","063"
"44149","MONTE ISOLA",20,0,0,20,"2024","111"
"44150","MONTE MARENZO",6,0,0,6,"2024","052"
"44151","MONTE SAN PIETRO",123,153,0,276,"2024","042"
"44152","MONTEBELLO DELLA BATTAGLIA",0,30,0,30,"2024","095"
"44153","MONTEBELLO VICENTINO",333,0,4,337,"2024","060"
"44154","MONTEBELLUNA",3061,414,12,3487,"2024","046"
"44155","MONTECALVO VERSIGGIA",3,0,0,3,"2024",NA
"44156","MONTECASTELLO",1,0,0,1,"2024","105"
"44157","MONTECCHIA DI CROSARA",317,3,0,320,"2024","049"
"44158","MONTECCHIO EMILIA",3,1793,0,1796,"2024","027"
"44159","MONTECCHIO MAGGIORE",202,38,0,240,"2024","061"
"44160","MONTECCHIO PRECALCINO",319,140,0,459,"2024","062"
"44161","MONTECHIARO D'ACQUI",72,0,0,72,"2024","106"
"44162","MONTECHIARO D'ASTI",637,0,0,637,"2024","075"
"44163","MONTECHIARUGOLO",31,3192,0,3223,"2024","023"
"44164","MONTECOPIOLO",447,24,4,475,"2024",NA
"44165","MONTECRESTESE",39,82,0,121,"2024","046"
"44166","MONTECRETO",12,641,0,653,"2024","024"
"44167","MONTEFIORE CONCA",21,16,0,37,"2024","008"
"44168","MONTEFIORINO",90,251,0,341,"2024","025"
"44169","MONTEFORTE D'ALPONE",734,4,0,738,"2024","050"
"44170","MONTEGALDA",21,146,0,167,"2024","064"
"44171","MONTEGALDELLA",10,312,0,322,"2024","065"
"44172","MONTEGIOCO",23,0,0,23,"2024","107"
"44173","MONTEGRIDOLFO",1,0,0,1,"2024","009"
"44174","MONTEGRINO VALTRAVAGLIA",10,0,0,10,"2024","103"
"44175","MONTEGROSSO D'ASTI",17,0,0,17,"2024","076"
"44176","MONTEGROTTO TERME",5,28,0,33,"2024","057"
"44177","MONTELUPO ALBESE",94,0,0,94,"2024","137"
"44178","MONTEMAGNO MONFERRATO",178,0,0,178,"2024",NA
"44179","MONTEMALE DI CUNEO",192,0,0,192,"2024","138"
"44180","MONTERENZIO",600,151,0,751,"2024","041"
"44181","MONTEROSSO GRANA",17,131,14,162,"2024","139"
"44182","MONTESCANO",1,0,0,1,"2024","097"
"44183","MONTESCUDO-MONTE COLOMBO",168,0,0,168,"2024",NA
"44184","MONTESE",110,1361,0,1471,"2024","026"
"44185","MONTESEGALE",19,0,0,19,"2024","098"
"44186","MONTEU DA PO",64,0,0,64,"2024","162"
"44187","MONTEU ROERO",549,0,0,549,"2024","140"
"44188","MONTEVECCHIA",2,0,0,2,"2024","053"
"44189","MONTEVIALE",49,1,0,50,"2024","066"
"44190","MONTEZEMOLO",134,0,0,134,"2024","141"
"44191","MONTIANO",2,0,0,2,"2024","028"
"44192","MONTICELLI BRUSATI",16,230,3,249,"2024","112"
"44193","MONTICELLI D'ONGINA",271,836,0,1107,"2024","027"
"44194","MONTICELLI PAVESE",1545,322,0,1867,"2024","099"
"44195","MONTICELLO BRIANZA",15,0,36,51,"2024","054"
"44196","MONTICELLO CONTE OTTO",159,833,45,1037,"2024","067"
"44197","MONTICELLO D'ALBA",59,0,0,59,"2024","142"
"44198","MONTICHIARI",8852,7112,513,16477,"2024","113"
"44199","MONTIGLIO MONFERRATO",201,0,0,201,"2024","121"
"44200","MONTIRONE",3287,370,0,3657,"2024","114"
"44201","MONTODINE",79,1094,0,1173,"2024","059"
"44202","MONTORFANO",2,0,0,2,"2024","157"
"44203","MONTORSO VICENTINO",650,119,5,774,"2024","068"
"44204","MONVALLE",22,0,0,22,"2024","104"
"44205","MONZA",34,45,0,79,"2024",NA
"44206","MONZAMBANO",1487,546,212,2245,"2024","036"
"44207","MONZUNO",6,60,0,66,"2024","044"
"44208","MORANO SUL PO",1,0,0,1,"2024","109"
"44209","MORANSENGO-TONENGO",476,0,0,476,"2024",NA
"44210","MORAZZONE",80,95,0,175,"2024","105"
"44211","MORBEGNO",23,67,1,91,"2024","045"
"44212","MORBELLO",1,0,0,1,"2024","110"
"44213","MORENGO",83,173,0,256,"2024","140"
"44214","MORETTA",1712,289,147,2148,"2024","143"
"44215","MORFASSO",181,3,0,184,"2024","028"
"44216","MORGANO",1356,2,0,1358,"2024","047"
"44217","MORIAGO DELLA BATTAGLIA",1012,65,0,1077,"2024","048"
"44218","MORIMONDO",45,1502,0,1547,"2024","150"
"44219","MORIONDO TORINESE",441,0,0,441,"2024","163"
"44220","MORNAGO",28,0,0,28,"2024","106"
"44221","MORNESE",47,0,0,47,"2024","111"
"44222","MORNICO AL SERIO",445,568,0,1013,"2024","141"
"44223","MORNICO LOSANA",31,0,0,31,"2024","101"
"44224","MOROZZO",3775,497,342,4614,"2024","144"
"44225","MORSASCO",207,0,0,207,"2024","112"
"44226","MORTARA",9,0,0,9,"2024","102"
"44227","MORTERONE",3,0,11,14,"2024","055"
"44228","MOSCAZZANO",3,1400,0,1403,"2024","060"
"44229","MOTTA BALUFFI",2,101,0,103,"2024","061"
"44230","MOTTA DI LIVENZA",9,8,0,17,"2024","049"
"44231","MOTTA VISCONTI",16,0,0,16,"2024","151"
"44232","MOTTALCIATA",80,40,1,121,"2024","037"
"44233","MOTTEGGIANA",1,2310,0,2311,"2024","037"
"44234","MOZZANICA",45,597,0,642,"2024","142"
"44235","MOZZATE",19,84,0,103,"2024","159"
"44236","MOZZECANE",2956,1644,0,4600,"2024","051"
"44237","MULAZZANO",15,864,6,885,"2024","041"
"44238","MURA",30,1,14,45,"2024","115"
"44239","MURAZZANO",471,0,27,498,"2024","145"
"44240","MURELLO",724,1277,189,2190,"2024","146"
"44241","MURISENGO",439,0,0,439,"2024","113"
"44242","MUSCOLINE",520,515,8,1043,"2024","116"
"44243","MUSILE DI PIAVE",20,3,0,23,"2024","025"
"44244","MUSSO",0,0,6,6,"2024","160"
"44245","MUSSOLENTE",196,224,0,420,"2024","070"
"44246","MUZZANO",62,0,0,62,"2024","038"
"44247","NANTO",305,197,0,502,"2024","071"
"44248","NARZOLE",2393,162,0,2555,"2024","147"
"44249","NAVE",58,188,1,247,"2024","117"
"44250","NEBBIUNO",87,0,18,105,"2024","103"
"44251","NEGRAR DI VALPOLICELLA",11,103,6,120,"2024",NA
"44252","NEIVE",32,0,0,32,"2024","148"
"44253","NEMBRO",72,4,0,76,"2024","144"
"44254","NERVESA DELLA BATTAGLIA",609,157,14,780,"2024","050"
"44255","NERVIANO",39,106,0,145,"2024","154"
"44256","NESSO",8,4,0,12,"2024","161"
"44257","NETRO",245,37,6,288,"2024","039"
"44258","NEVIANO DEGLI ARDUINI",62,2056,0,2118,"2024","024"
"44259","NEVIGLIE",6,0,0,6,"2024","149"
"44260","NIARDO",16,115,50,181,"2024","118"
"44261","NICHELINO",30,0,17,47,"2024","164"
"44262","NIELLA BELBO",225,0,0,225,"2024","150"
"44263","NIELLA TANARO",588,0,0,588,"2024","151"
"44264","NIZZA MONFERRATO",46,3,0,49,"2024","080"
"44265","NOALE",249,80,3,332,"2024","026"
"44266","NOASCA",2,0,31,33,"2024","165"
"44267","NOCETO",28,3590,0,3618,"2024","025"
"44268","NOGARA",2824,534,0,3358,"2024","053"
"44269","NOGAROLE ROCCA",237,303,0,540,"2024","054"
"44270","NOGAROLE VICENTINO",10,6,3,19,"2024","072"
"44271","NOLE",323,86,93,502,"2024","166"
"44272","NONANTOLA",40,115,0,155,"2024","027"
"44273","NONE",1063,1220,276,2559,"2024","168"
"44274","NONIO",26,0,0,26,"2024",NA
"44275","NOSATE",14,0,0,14,"2024","155"
"44276","NOVA MILANESE",0,83,0,83,"2024",NA
"44277","NOVAFELTRIA",875,226,0,1101,"2024","023"
"44278","NOVALESA",124,18,8,150,"2024","169"
"44279","NOVARA",58,256,2,316,"2024","106"
"44280","NOVATE MEZZOLA",5,0,19,24,"2024","046"
"44281","NOVE",15,191,0,206,"2024","073"
"44282","NOVEDRATE",3,0,0,3,"2024","163"
"44283","NOVELLARA",3172,2216,0,5388,"2024","028"
"44284","NOVELLO",1043,0,0,1043,"2024","152"
"44285","NOVENTA DI PIAVE",4,10,0,14,"2024","027"
"44286","NOVENTA PADOVANA",1,0,0,1,"2024","058"
"44287","NOVENTA VICENTINA",2910,0,0,2910,"2024","074"
"44288","NOVI DI MODENA",743,724,0,1467,"2024","028"
"44289","NOVI LIGURE",706,0,0,706,"2024","114"
"44290","NOVIGLIO",18,378,10,406,"2024","158"
"44291","NUVOLENTO",3,1153,0,1156,"2024","119"
"44292","NUVOLERA",1405,423,0,1828,"2024","120"
"44293","OCCHIEPPO INFERIORE",14,105,0,119,"2024","040"
"44294","OCCHIEPPO SUPERIORE",62,33,39,134,"2024","041"
"44295","OCCHIOBELLO",7,121,0,128,"2024","033"
"44296","OCCIMIANO",28,0,0,28,"2024","115"
"44297","ODALENGO GRANDE",93,0,0,93,"2024","116"
"44298","ODERZO",31,323,0,354,"2024","051"
"44299","ODOLO",13,0,9,22,"2024","121"
"44300","OFFANENGO",282,725,2,1009,"2024","062"
"44301","OFFLAGA",4,4496,0,4500,"2024","122"
"44302","OGGEBBIO",3,0,0,3,"2024","049"
"44303","OGGIONA CON SANTO STEFANO",5,26,0,31,"2024","107"
"44304","OGGIONO",84,0,25,109,"2024","057"
"44305","OGLIANICO",213,304,18,535,"2024","170"
"44306","OLCENENGO",2,0,0,2,"2024","088"
"44307","OLEGGIO",366,1066,37,1469,"2024","108"
"44308","OLEGGIO CASTELLO",3,0,0,3,"2024","109"
"44309","OLGIATE COMASCO",55,0,25,80,"2024","165"
"44310","OLGIATE MOLGORA",22,60,0,82,"2024","058"
"44311","OLGIATE OLONA",2,0,0,2,"2024","108"
"44312","OLGINATE",9,0,0,9,"2024","059"
"44313","OLIVA GESSI",15,0,0,15,"2024",NA
"44314","OLIVETO LARIO",29,0,3,32,"2024","060"
"44315","OLMENETA",0,513,0,513,"2024","063"
"44316","OLMO AL BREMBO",1,4,0,5,"2024","145"
"44317","OLMO GENTILE",42,0,8,50,"2024","081"
"44318","OLTRE IL COLLE",17,72,0,89,"2024","146"
"44319","OLTRESSENDA ALTA",7,32,0,39,"2024","147"
"44320","OLTRONA DI SAN MAMETTE",34,0,0,34,"2024","169"
"44321","OME",8,10,0,18,"2024","123"
"44322","OMEGNA",79,0,0,79,"2024","050"
"44323","ONETA",8,45,0,53,"2024","148"
"44324","ONO SAN PIETRO",3,10,0,13,"2024","124"
"44325","ONORE",2,16,0,18,"2024","149"
"44326","OPERA",0,100,0,100,"2024","159"
"44327","OPPEANO",5524,616,0,6140,"2024","055"
"44328","ORBASSANO",733,1,104,838,"2024","171"
"44329","ORGIANO",311,27,0,338,"2024","075"
"44330","ORIGGIO",99,0,0,99,"2024","109"
"44331","ORIO LITTA",9,128,0,137,"2024","042"
"44332","ORMEA",171,0,27,198,"2024","155"
"44333","ORMELLE",13,19,0,32,"2024","052"
"44334","ORNAGO",14,36,0,50,"2024",NA
"44335","ORNAVASSO",68,0,0,68,"2024","051"
"44336","ORNICA",2,0,0,2,"2024","151"
"44337","ORSAGO",2,0,0,2,"2024","053"
"44338","ORSARA BORMIDA",10,0,0,10,"2024","119"
"44339","ORSENIGO",2,51,0,53,"2024","170"
"44340","ORTA SAN GIULIO",3,0,0,3,"2024","112"
"44341","ORZINUOVI",604,5134,13,5751,"2024","125"
"44342","ORZIVECCHI",2,979,0,981,"2024","126"
"44343","OSASCO",490,0,90,580,"2024","173"
"44344","OSASIO",310,75,100,485,"2024","174"
"44345","OSIO SOPRA",2,576,0,578,"2024","152"
"44346","OSIO SOTTO",4,0,0,4,"2024","153"
"44347","OSNAGO",137,71,0,208,"2024","061"
"44348","OSPEDALETTO EUGANEO",222,0,0,222,"2024","059"
"44349","OSPEDALETTO LODIGIANO",0,756,0,756,"2024","043"
"44350","OSPITALETTO",134,156,0,290,"2024","127"
"44351","OSSAGO LODIGIANO",36,1095,420,1551,"2024","044"
"44352","OSSIMO",5,8,4,17,"2024","128"
"44353","OSSONA",62,0,0,62,"2024","164"
"44354","OSTELLATO",5143,0,0,5143,"2024","017"
"44355","OSTIANO",331,1334,0,1665,"2024","064"
"44356","OSTIGLIA",47,44,0,91,"2024","038"
"44357","OTTIGLIO",185,0,0,185,"2024","120"
"44358","OTTOBIANO",0,23,0,23,"2024","106"
"44359","OTTONE",281,1,0,282,"2024","030"
"44360","OULX",88,0,0,88,"2024","175"
"44361","OVADA",37,0,0,37,"2024","121"
"44362","OVIGLIO",65,13,0,78,"2024","122"
"44363","OZEGNA",457,0,0,457,"2024","176"
"44364","OZZANO DELL'EMILIA",187,242,0,429,"2024","046"
"44365","OZZANO MONFERRATO",137,0,0,137,"2024","123"
"44366","OZZERO",5,104,59,168,"2024","165"
"44367","PADENGHE SUL GARDA",37,0,13,50,"2024","129"
"44368","PADERNO D'ADDA",0,19,0,19,"2024","062"
"44369","PADERNO DUGNANO",6,0,0,6,"2024","166"
"44370","PADERNO FRANCIACORTA",85,103,86,274,"2024","130"
"44371","PADERNO PONCHIELLI",165,1872,132,2169,"2024","065"
"44372","PADOVA",475,200,48,723,"2024","060"
"44373","PAESANA",1604,7,0,1611,"2024","157"
"44374","PAESE",1927,539,187,2653,"2024","055"
"44375","PAGNO",51,0,0,51,"2024","158"
"44376","PAGNONA",0,4,2,6,"2024","063"
"44377","PAISCO LOVENO",3,15,1,19,"2024","131"
"44378","PAITONE",15,11,0,26,"2024","132"
"44379","PALADINA",14,0,0,14,"2024","155"
"44380","PALAGANO",34,552,0,586,"2024","029"
"44381","PALANZANO",10,521,21,552,"2024","026"
"44382","PALAZZAGO",114,55,0,169,"2024","156"
"44383","PALAZZO CANAVESE",27,0,2,29,"2024","177"
"44384","PALAZZO PIGNANO",3,699,0,702,"2024","066"
"44385","PALAZZOLO SULL'OGLIO",1025,1340,1,2366,"2024","133"
"44386","PALAZZOLO VERCELLESE",10,0,0,10,"2024","090"
"44387","PALESTRO",3,0,19,22,"2024","107"
"44388","PALLANZENO",155,0,0,155,"2024","052"
"44389","PALOSCO",438,489,0,927,"2024","157"
"44390","PALU'",261,0,0,261,"2024","056"
"44391","PAMPARATO",63,0,0,63,"2024","159"
"44392","PANCALIERI",249,32,0,281,"2024","178"
"44393","PANDINO",3,2969,0,2972,"2024","067"
"44394","PAPOZZE",18,120,0,138,"2024","034"
"44395","PARABIAGO",24,32,0,56,"2024","168"
"44396","PARATICO",6,45,0,51,"2024","134"
"44397","PARELLA",2,0,0,2,"2024",NA
"44398","PARETO",74,3,0,77,"2024","125"
"44399","PARMA",316,9266,0,9582,"2024","027"
"44400","PARODI LIGURE",51,0,47,98,"2024","126"
"44401","PAROLDO",52,0,4,56,"2024","160"
"44402","PARONA",5,0,0,5,"2024","109"
"44403","PARRE",40,59,3,102,"2024","158"
"44404","PARUZZARO",61,25,0,86,"2024","114"
"44405","PARZANICA",11,14,0,25,"2024","159"
"44406","PASPARDO",2,2,0,4,"2024","135"
"44407","PASSERANO MARMORITO",56,0,0,56,"2024","082"
"44408","PASSIRANO",41,190,0,231,"2024","136"
"44409","PASTRENGO",0,109,0,109,"2024","057"
"44410","PASTURANA",2,0,0,2,"2024",NA
"44411","PASTURO",141,97,34,272,"2024","065"
"44412","PAULLO",2,493,0,495,"2024","169"
"44413","PAVAROLO",98,0,0,98,"2024","180"
"44414","PAVIA",89,278,6,373,"2024","110"
"44415","PAVONE CANAVESE",221,0,0,221,"2024","181"
"44416","PAVONE DEL MELLA",2700,339,2,3041,"2024","137"
"44417","PAVULLO NEL FRIGNANO",178,3601,0,3779,"2024","030"
"44418","PECETTO DI VALENZA",23,0,0,23,"2024","128"
"44419","PECETTO TORINESE",124,0,0,124,"2024","183"
"44420","PEDAVENA",1,97,4,102,"2024","036"
"44421","PEDEMONTE",2,0,7,9,"2024","076"
"44422","PEDEROBBA",38,118,0,156,"2024","056"
"44423","PEDRENGO",17,256,0,273,"2024","160"
"44424","PEGLIO",2,5,11,18,"2024","178"
"44425","PEGOGNAGA",1842,3698,170,5710,"2024","039"
"44426","PEIA",8,14,0,22,"2024","161"
"44427","PELLEGRINO PARMENSE",111,722,0,833,"2024","028"
"44428","PENANGO",65,0,0,65,"2024","083"
"44429","PENNABILLI",517,0,0,517,"2024","024"
"44430","PERLEDO",2,0,0,2,"2024","067"
"44431","PERLETTO",234,0,0,234,"2024","161"
"44432","PERLO",59,0,0,59,"2024","162"
"44433","PERNUMIA",3,146,0,149,"2024","061"
"44434","PEROSA ARGENTINA",164,0,9,173,"2024","184"
"44435","PEROSA CANAVESE",190,184,0,374,"2024","185"
"44436","PERRERO",52,0,7,59,"2024","186"
"44437","PERSICO DOSIMO",3,1903,25,1931,"2024","068"
"44438","PERTICA ALTA",21,14,5,40,"2024","139"
"44439","PERTICA BASSA",32,52,24,108,"2024","140"
"44440","PERTUSIO",135,0,5,140,"2024","187"
"44441","PESCANTINA",182,16,0,198,"2024","058"
"44442","PESCAROLO ED UNITI",28,781,19,828,"2024","069"
"44443","PESCHIERA BORROMEO",105,306,1,412,"2024","171"
"44444","PESSANO CON BORNAGO",57,131,0,188,"2024","172"
"44445","PESSINA CREMONESE",505,3383,147,4035,"2024","070"
"44446","PESSINETTO",1,0,0,1,"2024","188"
"44447","PETTENASCO",12,0,0,12,"2024","116"
"44448","PETTINENGO",7,24,0,31,"2024","042"
"44449","PETTORAZZA GRIMANI",22,185,0,207,"2024","035"
"44450","PEVERAGNO",1674,428,4,2106,"2024","163"
"44451","PEZZAZE",30,47,0,77,"2024","141"
"44452","PEZZOLO VALLE UZZONE",56,0,0,56,"2024","164"
"44453","PIACENZA",429,1835,0,2264,"2024","032"
"44454","PIACENZA D'ADIGE",515,0,0,515,"2024","062"
"44455","PIADENA DRIZZONA",98,838,68,1004,"2024",NA
"44456","PIAN CAMUNO",0,294,21,315,"2024","142"
"44457","PIANCOGNO",0,90,8,98,"2024","206"
"44458","PIANELLO DEL LARIO",10,0,7,17,"2024","183"
"44459","PIANELLO VAL TIDONE",589,91,0,680,"2024","033"
"44460","PIANENGO",1,405,0,406,"2024","072"
"44461","PIANEZZA",492,337,133,962,"2024","189"
"44462","PIANEZZE",122,58,0,180,"2024","077"
"44463","PIANFEI",1170,0,12,1182,"2024","165"
"44464","PIANICO",16,59,0,75,"2024","162"
"44465","PIANIGA",28,0,0,28,"2024","028"
"44466","PIANORO",201,131,0,332,"2024","047"
"44467","PIANTEDO",5,236,0,241,"2024","048"
"44468","PIARIO",61,0,0,61,"2024","163"
"44469","PIASCO",388,179,0,567,"2024","166"
"44470","PIATEDA",30,48,0,78,"2024","049"
"44471","PIATTO",52,0,0,52,"2024","043"
"44472","PIAZZA BREMBANA",3,0,0,3,"2024","164"
"44473","PIAZZATORRE",7,0,0,7,"2024","165"
"44474","PIAZZOLA SUL BRENTA",2407,1027,0,3434,"2024","063"
"44475","PIEA",93,0,0,93,"2024","084"
"44476","PIEDIMULERA",0,23,0,23,"2024","053"
"44477","PIERANICA",73,42,0,115,"2024","073"
"44478","PIETRA DE' GIORGI",4,0,0,4,"2024","111"
"44479","PIEVE D'OLMI",0,2350,0,2350,"2024","074"
"44480","PIEVE DEL CAIRO",0,60,0,60,"2024","113"
"44481","PIEVE DEL GRAPPA",1012,775,25,1812,"2024",NA
"44482","PIEVE DI CADORE",3,17,0,20,"2024","039"
"44483","PIEVE DI SOLIGO",21,124,5,150,"2024","057"
"44484","PIEVE EMANUELE",0,330,184,514,"2024","173"
"44485","PIEVE FISSIRAGA",287,1364,0,1651,"2024","045"
"44486","PIEVE PORTO MORONE",122,0,0,122,"2024","114"
"44487","PIEVE SAN GIACOMO",0,1920,0,1920,"2024","075"
"44488","PIEVE VERGONTE",78,6,61,145,"2024","054"
"44489","PIEVEPELAGO",58,64,0,122,"2024","031"
"44490","PINAROLO PO",2287,0,0,2287,"2024","115"
"44491","PINASCA",204,0,40,244,"2024","190"
"44492","PINCARA",334,0,0,334,"2024","036"
"44493","PINEROLO",2412,147,99,2658,"2024","191"
"44494","PINO TORINESE",612,0,24,636,"2024","192"
"44495","PIOBESI D'ALBA",53,0,0,53,"2024",NA
"44496","PIOBESI TORINESE",410,999,306,1715,"2024","193"
"44497","PIODE",0,6,0,6,"2024","097"
"44498","PIOLTELLO",1,0,0,1,"2024","175"
"44499","PIOMBINO DESE",3847,148,0,3995,"2024","064"
"44500","PIOSSASCO",687,924,38,1649,"2024","194"
"44501","PIOVA' MASSAIA",311,0,0,311,"2024","086"
"44502","PIOVE DI SACCO",4088,90,0,4178,"2024","065"
"44503","PIOVENE ROCCHETTE",1582,128,1,1711,"2024","078"
"44504","PIOZZANO",336,0,0,336,"2024","034"
"44505","PIOZZO",505,0,0,505,"2024","169"
"44506","PISCINA",1883,0,0,1883,"2024","195"
"44507","PISOGNE",12,207,17,236,"2024","143"
"44508","PIUBEGA",4749,1314,14,6077,"2024","041"
"44509","PIURO",31,202,0,233,"2024","050"
"44510","PIVERONE",135,19,46,200,"2024","196"
"44511","PIZZIGHETTONE",146,2769,0,2915,"2024","076"
"44512","POCAPAGLIA",138,43,0,181,"2024","170"
"44513","PODENZANO",85,533,0,618,"2024","035"
"44514","POGGIO RENATICO",22,561,0,583,"2024","018"
"44515","POGGIO RUSCO",321,1029,10,1360,"2024","042"
"44516","POGGIO TORRIANA",361,0,0,361,"2024",NA
"44517","POGGIRIDENTI",3,0,0,3,"2024","051"
"44518","POGNANO",104,244,0,348,"2024","167"
"44519","POGNO",1,0,0,1,"2024",NA
"44520","POIRINO",4508,440,237,5185,"2024","197"
"44521","POJANA MAGGIORE",944,30,0,974,"2024","079"
"44522","POLAVENO",30,40,0,70,"2024","144"
"44523","POLESINE ZIBELLO",41,1402,0,1443,"2024",NA
"44524","POLINAGO",56,605,0,661,"2024","032"
"44525","POLLONE",401,47,0,448,"2024","046"
"44526","POLONGHERA",259,150,56,465,"2024","171"
"44527","POLPENAZZE DEL GARDA",11,113,0,124,"2024","145"
"44528","POLVERARA",3,3,0,6,"2024","066"
"44529","POMARETTO",78,0,19,97,"2024","198"
"44530","POMARO MONFERRATO",1,0,206,207,"2024","131"
"44531","POMBIA",1,36,0,37,"2024","121"
"44532","POMPIANO",6,1518,0,1524,"2024","146"
"44533","POMPONESCO",18,380,11,409,"2024","043"
"44534","PONCARALE",434,584,4,1022,"2024","147"
"44535","PONDERANO",134,36,48,218,"2024","047"
"44536","PONNA",3,0,4,7,"2024","187"
"44537","PONSO",9,0,0,9,"2024","067"
"44538","PONT CANAVESE",88,31,0,119,"2024",NA
"44539","PONTE DELL'OLIO",293,25,0,318,"2024","036"
"44540","PONTE DI LEGNO",10,3,1,14,"2024","148"
"44541","PONTE DI PIAVE",53,27,1,81,"2024","058"
"44542","PONTE IN VALTELLINA",29,1,0,30,"2024","052"
"44543","PONTE LAMBRO",10,3,0,13,"2024","188"
"44544","PONTE NELLE ALPI",24,71,0,95,"2024","040"
"44545","PONTE NIZZA",155,26,0,181,"2024","117"
"44546","PONTE NOSSA",0,10,0,10,"2024","168"
"44547","PONTE SAN NICOLO'",5,22,21,48,"2024","069"
"44548","PONTE SAN PIETRO",4,0,0,4,"2024","170"
"44549","PONTECCHIO POLESINE",763,0,0,763,"2024","038"
"44550","PONTECHIANALE",103,0,0,103,"2024","172"
"44551","PONTECURONE",6,0,0,6,"2024","132"
"44552","PONTELONGO",295,0,0,295,"2024","068"
"44553","PONTENURE",45,164,0,209,"2024","037"
"44554","PONTERANICA",18,0,0,18,"2024","169"
"44555","PONTESTURA",29,0,0,29,"2024","133"
"44556","PONTEVICO",247,3269,291,3807,"2024","149"
"44557","PONTI",117,0,4,121,"2024","134"
"44558","PONTI SUL MINCIO",115,360,42,517,"2024","044"
"44559","PONTIDA",53,0,0,53,"2024","171"
"44560","PONTIROLO NUOVO",250,591,0,841,"2024","172"
"44561","PONTOGLIO",543,1515,0,2058,"2024","150"
"44562","PONZANO MONFERRATO",57,0,0,57,"2024","135"
"44563","PONZANO VENETO",433,61,0,494,"2024","059"
"44564","PONZONE",29,0,14,43,"2024","136"
"44565","PORLEZZA",9,19,11,39,"2024","189"
"44566","PORTACOMARO",46,0,0,46,"2024","087"
"44567","PORTALBERA",3,0,0,3,"2024","118"
"44568","PORTE",34,0,0,34,"2024","200"
"44569","PORTICO E SAN BENEDETTO",127,0,0,127,"2024","031"
"44570","PORTO MANTOVANO",1760,1329,1307,4396,"2024","045"
"44571","PORTO TOLLE",15,0,0,15,"2024","039"
"44572","PORTO VALTRAVAGLIA",4,0,14,18,"2024","114"
"44573","PORTO VIRO",4008,0,0,4008,"2024","052"
"44574","PORTOGRUARO",1100,36,0,1136,"2024","029"
"44575","PORTOMAGGIORE",1233,325,0,1558,"2024","019"
"44576","POSINA",0,16,0,16,"2024","080"
"44577","POSSAGNO",14,0,0,14,"2024","061"
"44578","POSTALESIO",1,0,0,1,"2024","053"
"44579","POSTUA",21,0,0,21,"2024","102"
"44580","POVE DEL GRAPPA",5,0,0,5,"2024","081"
"44581","POVEGLIANO",177,175,2,354,"2024","062"
"44582","POVEGLIANO VERONESE",2152,425,25,2602,"2024","060"
"44583","POVIGLIO",8,1460,0,1468,"2024","029"
"44584","POZZAGLIO ED UNITI",22,2094,170,2286,"2024","077"
"44585","POZZO D'ADDA",340,0,0,340,"2024","177"
"44586","POZZOL GROPPO",33,0,0,33,"2024","137"
"44587","POZZOLENGO",529,393,10,932,"2024","151"
"44588","POZZOLEONE",122,2212,11,2345,"2024","082"
"44589","POZZOLO FORMIGARO",97,0,0,97,"2024","138"
"44590","POZZONOVO",1624,0,0,1624,"2024","070"
"44591","POZZUOLO MARTESANA",3,199,0,202,"2024","178"
"44592","PRADALUNGA",32,0,0,32,"2024","173"
"44593","PRADLEVES",0,5,0,5,"2024","173"
"44594","PRAGELATO",20,1,2,23,"2024","201"
"44595","PRALBOINO",1542,780,59,2381,"2024","152"
"44596","PRALI",91,0,10,101,"2024","202"
"44597","PRALORMO",1329,210,209,1748,"2024","203"
"44598","PRALUNGO",166,0,15,181,"2024","049"
"44599","PRAMAGGIORE",2,1,0,3,"2024","030"
"44600","PRAMOLLO",15,0,0,15,"2024","204"
"44601","PRAROSTINO",65,8,0,73,"2024","205"
"44602","PRASCO",42,0,0,42,"2024","139"
"44603","PRASCORSANO",1,0,0,1,"2024","206"
"44604","PRATA CAMPORTACCIO",34,115,31,180,"2024","054"
"44605","PRATIGLIONE",1,0,0,1,"2024","207"
"44606","PRATO SESIA",1,13,0,14,"2024","122"
"44607","PRAY",172,0,0,172,"2024","050"
"44608","PRAZZO",252,19,19,290,"2024","174"
"44609","PREDAPPIO",317,0,0,317,"2024","032"
"44610","PREDORE",36,0,0,36,"2024","174"
"44611","PREDOSA",524,104,0,628,"2024","140"
"44612","PREGANZIOL",14,172,0,186,"2024","063"
"44613","PREGNANA MILANESE",0,105,0,105,"2024","179"
"44614","PREMANA",4,0,2,6,"2024","069"
"44615","PREMENO",1,0,0,1,"2024","055"
"44616","PREMIA",78,182,1,261,"2024","056"
"44617","PREMILCUORE",530,0,19,549,"2024","033"
"44618","PREMOLO",30,8,0,38,"2024","175"
"44619","PREMOSELLO-CHIOVENDA",38,0,0,38,"2024","057"
"44620","PRESEGLIE",80,0,5,85,"2024","153"
"44621","PRESSANA",3817,0,11,3828,"2024","061"
"44622","PREVALLE",14,622,11,647,"2024","155"
"44623","PRIERO",44,0,0,44,"2024","175"
"44624","PRIGNANO SULLA SECCHIA",156,1288,0,1444,"2024","033"
"44625","PRIMALUNA",22,42,0,64,"2024","070"
"44626","PRIOCCA",614,0,0,614,"2024","176"
"44627","PRIOLA",221,0,0,221,"2024","177"
"44628","PROSERPIO",1,5,0,6,"2024","192"
"44629","PROVAGLIO D'ISEO",40,152,0,192,"2024","156"
"44630","PROVAGLIO VAL SABBIA",21,0,13,34,"2024","157"
"44631","PRUNETTO",106,0,0,106,"2024","178"
"44632","PUEGNAGO SUL GARDA",11,86,0,97,"2024","158"
"44633","PUMENENGO",2112,1061,0,3173,"2024","177"
"44634","QUAREGNA CERRETO",413,0,0,413,"2024",NA
"44635","QUARGNENTO",932,0,0,932,"2024","141"
"44636","QUARNA SOPRA",8,0,0,8,"2024","058"
"44637","QUARNA SOTTO",32,0,0,32,"2024","059"
"44638","QUARONA",10,0,0,10,"2024","107"
"44639","QUARTO D'ALTINO",4,0,0,4,"2024","031"
"44640","QUASSOLO",55,10,13,78,"2024","209"
"44641","QUATTORDIO",355,0,0,355,"2024","142"
"44642","QUATTRO CASTELLA",2,1425,0,1427,"2024","030"
"44643","QUINCINETTO",83,26,0,109,"2024","210"
"44644","QUINGENTOLE",0,55,73,128,"2024","046"
"44645","QUINTANO",0,439,0,439,"2024","078"
"44646","QUINTO DI TREVISO",122,165,9,296,"2024","064"
"44647","QUINTO VICENTINO",24,549,0,573,"2024","083"
"44648","QUINZANO D'OGLIO",214,2855,0,3069,"2024","159"
"44649","QUISTELLO",87,1613,157,1857,"2024","047"
"44650","RACCONIGI",2598,2111,134,4843,"2024","179"
"44651","RANCIO VALCUVIA",8,0,0,8,"2024","115"
"44652","RANICA",16,12,0,28,"2024","178"
"44653","RANZANICO",15,11,0,26,"2024","179"
"44654","RASURA",0,7,0,7,"2024","055"
"44655","RAVENNA",1097,1633,0,2730,"2024","014"
"44656","RE",37,0,0,37,"2024","060"
"44657","REANO",34,0,1,35,"2024","211"
"44658","RECOARO TERME",53,77,5,135,"2024","084"
"44659","REDAVALLE",72,0,0,72,"2024","120"
"44660","REDONDESCO",56,1546,47,1649,"2024","048"
"44661","REFRANCORE",17,0,0,17,"2024","089"
"44662","REFRONTOLO",5,22,2,29,"2024","065"
"44663","REGGIO NELL'EMILIA",66,10877,0,10943,"2024","033"
"44664","REGGIOLO",639,2858,0,3497,"2024","032"
"44665","REMEDELLO",7624,2869,0,10493,"2024","160"
"44666","RENATE",2,0,1,3,"2024",NA
"44667","RESANA",1917,30,14,1961,"2024","066"
"44668","REVELLO",7456,1770,227,9453,"2024","180"
"44669","REVIGLIASCO D'ASTI",225,0,0,225,"2024","090"
"44670","REVINE LAGO",15,0,0,15,"2024","067"
"44671","REZZATO",0,632,0,632,"2024","161"
"44672","RHO",4,408,14,426,"2024","182"
"44673","RIBORDONE",22,0,0,22,"2024","212"
"44674","RICENGO",22,3129,0,3151,"2024","079"
"44675","RIESE PIO X",7560,382,1,7943,"2024","068"
"44676","RIFREDDO",1298,6,56,1360,"2024","181"
"44677","RIMELLA",10,6,4,20,"2024","113"
"44678","RIMINI",49,101,0,150,"2024","014"
"44679","RIO SALICETO",930,350,0,1280,"2024","034"
"44680","RIOLO TERME",372,0,0,372,"2024","015"
"44681","RIOLUNATO",53,7,0,60,"2024","035"
"44682","RIPALTA ARPINA",0,518,0,518,"2024","080"
"44683","RIPALTA CREMASCA",5,549,0,554,"2024","081"
"44684","RIPALTA GUERINA",4,488,0,492,"2024","082"
"44685","RIVA DEL PO",1342,97,0,1439,"2024",NA
"44686","RIVA DI SOLTO",3,0,0,3,"2024","180"
"44687","RIVA PRESSO CHIERI",3642,144,168,3954,"2024","215"
"44688","RIVALBA",125,0,0,125,"2024","213"
"44689","RIVALTA DI TORINO",259,0,0,259,"2024","214"
"44690","RIVAMONTE AGORDINO",0,30,0,30,"2024","043"
"44691","RIVANAZZANO",79,0,0,79,"2024","122"
"44692","RIVARA",310,114,0,424,"2024","216"
"44693","RIVAROLO CANAVESE",1650,278,320,2248,"2024","217"
"44694","RIVAROLO DEL RE ED UNITI",3435,312,206,3953,"2024","083"
"44695","RIVAROLO MANTOVANO",50,1364,172,1586,"2024","050"
"44696","RIVAROSSA",16,145,0,161,"2024","218"
"44697","RIVERGARO",81,942,0,1023,"2024","038"
"44698","RIVOLI",1727,0,16,1743,"2024","219"
"44699","RIVOLI VERONESE",147,8,0,155,"2024","062"
"44700","RIVOLTA D'ADDA",2033,2177,98,4308,"2024","084"
"44701","ROANA",88,304,3,395,"2024","085"
"44702","ROASCIO",5,0,0,5,"2024","184"
"44703","ROASIO",17,0,0,17,"2024","116"
"44704","ROATTO",272,0,0,272,"2024","091"
"44705","ROBASSOMERO",104,86,37,227,"2024","220"
"44706","ROBBIO",1,164,0,165,"2024","123"
"44707","ROBECCHETTO CON INDUNO",413,192,0,605,"2024","183"
"44708","ROBECCO D'OGLIO",0,3334,0,3334,"2024","085"
"44709","ROBECCO PAVESE",5,0,0,5,"2024","124"
"44710","ROBECCO SUL NAVIGLIO",121,656,40,817,"2024","184"
"44711","ROBELLA",578,0,0,578,"2024","092"
"44712","ROBILANTE",342,0,0,342,"2024","185"
"44713","ROBURENT",63,0,0,63,"2024","186"
"44714","ROCCA CANAVESE",225,0,0,225,"2024","221"
"44715","ROCCA D'ARAZZO",278,0,0,278,"2024","093"
"44716","ROCCA DE' BALDI",4513,915,851,6279,"2024","189"
"44717","ROCCA GRIMALDA",21,0,0,21,"2024","147"
"44718","ROCCA PIETORE",1,13,0,14,"2024","044"
"44719","ROCCA SAN CASCIANO",171,0,0,171,"2024","036"
"44720","ROCCA SUSELLA",2,0,0,2,"2024",NA
"44721","ROCCABIANCA",0,1558,0,1558,"2024","030"
"44722","ROCCABRUNA",334,36,5,375,"2024","187"
"44723","ROCCAFORTE LIGURE",49,0,0,49,"2024","146"
"44724","ROCCAFORTE MONDOVI'",2081,0,8,2089,"2024","190"
"44725","ROCCAFRANCA",1658,1668,11,3337,"2024","162"
"44726","ROCCASPARVERA",471,0,0,471,"2024","191"
"44727","ROCCAVERANO",77,0,14,91,"2024","094"
"44728","ROCCAVIONE",64,0,0,64,"2024","192"
"44729","ROCCHETTA LIGURE",1,0,0,1,"2024","148"
"44730","ROCCHETTA PALAFEA",1,0,0,1,"2024","095"
"44731","ROCCHETTA TANARO",527,0,0,527,"2024","096"
"44732","RODANO",24,79,79,182,"2024","185"
"44733","RODDI",125,3,0,128,"2024","194"
"44734","RODDINO",87,0,0,87,"2024","195"
"44735","RODELLO",106,0,0,106,"2024","196"
"44736","RODENGO-SAIANO",16,216,28,260,"2024","163"
"44737","RODERO",2,0,2,4,"2024",NA
"44738","RODIGO",879,1575,1047,3501,"2024","051"
"44739","ROE' VOLCIANO",4,0,0,4,"2024","164"
"44740","ROGENO",20,250,15,285,"2024","072"
"44741","ROGNANO",28,0,0,28,"2024","127"
"44742","ROGNO",11,52,0,63,"2024","182"
"44743","ROGOLO",0,8,0,8,"2024","056"
"44744","ROLETTO",224,80,0,304,"2024","222"
"44745","ROLO",58,261,0,319,"2024","035"
"44746","ROMAGNANO SESIA",38,1,0,39,"2024","130"
"44747","ROMAGNESE",177,0,0,177,"2024","128"
"44748","ROMANENGO",6,1867,0,1873,"2024","086"
"44749","ROMANO CANAVESE",27,0,0,27,"2024","223"
"44750","ROMANO D'EZZELINO",189,488,0,677,"2024","086"
"44751","ROMANO DI LOMBARDIA",66,3806,0,3872,"2024","183"
"44752","ROMENTINO",28,0,0,28,"2024","131"
"44753","RONCA'",2,0,0,2,"2024","063"
"44754","RONCADE",2107,44,0,2151,"2024","069"
"44755","RONCADELLE",180,643,0,823,"2024","165"
"44756","RONCELLO",2,0,0,2,"2024",NA
"44757","RONCO ALL'ADIGE",5591,0,0,5591,"2024","064"
"44758","RONCO BIELLESE",32,24,0,56,"2024","053"
"44759","RONCO BRIANTINO",45,122,0,167,"2024",NA
"44760","RONCOFERRARO",2788,824,177,3789,"2024","052"
"44761","RONCOFREDDO",27,16,0,43,"2024","037"
"44762","RONCOLA",44,43,0,87,"2024","185"
"44763","RONSECCO",2,0,0,2,"2024",NA
"44764","ROPPOLO",12,0,0,12,"2024","054"
"44765","RORA'",59,0,0,59,"2024","226"
"44766","ROSA'",62,638,4,704,"2024","087"
"44767","ROSATE",3381,424,0,3805,"2024","188"
"44768","ROSIGNANO MONFERRATO",93,0,0,93,"2024","149"
"44769","ROSOLINA",1,0,0,1,"2024","040"
"44770","ROSSA",13,20,0,33,"2024","121"
"44771","ROSSANA",283,31,0,314,"2024","197"
"44772","ROSSANO VENETO",360,182,8,550,"2024","088"
"44773","ROSTA",17,0,64,81,"2024","228"
"44774","ROTA D'IMAGNA",9,40,0,49,"2024","186"
"44775","ROTTOFRENO",827,855,0,1682,"2024","039"
"44776","ROTZO",118,0,0,118,"2024","089"
"44777","ROURE",1,0,0,1,"2024","227"
"44778","ROVASENDA",15,0,0,15,"2024","122"
"44779","ROVATO",1692,2244,15,3951,"2024","166"
"44780","ROVELLASCA",0,70,0,70,"2024","201"
"44781","ROVERBELLA",15525,836,79,16440,"2024","053"
"44782","ROVERCHIARA",3923,0,107,4030,"2024","065"
"44783","ROVERE' VERONESE",209,1072,2,1283,"2024","067"
"44784","ROVEREDO DI GUA'",1433,29,19,1481,"2024","066"
"44785","ROVESCALA",16,0,0,16,"2024","131"
"44786","ROVETTA",49,119,0,168,"2024","187"
"44787","ROVIGO",1155,2,0,1157,"2024","041"
"44788","ROVOLON",232,10,6,248,"2024","071"
"44789","RUBANO",83,9,0,92,"2024","072"
"44790","RUBIANA",0,0,13,13,"2024","229"
"44791","RUBIERA",5,466,0,471,"2024","036"
"44792","RUDIANO",262,1137,0,1399,"2024","167"
"44793","RUEGLIO",188,0,6,194,"2024","230"
"44794","RUFFIA",494,166,223,883,"2024","198"
"44795","RUSSI",9,0,0,9,"2024","016"
"44796","SABBIO CHIESE",9,49,38,96,"2024","168"
"44797","SABBIONETA",4,10,0,14,"2024","054"
"44798","SACCOLONGO",46,448,0,494,"2024","073"
"44799","SAGLIANO MICCA",102,0,0,102,"2024","056"
"44800","SALA BAGANZA",4,102,0,106,"2024","031"
"44801","SALA BIELLESE",7,0,0,7,"2024","057"
"44802","SALA BOLOGNESE",386,0,0,386,"2024","050"
"44803","SALA COMACINA",7,0,0,7,"2024","203"
"44804","SALA MONFERRATO",74,0,0,74,"2024","150"
"44805","SALARA",2,0,0,2,"2024","042"
"44806","SALASSA",42,0,0,42,"2024","231"
"44807","SALBERTRAND",1,0,54,55,"2024","232"
"44808","SALCEDO",951,63,0,1014,"2024","090"
"44809","SALE",80,0,0,80,"2024","151"
"44810","SALE DELLE LANGHE",143,0,0,143,"2024","199"
"44811","SALE MARASINO",42,0,33,75,"2024","169"
"44812","SALE SAN GIOVANNI",90,0,0,90,"2024","200"
"44813","SALERANO CANAVESE",7,0,0,7,"2024",NA
"44814","SALERANO SUL LAMBRO",2,194,0,196,"2024","046"
"44815","SALGAREDA",1359,137,0,1496,"2024","070"
"44816","SALICETO",89,0,0,89,"2024","201"
"44817","SALIZZOLE",2497,366,59,2922,"2024","068"
"44818","SALMOUR",493,0,0,493,"2024","202"
"44819","SALO'",0,32,0,32,"2024","170"
"44820","SALSOMAGGIORE TERME",17,1088,0,1105,"2024","032"
"44821","SALTRIO",0,39,0,39,"2024","117"
"44822","SALUDECIO",115,0,0,115,"2024","015"
"44823","SALUGGIA",637,142,0,779,"2024","128"
"44824","SALUSSOLA",861,4,0,865,"2024","058"
"44825","SALUZZO",5762,3618,267,9647,"2024","203"
"44826","SALVIROLA",687,22,0,709,"2024","087"
"44827","SALZANO",373,28,0,401,"2024","032"
"44828","SAMARATE",4,0,0,4,"2024","118"
"44829","SAMBUCO",84,0,0,84,"2024","204"
"44830","SAMOLACO",249,728,71,1048,"2024","057"
"44831","SAMPEYRE",594,81,0,675,"2024","205"
"44832","SAN BARTOLOMEO VAL CAVARGNA",2,0,0,2,"2024","204"
"44833","SAN BASSANO",7,1769,0,1776,"2024","088"
"44834","SAN BELLINO",962,0,0,962,"2024","043"
"44835","SAN BENEDETTO BELBO",45,0,0,45,"2024","206"
"44836","SAN BENEDETTO PO",779,2433,235,3447,"2024","055"
"44837","SAN BENEDETTO VAL DI SAMBRO",377,50,41,468,"2024","051"
"44838","SAN BENIGNO CANAVESE",322,0,0,322,"2024","236"
"44839","SAN BERNARDINO VERBANO",13,0,0,13,"2024","061"
"44840","SAN BIAGIO DI CALLALTA",589,0,0,589,"2024","071"
"44841","SAN BONIFACIO",1683,0,0,1683,"2024","069"
"44842","SAN CARLO CANAVESE",290,129,127,546,"2024","237"
"44843","SAN CESARIO SUL PANARO",8,992,0,1000,"2024","036"
"44844","SAN CIPRIANO PO",0,259,0,259,"2024","133"
"44845","SAN CLEMENTE",15,0,0,15,"2024","016"
"44846","SAN COLOMBANO AL LAMBRO",29,245,0,274,"2024","191"
"44847","SAN COLOMBANO BELMONTE",8,12,0,20,"2024","238"
"44848","SAN CRISTOFORO",6,0,0,6,"2024","152"
"44849","SAN DAMIANO D'ASTI",4043,0,0,4043,"2024","097"
"44850","SAN DAMIANO MACRA",96,0,0,96,"2024","207"
"44851","SAN DANIELE PO",13,1407,0,1420,"2024","089"
"44852","SAN DIDERO",0,5,0,5,"2024","239"
"44853","SAN DONA' DI PIAVE",89,255,0,344,"2024","033"
"44854","SAN DONATO MILANESE",3,0,0,3,"2024","192"
"44855","SAN FELICE DEL BENACO",5,0,0,5,"2024","171"
"44856","SAN FELICE SUL PANARO",0,803,0,803,"2024","037"
"44857","SAN FERMO DELLA BATTAGLIA",21,0,57,78,"2024","206"
"44858","SAN FIOR",24,8,4,36,"2024","072"
"44859","SAN FIORANO",0,160,0,160,"2024","047"
"44860","SAN FRANCESCO AL CAMPO",1122,310,7,1439,"2024","240"
"44861","SAN GENESIO ED UNITI",2,461,0,463,"2024","135"
"44862","SAN GERMANO CHISONE",227,9,2,238,"2024","242"
"44863","SAN GERMANO VERCELLESE",6,0,0,6,"2024","131"
"44864","SAN GERVASIO BRESCIANO",1,287,0,288,"2024","172"
"44865","SAN GIACOMO DELLE SEGNATE",266,322,26,614,"2024","056"
"44866","SAN GIACOMO VERCELLESE",1927,0,0,1927,"2024","035"
"44867","SAN GILLIO",141,68,0,209,"2024","243"
"44868","SAN GIORGIO BIGARELLO",1329,358,0,1687,"2024",NA
"44869","SAN GIORGIO CANAVESE",478,15,0,493,"2024","244"
"44870","SAN GIORGIO DELLE PERTICHE",204,44,35,283,"2024","075"
"44871","SAN GIORGIO DI PIANO",7,0,0,7,"2024","052"
"44872","SAN GIORGIO IN BOSCO",316,566,0,882,"2024","076"
"44873","SAN GIORGIO MONFERRATO",23,0,0,23,"2024","153"
"44874","SAN GIORGIO PIACENTINO",769,957,0,1726,"2024","040"
"44875","SAN GIORGIO SCARAMPI",95,0,0,95,"2024","098"
"44876","SAN GIORIO DI SUSA",2,28,6,36,"2024","245"
"44877","SAN GIOVANNI BIANCO",84,17,0,101,"2024","188"
"44878","SAN GIOVANNI DEL DOSSO",0,307,64,371,"2024","058"
"44879","SAN GIOVANNI ILARIONE",775,0,0,775,"2024","070"
"44880","SAN GIOVANNI IN CROCE",0,481,2,483,"2024","090"
"44881","SAN GIOVANNI IN MARIGNANO",8,0,0,8,"2024","017"
"44882","SAN GIOVANNI IN PERSICETO",18,802,0,820,"2024","053"
"44883","SAN GIOVANNI LUPATOTO",767,61,0,828,"2024","071"
"44884","SAN GIULIANO MILANESE",68,515,89,672,"2024","195"
"44885","SAN GIUSTO CANAVESE",123,0,36,159,"2024","246"
"44886","SAN GREGORIO NELLE ALPI",2,64,2,68,"2024","045"
"44887","SAN LAZZARO DI SAVENA",1,0,0,1,"2024","054"
"44888","SAN LEO",412,117,0,529,"2024","025"
"44889","SAN MARTINO ALFIERI",5,0,0,5,"2024","099"
"44890","SAN MARTINO BUON ALBERGO",207,937,0,1144,"2024","073"
"44891","SAN MARTINO CANAVESE",114,0,0,114,"2024","247"
"44892","SAN MARTINO DALL'ARGINE",2,1388,14,1404,"2024","059"
"44893","SAN MARTINO DEL LAGO",13,0,0,13,"2024","091"
"44894","SAN MARTINO DI LUPARI",3316,406,0,3722,"2024","077"
"44895","SAN MARTINO IN RIO",0,960,0,960,"2024","037"
"44896","SAN MARTINO IN STRADA",4,804,0,808,"2024","048"
"44897","SAN MARTINO SICCOMARIO",3,0,0,3,"2024","137"
"44898","SAN MARZANO OLIVETO",93,0,0,93,"2024","100"
"44899","SAN MAURIZIO CANAVESE",409,281,118,808,"2024","248"
"44900","SAN MAURIZIO D'OPAGLIO",6,0,0,6,"2024","133"
"44901","SAN MAURO DI SALINE",93,336,9,438,"2024","074"
"44902","SAN MAURO TORINESE",6,0,0,6,"2024","249"
"44903","SAN MICHELE AL TAGLIAMENTO",2736,45,0,2781,"2024","034"
"44904","SAN MICHELE MONDOVI'",372,0,0,372,"2024","210"
"44905","SAN NAZZARO SESIA",198,0,0,198,"2024","134"
"44906","SAN NAZZARO VAL CAVARGNA",4,0,6,10,"2024","207"
"44907","SAN NICOLO' DI COMELICO",3,6,0,9,"2024","046"
"44908","SAN PAOLO",394,2450,14,2858,"2024","138"
"44909","SAN PAOLO D'ARGON",42,12,0,54,"2024","189"
"44910","SAN PAOLO SOLBRITO",77,0,0,77,"2024","101"
"44911","SAN PELLEGRINO TERME",77,16,0,93,"2024","190"
"44912","SAN PIETRO DI CADORE",3,69,0,72,"2024","047"
"44913","SAN PIETRO DI FELETTO",16,8,8,32,"2024","073"
"44914","SAN PIETRO DI MORUBIO",2,0,0,2,"2024","075"
"44915","SAN PIETRO IN CASALE",3,460,0,463,"2024","055"
"44916","SAN PIETRO IN CERRO",92,720,0,812,"2024","041"
"44917","SAN PIETRO IN GU",560,2853,69,3482,"2024","078"
"44918","SAN PIETRO MOSEZZO",1,0,0,1,"2024","135"
"44919","SAN PIETRO MUSSOLINO",20,0,0,20,"2024","094"
"44920","SAN PIETRO VAL LEMINA",12,0,0,12,"2024","250"
"44921","SAN PIETRO VIMINARIO",23,3,0,26,"2024","079"
"44922","SAN POLO D'ENZA",3,643,0,646,"2024","038"
"44923","SAN POLO DI PIAVE",904,46,0,950,"2024","074"
"44924","SAN PONSO",2,66,0,68,"2024","251"
"44925","SAN POSSIDONIO",0,520,0,520,"2024","038"
"44926","SAN PROSPERO",1,380,0,381,"2024","039"
"44927","SAN RAFFAELE CIMENA",73,0,0,73,"2024","252"
"44928","SAN ROCCO AL PORTO",167,611,0,778,"2024","049"
"44929","SAN SALVATORE MONFERRATO",239,0,0,239,"2024","154"
"44930","SAN SEBASTIANO DA PO",740,0,0,740,"2024","253"
"44931","SAN SECONDO DI PINEROLO",699,23,63,785,"2024","254"
"44932","SAN SECONDO PARMENSE",1,1185,0,1186,"2024","033"
"44933","SAN SIRO",6,0,5,11,"2024","248"
"44934","SAN STINO DI LIVENZA",3586,90,0,3676,"2024",NA
"44935","SAN VENDEMIANO",62,107,0,169,"2024","076"
"44936","SAN VITO DI CADORE",4,0,0,4,"2024","051"
"44937","SAN VITO DI LEGUZZANO",421,136,0,557,"2024","096"
"44938","SAN VITTORE OLONA",16,15,0,31,"2024","201"
"44939","SAN ZENO DI MONTAGNA",162,89,26,277,"2024","079"
"44940","SAN ZENO NAVIGLIO",0,411,0,411,"2024","173"
"44941","SAN ZENONE AL LAMBRO",0,945,0,945,"2024","202"
"44942","SAN ZENONE DEGLI EZZELINI",1706,486,4,2196,"2024","077"
"44943","SANDIGLIANO",144,99,10,253,"2024","059"
"44944","SANDRIGO",1120,1507,0,2627,"2024","091"
"44945","SANFRE'",935,0,0,935,"2024","208"
"44946","SANFRONT",2687,216,32,2935,"2024","209"
"44947","SANGANO",78,0,10,88,"2024","241"
"44948","SANGIANO",0,13,0,13,"2024","141"
"44949","SANGUINETTO",52,151,0,203,"2024","072"
"44950","SANNAZZARO DE' BURGONDI",7,18,0,25,"2024","138"
"44951","SANT'AGATA BOLOGNESE",0,607,0,607,"2024","056"
"44952","SANT'AGATA FELTRIA",430,55,0,485,"2024","026"
"44953","SANT'AGATA FOSSILI",61,0,0,61,"2024","156"
"44954","SANT'AGATA SUL SANTERNO",21,0,0,21,"2024","017"
"44955","SANT'ALBANO STURA",5385,901,221,6507,"2024","211"
"44956","SANT'ALESSIO CON VIALONE",0,164,0,164,"2024","141"
"44957","SANT'AMBROGIO DI TORINO",140,21,0,161,"2024","255"
"44958","SANT'AMBROGIO DI VALPOLICELLA",0,30,0,30,"2024","077"
"44959","SANT'ANGELO DI PIOVE DI SACCO",369,67,0,436,"2024","082"
"44960","SANT'ANGELO LODIGIANO",67,386,0,453,"2024","050"
"44961","SANT'ANGELO LOMELLINA",0,546,0,546,"2024","144"
"44962","SANT'ANNA D'ALFAEDO",148,1352,102,1602,"2024","078"
"44963","SANT'ANTONINO DI SUSA",13,73,29,115,"2024","256"
"44964","SANT'ELENA",36,0,0,36,"2024","083"
"44965","SANT'ILARIO D'ENZA",4,688,0,692,"2024","039"
"44966","SANT'OMOBONO TERME",144,41,1,186,"2024","192"
"44967","SANT'URBANO",483,0,0,483,"2024","084"
"44968","SANTA BRIGIDA",15,17,0,32,"2024","191"
"44969","SANTA CATERINA D'ESTE",1822,21,0,1843,"2024",NA
"44970","SANTA CRISTINA E BISSONE",6,141,0,147,"2024","139"
"44971","SANTA GIULETTA",18,0,0,18,"2024","140"
"44972","SANTA GIUSTINA",1216,104,0,1320,"2024","048"
"44973","SANTA GIUSTINA IN COLLE",1290,369,1,1660,"2024","080"
"44974","SANTA LUCIA DI PIAVE",20,50,9,79,"2024","075"
"44975","SANTA MARGHERITA DI STAFFORA",29,4,18,51,"2024","142"
"44976","SANTA MARIA DI SALA",78,138,8,224,"2024","035"
"44977","SANTA MARIA HOE'",6,0,0,6,"2024","074"
"44978","SANTA MARIA MAGGIORE",81,7,41,129,"2024","062"
"44979","SANTA SOFIA",518,0,2,520,"2024","043"
"44980","SANTA VITTORIA D'ALBA",75,0,0,75,"2024","212"
"44981","SANTARCANGELO DI ROMAGNA",24,0,0,24,"2024","018"
"44982","SANTENA",179,0,0,179,"2024","257"
"44983","SANTHIA'",479,14,0,493,"2024","133"
"44984","SANTO STEFANO BELBO",2,0,0,2,"2024","213"
"44985","SANTO STEFANO DI CADORE",0,15,1,16,"2024","050"
"44986","SANTO STEFANO LODIGIANO",203,338,0,541,"2024","051"
"44987","SANTO STEFANO ROERO",63,0,0,63,"2024","214"
"44988","SANTO STEFANO TICINO",10,16,0,26,"2024","200"
"44989","SANTORSO",454,119,0,573,"2024","095"
"44990","SAONARA",261,0,3,264,"2024","085"
"44991","SARCEDO",1521,293,0,1814,"2024","097"
"44992","SAREGO",457,25,0,482,"2024","098"
"44993","SAREZZO",27,28,0,55,"2024","174"
"44994","SARMATO",0,430,0,430,"2024","042"
"44995","SARMEDE",43,10,6,59,"2024","078"
"44996","SARNICO",9,0,0,9,"2024","193"
"44997","SARONNO",5,0,0,5,"2024","119"
"44998","SARSINA",226,0,0,226,"2024","044"
"44999","SASSO MARCONI",70,93,0,163,"2024","057"
"45000","SASSOFELTRIO",55,26,0,81,"2024",NA
"45001","SASSUOLO",22,607,0,629,"2024","040"
"45002","SAUZE D'OULX",0,0,47,47,"2024","259"
"45003","SAUZE DI CESANA",77,0,19,96,"2024","258"
"45004","SAVIGLIANO",13798,4660,259,18717,"2024","215"
"45005","SAVIGNANO SUL PANARO",25,48,0,73,"2024","041"
"45006","SAVIGNANO SUL RUBICONE",62,0,0,62,"2024","045"
"45007","SAVIORE DELL'ADAMELLO",21,23,2,46,"2024","175"
"45008","SCAGNELLO",333,0,50,383,"2024","216"
"45009","SCALDASOLE",4,0,0,4,"2024","147"
"45010","SCALENGHE",1781,2167,442,4390,"2024","260"
"45011","SCANDIANO",31,1055,0,1086,"2024","040"
"45012","SCANDOLARA RAVARA",0,881,0,881,"2024","092"
"45013","SCANDOLARA RIPA D'OGLIO",44,830,197,1071,"2024","093"
"45014","SCANZOROSCIATE",52,0,0,52,"2024","194"
"45015","SCARMAGNO",10,18,0,28,"2024","261"
"45016","SCARNAFIGI",2929,1608,0,4537,"2024","217"
"45017","SCHIAVON",1666,1893,0,3559,"2024","099"
"45018","SCHIGNANO",17,18,5,40,"2024","211"
"45019","SCHILPARIO",12,44,0,56,"2024","195"
"45020","SCHIO",433,232,7,672,"2024","100"
"45021","SCIOLZE",147,0,0,147,"2024","262"
"45022","SCOPELLO",53,10,0,63,"2024","135"
"45023","SCORZE'",4032,0,0,4032,"2024","037"
"45024","SECUGNAGO",0,1346,0,1346,"2024","052"
"45025","SEDICO",1349,63,0,1412,"2024","053"
"45026","SEDRIANO",13,815,0,828,"2024","204"
"45027","SEDRINA",32,15,0,47,"2024","196"
"45028","SEGRATE",12,0,0,12,"2024","205"
"45029","SEGUSINO",9,45,5,59,"2024","079"
"45030","SELLERO",16,20,2,38,"2024","176"
"45031","SELVA DI CADORE",2,0,0,2,"2024","054"
"45032","SELVA DI PROGNO",72,403,39,514,"2024","080"
"45033","SELVAZZANO DENTRO",7,0,16,23,"2024","086"
"45034","SELVINO",3,0,0,3,"2024","197"
"45035","SENIGA",1845,1779,14,3638,"2024","177"
"45036","SENNA COMASCO",56,0,4,60,"2024","212"
"45037","SENNA LODIGIANA",0,869,0,869,"2024","053"
"45038","SEREGNO",6,0,0,6,"2024",NA
"45039","SEREN DEL GRAPPA",65,164,44,273,"2024","055"
"45040","SERGNANO",19,1394,0,1413,"2024","094"
"45041","SERIATE",119,79,0,198,"2024","198"
"45042","SERINA",30,106,0,136,"2024","199"
"45043","SERLE",23,63,16,102,"2024","178"
"45044","SERMIDE E FELONICA",0,403,0,403,"2024",NA
"45045","SERNAGLIA DELLA BATTAGLIA",849,0,3,852,"2024","080"
"45046","SERNIO",2,0,0,2,"2024","059"
"45047","SEROLE",81,0,3,84,"2024","104"
"45048","SERRALUNGA D'ALBA",14,0,0,14,"2024","218"
"45049","SERRALUNGA DI CREA",46,0,1,47,"2024","159"
"45050","SERRAMAZZONI",38,1362,0,1400,"2024","042"
"45051","SERRAVALLE A PO",35,0,38,73,"2024","062"
"45052","SERRAVALLE LANGHE",125,0,0,125,"2024","219"
"45053","SERRAVALLE SCRIVIA",33,0,0,33,"2024","160"
"45054","SERRAVALLE SESIA",8,0,0,8,"2024","137"
"45055","SESTO CALENDE",55,0,0,55,"2024","120"
"45056","SESTO ED UNITI",3,2401,0,2404,"2024","095"
"45057","SESTOLA",119,295,0,414,"2024","043"
"45058","SETTALA",56,382,0,438,"2024","210"
"45059","SETTEVILLE",387,136,9,532,"2024",NA
"45060","SETTIME",100,0,0,100,"2024","106"
"45061","SETTIMO MILANESE",22,338,0,360,"2024","211"
"45062","SETTIMO ROTTARO",65,0,0,65,"2024","264"
"45063","SETTIMO TORINESE",503,376,58,937,"2024","265"
"45064","SETTIMO VITTONE",309,107,34,450,"2024","266"
"45065","SEZZADIO",86,0,0,86,"2024","161"
"45066","SILEA",7,76,0,83,"2024","081"
"45067","SILLAVENGO",72,0,118,190,"2024","138"
"45068","SILVANO D'ORBA",2,0,0,2,"2024","162"
"45069","SILVANO PIETRA",2,0,0,2,"2024",NA
"45070","SINIO",9,3,0,12,"2024","220"
"45071","SIRONE",6,153,0,159,"2024","075"
"45072","SIRTORI",2,0,0,2,"2024","076"
"45073","SISSA TRECASALI",7,704,0,711,"2024",NA
"45074","SIZIANO",30,74,0,104,"2024","150"
"45075","SIZZANO",148,0,45,193,"2024","139"
"45076","SOAVE",8,0,0,8,"2024","081"
"45077","SOGLIANO AL RUBICONE",317,20,0,337,"2024","046"
"45078","SOIANO DEL LAGO",1,0,5,6,"2024","180"
"45079","SOLAGNA",0,18,0,18,"2024","101"
"45080","SOLARO",59,0,0,59,"2024","213"
"45081","SOLAROLO RAINERIO",0,260,0,260,"2024","096"
"45082","SOLBIATE CON CAGNO",24,126,1,151,"2024",NA
"45083","SOLERO",213,0,0,213,"2024","163"
"45084","SOLESINO",4,0,0,4,"2024","087"
"45085","SOLFERINO",669,360,0,1029,"2024","063"
"45086","SOLIERA",26,1085,0,1111,"2024","044"
"45087","SOLIGNANO",80,233,0,313,"2024","035"
"45088","SOLONGHELLO",65,0,0,65,"2024","164"
"45089","SOLTO COLLINA",35,0,0,35,"2024","200"
"45090","SOMAGLIA",0,1208,0,1208,"2024","054"
"45091","SOMANO",42,0,0,42,"2024","221"
"45092","SOMMA LOMBARDO",27,11,8,46,"2024","123"
"45093","SOMMACAMPAGNA",1523,365,55,1943,"2024","082"
"45094","SOMMARIVA DEL BOSCO",2096,569,147,2812,"2024","222"
"45095","SOMMARIVA PERNO",12,0,0,12,"2024","223"
"45096","SONA",2372,400,13,2785,"2024","083"
"45097","SONCINO",736,5179,224,6139,"2024","097"
"45098","SONDALO",20,64,9,93,"2024","060"
"45099","SONDRIO",51,34,0,85,"2024","061"
"45100","SONGAVAZZO",1,0,0,1,"2024","201"
"45101","SONICO",4,74,11,89,"2024","181"
"45102","SORAGNA",8,1459,0,1467,"2024","036"
"45103","SORBOLO MEZZANI",2,2205,0,2207,"2024",NA
"45104","SORDEVOLO",201,14,0,215,"2024","063"
"45105","SORDIO",0,214,0,214,"2024","055"
"45106","SORESINA",61,1375,254,1690,"2024","098"
"45107","SORGA'",1599,26,0,1625,"2024","084"
"45108","SORICO",17,14,67,98,"2024","216"
"45109","SORISO",19,0,0,19,"2024","140"
"45110","SORISOLE",89,72,0,161,"2024","202"
"45111","SORMANO",12,0,0,12,"2024","217"
"45112","SOSPIRO",55,219,1,275,"2024","099"
"45113","SOSPIROLO",4,67,0,71,"2024","056"
"45114","SOSSANO",1,318,0,319,"2024","102"
"45115","SOSTEGNO",2,16,0,18,"2024","064"
"45116","SOTTO IL MONTE GIOVANNI XXIII",402,0,0,402,"2024","203"
"45117","SOVERE",32,55,0,87,"2024","204"
"45118","SOVERZENE",2,0,0,2,"2024","057"
"45119","SOVIZZO",295,126,10,431,"2024","103"
"45120","SOVRAMONTE",0,77,0,77,"2024","058"
"45121","SOZZAGO",3,0,0,3,"2024","141"
"45122","SPARONE",57,47,0,104,"2024","267"
"45123","SPESSA",16,0,0,16,"2024","152"
"45124","SPIGNO MONFERRATO",147,0,50,197,"2024","165"
"45125","SPILAMBERTO",1317,1342,0,2659,"2024","045"
"45126","SPINADESCO",0,1,0,1,"2024","100"
"45127","SPINEA",3,106,2,111,"2024","038"
"45128","SPINEDA",6,714,0,720,"2024","101"
"45129","SPINETO SCRIVIA",163,0,0,163,"2024","166"
"45130","SPINO D'ADDA",534,1475,231,2240,"2024","102"
"45131","SPINONE AL LAGO",6,0,0,6,"2024","205"
"45132","SPIRANO",3,957,0,960,"2024","206"
"45133","SPRESIANO",17,288,0,305,"2024","082"
"45134","STAGNO LOMBARDO",6,6542,0,6548,"2024","103"
"45135","STANGHELLA",357,0,0,357,"2024","088"
"45136","STAZZANO",5,0,0,5,"2024","167"
"45137","STAZZONA",2,4,2,8,"2024","218"
"45138","STEZZANO",304,396,0,700,"2024","207"
"45139","STIENTA",66,0,0,66,"2024","045"
"45140","STRA",18,0,0,18,"2024","039"
"45141","STRADELLA",7,26,0,33,"2024","153"
"45142","STRAMBINELLO",79,0,0,79,"2024",NA
"45143","STRAMBINO",339,0,0,339,"2024","269"
"45144","STRESA",151,0,0,151,"2024","064"
"45145","STREVI",26,0,0,26,"2024","168"
"45146","STRONA",1,0,0,1,"2024","065"
"45147","STROPPO",29,0,0,29,"2024","224"
"45148","STROZZA",8,0,0,8,"2024","208"
"45149","SUARDI",2,0,0,2,"2024","154"
"45150","SUEGLIO",0,0,2,2,"2024","077"
"45151","SUELLO",2,0,6,8,"2024","078"
"45152","SUISIO",0,97,0,97,"2024","209"
"45153","SULBIATE",54,0,0,54,"2024",NA
"45154","SULZANO",49,223,2,274,"2024","182"
"45155","SUMIRAGO",56,62,0,118,"2024","124"
"45156","SUNO",12,331,0,343,"2024","143"
"45157","SUSA",321,0,25,346,"2024","270"
"45158","SUSEGANA",823,49,0,872,"2024","083"
"45159","SUSTINENTE",755,833,16,1604,"2024","064"
"45160","SUZZARA",3164,1867,56,5087,"2024","065"
"45161","TACENO",5,0,20,25,"2024","079"
"45162","TAGLIO DI PO",7858,0,0,7858,"2024","046"
"45163","TAGLIOLO MONFERRATO",112,0,0,112,"2024","169"
"45164","TAIBON AGORDINO",0,24,0,24,"2024","059"
"45165","TAINO",50,122,0,172,"2024","125"
"45166","TALAMONA",41,113,2,156,"2024","063"
"45167","TALEGGIO",160,22,0,182,"2024","210"
"45168","TAMBRE",11,126,0,137,"2024","060"
"45169","TARANTASCA",3207,830,0,4037,"2024","225"
"45170","TARTANO",67,14,0,81,"2024","064"
"45171","TARZO",31,0,0,31,"2024","084"
"45172","TAVAGNASCO",223,14,0,237,"2024","271"
"45173","TAVAZZANO CON VILLAVESCO",0,1097,0,1097,"2024","056"
"45174","TAVERNOLA BERGAMASCA",2,0,0,2,"2024","211"
"45175","TAVERNOLE SUL MELLA",15,40,10,65,"2024","183"
"45176","TAVIGLIANO",7,0,3,10,"2024","066"
"45177","TEGLIO",108,213,17,338,"2024","065"
"45178","TELGATE",2092,152,0,2244,"2024","212"
"45179","TEMU'",51,5,0,56,"2024","184"
"45180","TEOLO",23,27,0,50,"2024","089"
"45181","TERDOBBIATE",0,142,0,142,"2024","144"
"45182","TERENZO",48,870,0,918,"2024","038"
"45183","TERNO D'ISOLA",6,0,0,6,"2024","213"
"45184","TERRANOVA DEI PASSERINI",69,313,0,382,"2024","057"
"45185","TERRASSA PADOVANA",1556,0,0,1556,"2024","090"
"45186","TERRAZZO",26,0,0,26,"2024","085"
"45187","TERRE DEL RENO",1,0,0,1,"2024",NA
"45188","TERRUGGIA",52,0,0,52,"2024","171"
"45189","TERZO",2,0,0,2,"2024","172"
"45190","TEZZE SUL BRENTA",72,235,0,307,"2024","104"
"45191","THIENE",404,239,0,643,"2024","105"
"45192","TICENGO",1,431,83,515,"2024","104"
"45193","TIGLIOLE",830,0,0,830,"2024","108"
"45194","TIGNALE",0,6,6,12,"2024","185"
"45195","TIRANO",2,10,1,13,"2024","066"
"45196","TIZZANO VAL PARMA",10,750,0,760,"2024","039"
"45197","TOANO",49,1808,0,1857,"2024","041"
"45198","TOCENO",68,10,23,101,"2024","065"
"45199","TOLLEGNO",4,0,40,44,"2024","068"
"45200","TOMBOLO",468,20,0,488,"2024","091"
"45201","TONCO",831,0,0,831,"2024","109"
"45202","TONEZZA DEL CIMONE",2,0,0,2,"2024","106"
"45203","TORBOLE CASAGLIA",29,814,52,895,"2024","186"
"45204","TORINO",267,0,2,269,"2024","272"
"45205","TORLINO VIMERCATI",0,284,0,284,"2024","105"
"45206","TORNACO",0,151,0,151,"2024",NA
"45207","TORNATA",2,157,0,159,"2024","106"
"45208","TORNO",1,0,0,1,"2024","223"
"45209","TORNOLO",122,2,0,124,"2024","040"
"45210","TORRAZZA COSTE",12,0,0,12,"2024","155"
"45211","TORRAZZA PIEMONTE",315,0,0,315,"2024","273"
"45212","TORRAZZO",10,0,16,26,"2024","069"
"45213","TORRE BERETTI E CASTELLARO",25,397,0,422,"2024","156"
"45214","TORRE BOLDONE",2,0,0,2,"2024","214"
"45215","TORRE BORMIDA",16,0,0,16,"2024","226"
"45216","TORRE D'ISOLA",0,1006,0,1006,"2024","159"
"45217","TORRE DE' BUSI",13,0,0,13,"2024","080"
"45218","TORRE DE' NEGRI",23,0,252,275,"2024","158"
"45219","TORRE DE' PICENARDI",75,2732,0,2807,"2024","107"
"45220","TORRE DE' ROVERI",14,0,0,14,"2024","216"
"45221","TORRE DI MOSTO",11,639,0,650,"2024","041"
"45222","TORRE DI SANTA MARIA",25,7,8,40,"2024","067"
"45223","TORRE MONDOVI'",1,0,0,1,"2024","227"
"45224","TORRE PALLAVICINA",218,367,0,585,"2024","217"
"45225","TORRE PELLICE",132,0,32,164,"2024","275"
"45226","TORRE SAN GIORGIO",108,4,2,114,"2024","228"
"45227","TORREBELVICINO",835,10,0,845,"2024","107"
"45228","TORREGLIA",4,0,0,4,"2024","092"
"45229","TORRESINA",2,0,0,2,"2024","229"
"45230","TORREVECCHIA PIA",83,11,10,104,"2024","160"
"45231","TORRI DI QUARTESOLO",37,112,0,149,"2024","108"
"45232","TORRICELLA VERZATE",1,0,0,1,"2024",NA
"45233","TORRILE",0,2423,0,2423,"2024","041"
"45234","TORTONA",2463,22,0,2485,"2024","174"
"45235","TOSCOLANO-MADERNO",5,0,5,10,"2024","187"
"45236","TOVO DI SANT'AGATA",9,63,1,73,"2024","068"
"45237","TRADATE",29,17,0,46,"2024","127"
"45238","TRANA",147,8,5,160,"2024","276"
"45239","TRAONA",153,207,0,360,"2024","069"
"45240","TRAREGO VIGGIONA",11,0,0,11,"2024","066"
"45241","TRASQUERA",41,0,7,48,"2024","067"
"45242","TRAVAGLIATO",242,416,0,658,"2024","188"
"45243","TRAVEDONA-MONATE",9,0,1,10,"2024","128"
"45244","TRAVERSELLA",60,13,19,92,"2024","278"
"45245","TRAVERSETOLO",81,1012,0,1093,"2024","042"
"45246","TRAVES",42,0,0,42,"2024","279"
"45247","TRAVO",78,29,0,107,"2024","043"
"45248","TREBASELEGHE",7094,92,1,7187,"2024","093"
"45249","TRECATE",0,130,0,130,"2024","149"
"45250","TRECENTA",0,99,37,136,"2024","047"
"45251","TREDOZIO",194,0,0,194,"2024","049"
"45252","TREGNAGO",566,105,0,671,"2024","087"
"45253","TREMEZZINA",35,27,21,83,"2024",NA
"45254","TREMOSINE",25,444,6,475,"2024","189"
"45255","TRENZANO",989,1379,25,2393,"2024","190"
"45256","TRESCORE BALNEARIO",39,64,0,103,"2024","218"
"45257","TRESCORE CREMASCO",12,873,0,885,"2024","109"
"45258","TRESIGNANA",2,0,0,2,"2024",NA
"45259","TRESIVIO",13,12,0,25,"2024","070"
"45260","TREVENZUOLO",572,1124,0,1696,"2024","088"
"45261","TREVIGLIO",1007,1617,0,2624,"2024","219"
"45262","TREVIGNANO",1640,383,0,2023,"2024","085"
"45263","TREVILLE",8,0,0,8,"2024","175"
"45264","TREVIOLO",107,56,0,163,"2024","220"
"45265","TREVISO",453,86,1,540,"2024","086"
"45266","TREVISO BRESCIANO",13,30,12,55,"2024","191"
"45267","TREZZO SULL'ADDA",5,335,0,340,"2024","221"
"45268","TREZZO TINELLA",10,0,0,10,"2024","231"
"45269","TREZZONE",1,0,3,4,"2024","226"
"45270","TRIBIANO",0,60,0,60,"2024","222"
"45271","TRIGOLO",0,1012,0,1012,"2024","110"
"45272","TRINITA'",4143,518,189,4850,"2024","232"
"45273","TRINO",24,176,0,200,"2024","148"
"45274","TRISOBBIO",150,0,0,150,"2024","176"
"45275","TRISSINO",65,206,48,319,"2024","110"
"45276","TRIUGGIO",2,208,12,222,"2024",NA
"45277","TROFARELLO",643,49,0,692,"2024","280"
"45278","TROMELLO",15,504,160,679,"2024","164"
"45279","TRONTANO",17,7,0,24,"2024","068"
"45280","TRONZANO VERCELLESE",290,0,0,290,"2024","150"
"45281","TROVO",0,28,0,28,"2024","165"
"45282","TRUCCAZZANO",105,1423,0,1528,"2024","224"
"45283","TURANO LODIGIANO",50,2034,0,2084,"2024","058"
"45284","TURATE",1,0,0,1,"2024","227"
"45285","TURBIGO",1,0,24,25,"2024","226"
"45286","UBIALE CLANEZZO",3,0,0,3,"2024","221"
"45287","UBOLDO",2,0,0,2,"2024","130"
"45288","UGGIATE CON RONAGO",40,76,7,123,"2024",NA
"45289","URAGO D'OGLIO",319,1185,0,1504,"2024","192"
"45290","URBANA",777,0,0,777,"2024","095"
"45291","URGNANO",240,195,0,435,"2024","222"
"45292","USMATE VELATE",6,22,3,31,"2024",NA
"45293","USSEAUX",81,15,32,128,"2024","281"
"45294","USSEGLIO",5,0,0,5,"2024","282"
"45295","VAIANO CREMASCO",247,430,38,715,"2024","111"
"45296","VAIE",45,49,0,94,"2024","283"
"45297","VAILATE",57,308,9,374,"2024","112"
"45298","VAL BREMBILLA",104,43,0,147,"2024",NA
"45299","VAL DELLA TORRE",438,0,23,461,"2024","284"
"45300","VAL DI CHY",53,9,0,62,"2024",NA
"45301","VAL DI ZOLDO",7,0,0,7,"2024",NA
"45302","VAL LIONA",444,130,0,574,"2024",NA
"45303","VAL MASINO",2,36,0,38,"2024","074"
"45304","VAL REZZO",23,0,8,31,"2024","233"
"45305","VALBONDIONE",2,6,0,8,"2024","223"
"45306","VALBREMBO",18,31,0,49,"2024","224"
"45307","VALBRENTA",44,26,1,71,"2024",NA
"45308","VALBRONA",8,0,2,10,"2024","229"
"45309","VALCHIUSA",285,77,41,403,"2024",NA
"45310","VALDAGNO",35,137,8,180,"2024","111"
"45311","VALDASTICO",957,14,0,971,"2024","112"
"45312","VALDENGO",128,0,0,128,"2024","071"
"45313","VALDIDENTRO",74,91,30,195,"2024","071"
"45314","VALDIERI",5,0,21,26,"2024","233"
"45315","VALDILANA",208,37,32,277,"2024",NA
"45316","VALDISOTTO",56,144,13,213,"2024","072"
"45317","VALDOBBIADENE",52,315,4,371,"2024","087"
"45318","VALEGGIO",91,0,0,91,"2024","167"
"45319","VALEGGIO SUL MINCIO",1786,2162,48,3996,"2024","089"
"45320","VALENZA",120,0,0,120,"2024","177"
"45321","VALERA FRATTA",299,326,0,625,"2024","059"
"45322","VALFENERA",1077,99,264,1440,"2024","112"
"45323","VALFURVA",38,105,1,144,"2024","073"
"45324","VALGANNA",31,0,0,31,"2024","131"
"45325","VALGIOIE",4,0,0,4,"2024",NA
"45326","VALGOGLIO",28,29,2,59,"2024","225"
"45327","VALGRANA",452,0,0,452,"2024","234"
"45328","VALGREGHENTINO",4,0,0,4,"2024","082"
"45329","VALLADA AGORDINA",0,5,0,5,"2024","062"
"45330","VALLE CANNOBINA",5,0,0,5,"2024",NA
"45331","VALLE LOMELLINA",50,777,0,827,"2024","168"
"45332","VALLE SAN NICOLAO",13,0,0,13,"2024","074"
"45333","VALLEVE",0,11,0,11,"2024","226"
"45334","VALLI DEL PASUBIO",1,5,0,6,"2024","113"
"45335","VALLIO TERME",3,0,1,4,"2024","193"
"45336","VALLO TORINESE",43,0,0,43,"2024","286"
"45337","VALMADRERA",18,0,13,31,"2024","083"
"45338","VALMOREA",1,34,0,35,"2024","232"
"45339","VALMOZZOLA",97,10,0,107,"2024","044"
"45340","VALPERGA",229,118,79,426,"2024","287"
"45341","VALSAMOGGIA",301,810,0,1111,"2024",NA
"45342","VALSOLDA",11,8,3,22,"2024","234"
"45343","VALSTRONA",21,0,0,21,"2024","069"
"45344","VALTORTA",2,31,0,33,"2024","229"
"45345","VALVESTINO",2,27,0,29,"2024","194"
"45346","VANZAGO",40,0,0,40,"2024","229"
"45347","VAPRIO D'ADDA",10,421,0,431,"2024","230"
"45348","VARALLO",21,36,0,57,"2024","156"
"45349","VARALLO POMBIA",1,0,0,1,"2024","154"
"45350","VARANO DE' MELEGARI",37,289,0,326,"2024","045"
"45351","VAREDO",1,0,0,1,"2024",NA
"45352","VARENNA",1,0,0,1,"2024",NA
"45353","VARESE",94,14,0,108,"2024","133"
"45354","VARISELLA",345,0,0,345,"2024","289"
"45355","VARSI",21,391,0,412,"2024","046"
"45356","VARZI",171,11,0,182,"2024","171"
"45357","VARZO",73,5,0,78,"2024","071"
"45358","VAUDA CANAVESE",47,0,0,47,"2024","290"
"45359","VAZZOLA",1279,41,0,1320,"2024","088"
"45360","VEDANO OLONA",1,207,0,208,"2024","134"
"45361","VEDELAGO",22024,699,388,23111,"2024","089"
"45362","VEDESETA",13,144,0,157,"2024","230"
"45363","VEGGIANO",449,57,0,506,"2024","096"
"45364","VEGLIO",2,0,0,2,"2024","075"
"45365","VELESO",0,0,6,6,"2024","236"
"45366","VELEZZO LOMELLINA",3,0,0,3,"2024","172"
"45367","VELLEZZO BELLINI",14,329,3,346,"2024","173"
"45368","VELO D'ASTICO",808,20,0,828,"2024","115"
"45369","VELO VERONESE",424,1515,7,1946,"2024","090"
"45370","VENARIA REALE",213,187,0,400,"2024","292"
"45371","VENASCA",125,0,0,125,"2024","237"
"45372","VENAUS",11,1,65,77,"2024","291"
"45373","VENEGONO INFERIORE",0,58,0,58,"2024","136"
"45374","VENEGONO SUPERIORE",3,0,0,3,"2024","137"
"45375","VENEZIA",1604,112,0,1716,"2024","042"
"45376","VENIANO",55,94,0,149,"2024","238"
"45377","VENTASSO",92,442,0,534,"2024",NA
"45378","VERBANIA",73,0,2,75,"2024","072"
"45379","VERCANA",6,6,0,12,"2024","239"
"45380","VERCEIA",13,0,3,16,"2024","075"
"45381","VERCELLI",78,273,0,351,"2024","158"
"45382","VERDELLINO",0,38,0,38,"2024","232"
"45383","VERDELLO",248,94,0,342,"2024","233"
"45384","VERDERIO",132,0,0,132,"2024",NA
"45385","VERGATO",39,0,0,39,"2024","059"
"45386","VERGHERETO",1239,0,0,1239,"2024","050"
"45387","VERGIATE",32,0,0,32,"2024","138"
"45388","VERMEZZO CON ZELO",27,422,0,449,"2024",NA
"45389","VERNANTE",276,0,56,332,"2024","239"
"45390","VERNASCA",63,89,0,152,"2024","044"
"45391","VERNATE",0,65,0,65,"2024","236"
"45392","VEROLANUOVA",799,1944,4,2747,"2024","195"
"45393","VEROLAVECCHIA",4,3584,0,3588,"2024","196"
"45394","VEROLENGO",1232,43,0,1275,"2024","293"
"45395","VERONA",3058,692,0,3750,"2024","091"
"45396","VERONELLA",4498,201,0,4699,"2024","092"
"45397","VERRETTO",5,0,0,5,"2024","174"
"45398","VERRONE",79,0,0,79,"2024","076"
"45399","VERRUA SAVOIA",456,0,0,456,"2024","294"
"45400","VERTEMATE CON MINOPRIO",7,0,0,7,"2024","242"
"45401","VERTOVA",27,25,2,54,"2024","234"
"45402","VERUCCHIO",201,0,0,201,"2024","020"
"45403","VERVIO",32,49,1,82,"2024","076"
"45404","VERZUOLO",2,0,0,2,"2024","240"
"45405","VESCOVATO",3811,1483,0,5294,"2024","113"
"45406","VESIME",421,0,0,421,"2024","113"
"45407","VESPOLATE",0,151,0,151,"2024","158"
"45408","VESTENANOVA",428,193,0,621,"2024","093"
"45409","VESTIGNE'",13,70,0,83,"2024","295"
"45410","VESTONE",13,0,0,13,"2024","197"
"45411","VETTO",23,332,0,355,"2024","042"
"45412","VEZZA D'ALBA",2,0,0,2,"2024","241"
"45413","VEZZA D'OGLIO",5,92,20,117,"2024","198"
"45414","VEZZANO SUL CROSTOLO",14,113,0,127,"2024","043"
"45415","VIADANA",284,1324,4,1612,"2024","066"
"45416","VIADANICA",6,28,0,34,"2024","235"
"45417","VIALE",284,0,0,284,"2024","114"
"45418","VIALFRE'",25,0,1,26,"2024","296"
"45419","VIANO",3,682,0,685,"2024","044"
"45420","VIARIGI",38,0,0,38,"2024","115"
"45421","VICENZA",109,797,10,916,"2024","116"
"45422","VICOFORTE",804,0,0,804,"2024","242"
"45423","VIDIGULFO",11,171,0,182,"2024","176"
"45424","VIDOR",10,434,0,444,"2024","090"
"45425","VIDRACCO",7,0,0,7,"2024","298"
"45426","VIGANO SAN MARTINO",9,0,0,9,"2024","236"
"45427","VIGASIO",632,775,0,1407,"2024","094"
"45428","VIGEVANO",103,0,5,108,"2024","177"
"45429","VIGGIU'",51,0,0,51,"2024","139"
"45430","VIGLIANO BIELLESE",1,0,0,1,"2024","077"
"45431","VIGLIANO D'ASTI",59,0,0,59,"2024","116"
"45432","VIGNALE MONFERRATO",208,0,0,208,"2024","179"
"45433","VIGNATE",0,293,0,293,"2024","237"
"45434","VIGNOLA",1,90,0,91,"2024","046"
"45435","VIGNOLO",1353,0,0,1353,"2024","243"
"45436","VIGNONE",2,0,0,2,"2024","074"
"45437","VIGO DI CADORE",0,11,0,11,"2024","065"
"45438","VIGODARZERE",108,41,0,149,"2024","099"
"45439","VIGOLO",10,214,0,224,"2024","237"
"45440","VIGOLZONE",83,607,0,690,"2024","045"
"45441","VIGONE",3331,1048,269,4648,"2024","299"
"45442","VIGONOVO",2,0,0,2,"2024","043"
"45443","VIGONZA",55,930,0,985,"2024","100"
"45444","VILLA BARTOLOMEA",251,0,0,251,"2024","095"
"45445","VILLA CARCINA",3,0,0,3,"2024","199"
"45446","VILLA D'ADDA",9,0,0,9,"2024","238"
"45447","VILLA D'ALME'",174,8,0,182,"2024","239"
"45448","VILLA D'OGNA",0,28,0,28,"2024","241"
"45449","VILLA DEL CONTE",914,558,0,1472,"2024","101"
"45450","VILLA DI CHIAVENNA",1,20,3,24,"2024","077"
"45451","VILLA DI SERIO",18,0,0,18,"2024","240"
"45452","VILLA DI TIRANO",26,130,23,179,"2024","078"
"45453","VILLA ESTENSE",26,55,0,81,"2024","102"
"45454","VILLA GUARDIA",112,0,24,136,"2024","245"
"45455","VILLA MINOZZO",30,667,0,697,"2024","045"
"45456","VILLA SAN SECONDO",4,0,0,4,"2024","119"
"45457","VILLACHIARA",326,3319,6,3651,"2024","200"
"45458","VILLADEATI",28,0,0,28,"2024","182"
"45459","VILLADOSE",2,0,75,77,"2024","048"
"45460","VILLADOSSOLA",14,0,0,14,"2024","075"
"45461","VILLAFALLETTO",2744,786,284,3814,"2024","244"
"45462","VILLAFRANCA D'ASTI",366,0,0,366,"2024","117"
"45463","VILLAFRANCA DI VERONA",7937,3159,170,11266,"2024","096"
"45464","VILLAFRANCA PADOVANA",755,2455,23,3233,"2024","103"
"45465","VILLAFRANCA PIEMONTE",4291,2540,272,7103,"2024","300"
"45466","VILLAGA",63,206,0,269,"2024","117"
"45467","VILLAMARZANA",933,60,0,993,"2024","049"
"45468","VILLANOVA BIELLESE",577,0,0,577,"2024","079"
"45469","VILLANOVA CANAVESE",50,0,2,52,"2024","301"
"45470","VILLANOVA D'ARDENGHI",2,0,0,2,"2024","179"
"45471","VILLANOVA D'ASTI",4769,61,0,4830,"2024","118"
"45472","VILLANOVA DEL GHEBBO",9,0,0,9,"2024","050"
"45473","VILLANOVA DEL SILLARO",0,1081,0,1081,"2024","060"
"45474","VILLANOVA DI CAMPOSAMPIERO",22,4,0,26,"2024","104"
"45475","VILLANOVA MARCHESANA",0,86,0,86,"2024","051"
"45476","VILLANOVA MONDOVI'",3069,511,145,3725,"2024","245"
"45477","VILLANOVA MONFERRATO",0,0,1,1,"2024","185"
"45478","VILLANOVA SOLARO",403,616,0,1019,"2024","246"
"45479","VILLANOVA SULL'ARDA",4,1500,0,1504,"2024","046"
"45480","VILLANTERIO",3,0,214,217,"2024","180"
"45481","VILLANUOVA SUL CLISI",6,0,0,6,"2024","201"
"45482","VILLAR DORA",189,0,24,213,"2024","303"
"45483","VILLAR FOCCHIARDO",134,30,31,195,"2024","305"
"45484","VILLAR PELLICE",510,48,26,584,"2024","306"
"45485","VILLAR PEROSA",14,28,0,42,"2024","307"
"45486","VILLAR SAN COSTANZO",741,216,4,961,"2024","247"
"45487","VILLARBASSE",391,11,1,403,"2024","302"
"45488","VILLAREGGIA",90,0,0,90,"2024","304"
"45489","VILLASTELLONE",795,214,173,1182,"2024","308"
"45490","VILLATA",10,26,0,36,"2024","164"
"45491","VILLAVERLA",95,1749,0,1844,"2024","118"
"45492","VILLETTE",42,0,31,73,"2024","076"
"45493","VILLIMPENTA",57,19,0,76,"2024","068"
"45494","VILLONGO",4,0,0,4,"2024","242"
"45495","VILLORBA",132,0,0,132,"2024","091"
"45496","VILMINORE DI SCALVE",10,162,0,172,"2024","243"
"45497","VIMERCATE",3,29,0,32,"2024",NA
"45498","VINADIO",536,0,0,536,"2024","248"
"45499","VINCHIO",1,0,0,1,"2024","120"
"45500","VINOVO",623,152,28,803,"2024","309"
"45501","VINZAGLIO",0,37,0,37,"2024","164"
"45502","VIOLA",103,0,0,103,"2024","249"
"45503","VIONE",21,49,25,95,"2024","202"
"45504","VIRLE PIEMONTE",350,228,175,753,"2024","310"
"45505","VISANO",2039,290,2,2331,"2024","203"
"45506","VISCHE",40,0,0,40,"2024","311"
"45507","VISONE",66,0,0,66,"2024","187"
"45508","VISTARINO",1,0,0,1,"2024","181"
"45509","VISTRORIO",3,0,0,3,"2024","312"
"45510","VITTORIO VENETO",167,135,1,303,"2024","092"
"45511","VITTUONE",1,188,0,189,"2024","243"
"45512","VIU'",100,0,4,104,"2024","313"
"45513","VIVERONE",97,0,0,97,"2024","080"
"45514","VIZZOLO PREDABISSI",14,113,0,127,"2024","244"
"45515","VO'",49,73,0,122,"2024","105"
"45516","VOBARNO",36,96,31,163,"2024","204"
"45517","VOCCA",0,10,0,10,"2024","166"
"45518","VODO CADORE",0,0,22,22,"2024","066"
"45519","VOGHERA",32,0,0,32,"2024","182"
"45520","VOGOGNA",61,0,0,61,"2024","077"
"45521","VOLONGO",3,0,0,3,"2024","114"
"45522","VOLPAGO DEL MONTELLO",1171,666,56,1893,"2024","093"
"45523","VOLPEDO",4,0,0,4,"2024","188"
"45524","VOLPIANO",346,74,50,470,"2024","314"
"45525","VOLTA MANTOVANA",3299,1505,604,5408,"2024","070"
"45526","VOLTAGGIO",48,0,68,116,"2024","190"
"45527","VOLVERA",1514,258,93,1865,"2024","315"
"45528","VOTTIGNASCO",2050,40,62,2152,"2024","250"
"45529","ZANDOBBIO",18,0,0,18,"2024","244"
"45530","ZANE'",255,92,0,347,"2024","119"
"45531","ZANICA",179,1233,0,1412,"2024","245"
"45532","ZAVATTARELLO",159,0,0,159,"2024","184"
"45533","ZECCONE",25,215,0,240,"2024","185"
"45534","ZELBIO",0,0,14,14,"2024","246"
"45535","ZELO BUON PERSICO",4,1383,0,1387,"2024","061"
"45536","ZEME",112,0,0,112,"2024","186"
"45537","ZENEVREDO",2,0,0,2,"2024","187"
"45538","ZENSON DI PIAVE",1,0,0,1,"2024","094"
"45539","ZERBA",0,1,0,1,"2024",NA
"45540","ZERBOLO'",0,198,0,198,"2024","189"
"45541","ZERMEGHEDO",0,44,0,44,"2024","120"
"45542","ZERO BRANCO",233,183,0,416,"2024","095"
"45543","ZEVIO",3373,501,94,3968,"2024","097"
"45544","ZIANO PIACENTINO",145,0,0,145,"2024","048"
"45545","ZIBIDO SAN GIACOMO",28,314,0,342,"2024","247"
"45546","ZIMELLA",8095,342,0,8437,"2024","098"
"45547","ZINASCO",39,0,0,39,"2024","190"
"45548","ZOCCA",61,649,0,710,"2024","047"
"45549","ZOGNO",107,66,0,173,"2024","246"
"45550","ZOLA PREDOSA",19,157,0,176,"2024","060"
"45551","ZONE",2,38,0,40,"2024","205"
"45552","ZOVENCEDO",6,0,0,6,"2024","121"
"45553","ZUBIENA",116,0,23,139,"2024","082"
"45554","ZUGLIANO",644,132,9,785,"2024","122"
"45555","ZUMAGLIA",17,0,0,17,"2024","083"
